皮爾力巴斯直屬隊員	Philipas' Soldier	필리파스 직속 부대원
指揮官 巴塞寧	Commander Vacenin	지휘관 바세닌
上級長官 皮爾力巴斯	Senior Officer Philipas	선임장교 필리파스
軍官皮爾利克斯	Officer Felix	장교 필릭스
脆弱的貓頭鷹雕像	Weak Owl Sculpture	약한 부엉이 조각상
恐懼的貓頭鷹雕像	Scared Owl Sculpture	두려운 부엉이 조각상
老實的貓頭鷹隊長	Sincere Owl Sculpture	성실한 대장 부엉이
意志的貓頭鷹雕像	Devoted Owl Sculpture	의지의 부엉이 조각상
痛苦的貓頭鷹雕像	Troubled Owl Sculpture	괴로운 부엉이 조각상
部下貓頭鷹3	Subordinate Owl 3	부하 부엉이3
我們只是為了人類的靈魂而存在的嗎？	Do we exist only for guiding humans' souls?	우리는 인간의 영혼을 위해서만 존재하는 걸까?
士兵 杜米尼克	Soldier Dominic	병사 도미니크
士兵 山姆森	Soldier Samson	병사 샘슨
士兵 福爾特	Soldier Poulter	병사 폴터
指揮官 朱利安	Commander Julian	지휘관 줄리안
你能不能去貝爾圖伊交叉路上支援指揮官歐路克的部隊呢？	Won't you support Commander O'Rourke's unit at the Veltui Crossroads?	벨투이 교차로에서 지휘관 오루크 부대를 지원해주지 않겠나?
指揮官 歐路克	Commander O'Rourke	지휘관 오루크
離開的貓頭鷹雕像	Substitute Owl Sculpture	떠나가는 부엉이 조각상
士兵 卡爾路斯	Soldier Kallus	병사 칼루스
士兵 戴伊紐斯	Soldier Dainus	병사 다이뉴스
定居的貓頭鷹雕像	Settled Owl Sculpture	정착한 부엉이 조각상
人類的靈魂為什麼會有如此多的東西呢？	Why do human souls contain so many things?	인간의 영혼은 왜 그리 많은 것을 품고 있을까요?
老實的貓頭鷹隊長雕像	Earnest Owl Chief Sculpture	성실한 대장 부엉이 조각상
變弱的貓頭鷹雕像	Weak Owl Sculpture	약해진 부엉이 조각상
我的同伴們能夠平安抵達奧施莉奈女神身邊嗎？	Do you think my allies can reach Goddess Ausrine safely?	제 동료들이 아우슈리네 여신께 무사히 닿을 수 있을까요?
暈倒的傳令	Fallen Messenger	쓰러진 전령
資深修道士佛特斯	Senior Monk Potos	선임 수도사 포토스
修道士瓦以利	Monk Wiley	수도사 와일리
獵人雷伊娜	Hunter Reina	헌터 레이나
資深修道士馬勒寇	Senior Monk Marko	선임 수도사 마르코
獵人納塔夏	Hunter Natasha	헌터 나타샤
獵人巴斯提爾	Hunter Bastille	헌터 바스틸
修道士查德	Monk Chad	수도사 채드
資深修道士古斯	Senior Monk Goss	선임 수도사 거스
修道士勇斯	Monk Jones	수도사 욘스
修道士傑普利	Monk Jeffrey	수도사 제프리
修道士莫漢	Monk Moheim	수도사 모하임
警備 兵萊爾	Guard Lyle	경비병 라일
警備兵 諾瑪比斯	Guard Nomabis	경비병 노마비스
時空法師 莎比納	Chronomancer Sabina	크로노맨서 사비나
王國軍 蕾堤亞	Royal Army Guard Retia	왕국군 레티아
警備兵 葛普坦	Guard Gofden	경비병 고프덴
副官 漢斯	Adjutant General Hans	부관 한스
葳荷米娜凱利奧特	Wilhelmina Carriot	빌헬미나 캐리어트
能幫忙從奈勃基亞城堡的怪物身上取得石化樣本嗎？	Can you defeat the monsters in Neiveikiama Castle and get me petrified samples?	네베키아 성채의 몬스터에게서 석화 표본을 구해 줄 수 있겠나?
我正在考慮，你能以後再來嗎？	I'm still thinking so can you come back later?	생각 중이니까 나중에 다시 와주겠어?
弟子萊恩斯	Disciple Laius	제자 라이어스
弟子侯內斯	Disciple Hones	제자 호네스
只有你是解救加比婭女神和魔法師之塔的唯一希望。{nl}準備好了嗎？	Are you ready?	당신만이 가비야 여신과 마법사의 탑을 구할 수 있는 유일한 희망이예요.{nl}준비는 되셨나요?
後防部隊士兵	Rearguard Unit Soldier	후방부대 병사
會不會從畢拉空身上搜括黑煤粉反而比較好？	Would it have been better to scrape off the coal powder from Phyracon?	차라리 피라콘에게서 흑탄 가루를 긁어내는 게 나았을까?
塔上還有很多怪物嗎？	Are there still a lot of monsters in the tower?	아직도 탑에 몬스터가 많나요?
詭異的燈	Suspicious Lamp	수상한 램프
裝備商人約魯基斯	Equipment Merchant Yorgis	장비 상인 요르기스
雜貨商人穆拉斯	Item Merchant Muras	잡화 상인 뮤라스
軍官 達扭斯	Officer Danus	장교 다뉴스
士兵 羅伊	Soldier Roy	병사 로이
分隊長 約翰	Squad Commander Johan	분대장 요한
達扭斯的偵察兵	Danus' Scout	다뉴스의 정찰병
亞佳伊拉弗羅里的碑文	Epitaph of Agailla Flurry	아가일라 플러리의 비문
村民	Villager	마을 사람
姆杰老人	Old Man Moses	모제 영감
村莊青年 凱伊希	Villager Cahill	마을 청년 케이힐
補給官	Supplies Officer	보급관
朝聖者 莉莉亞	Pilgrim Liliya	순례자 릴리야
朝聖者 由利烏斯	Pilgrim Julius	순례자 율리우스
朝聖者 傑紐斯	Pilgrim Zenius	순례자 재뉴스
朝聖者 葛拉奇烏斯	Pilgrim Gracius	순례자 그라치우스
聖所導覽	Sanctum Notice Board	성소 안내
聖所	Sanctum	성소
旁白	Aside	방백
朝聖者 衛塔斯	Pilgrim Witas	순례자 위타스
寂靜之泉	Pond of Silence	고요의 샘
朝聖者的靈魂	Pilgrim's Spirit	순례자의 영혼
商人 圖凱	Merchant Dulke	상인 둘케
住民 艾密	Villager Emil	주민 에밀
藥師 提阿納	Pharmacist Tiana	약사 티아나
祭司 多支奈	Priest Dazine	사제 다지네
村莊青年 多萊恩	Villager Darren	마을 청년 다렌
奇利納	Kirina	키리나
釀造業者 都勒傑	Brewer Dorjen	양조업자 도르젠
瑪拉斯	Maras	마라스
巴爾達	Valda	발다
這種時候奧斯特雅女神到底是去了哪裡呢？	Where could Goddess Austeja have gone at a time like this?	이런 때에 아우스테야 여신께선 어디로 가신 걸까요?
拉馬勒	Lamar	라마르
利斯	Riesz	리스
祭司 利耶爾利耶	Priest Raeli	사제 라엘리에
農夫德魯巴	Farmer Druva	농사꾼 드루바
完蛋的養蜂專家 羅森	Ruined Bee Farmer Logen	망한 양봉가 로센
要怎麼用這個東西來拯救靈魂們呢？	What should I do about it to save the spirits?	이걸 어떻게 해야 영혼들을 구원할 수 있지?
主教亞烏雷利屋斯的靈魂	Bishop Aurelius' Spirit	주교 아우렐리우스의 영혼
祭司大朗	Priest Daram	사제 다람
祭司高達	Priest Goda	사제 고다
祭司普羅基特	Priest Prosit	사제 프로지트
士兵 魯特爾巴斯	Soldier Rudolfas	병사 루돌파스
士兵 阿斯巴斯	Soldier Aspas	병사 아스파스
墳墓看守人 羅馬思	Grave Keeper Romas	무덤지기 로마스
補給部隊員	Supply Soldier	보급 부대원
大教堂的啟示	Revelation of Great Cathedral	대성당의 계시
主教亞烏雷利屋斯	Bishop Aurelius	주교 아우렐리우스
因此只有我才有資格看師父的資料，而不是侯內斯吧？	So I have the rights to look at the documents of our master and not Hones right?	그러니까 호네스가 아닌 저만이 스승님의 자료를 볼 자격이 있다는 것 아니겠어요?
魔石融合劑	Magic Gem Fusion Device	마석 융합기
侯內斯的一部分紙條	Hones' Regular Memo	호네스의 쪽지 일부
侯內斯的一部分紙條	Hones' Regular Memo	호네스의 메모 일부
奎波爾碧塔	Kupole Vita	큐폴 비타
里莫斯的靈魂	Rimos' Spirit	리모스의 영혼
擊劍手大師	Fencer Master	펜서 마스터
賓申塔斯	Vincentas	빈센타스
因切斷命運的線頭而徬徨	May the threads of destiny be cut loose and flutter freely	운명의 실타래가 끊어져 방황하리라
王國的城牆比王國歷史更悠久	The Kingdom's walls will last longer than the Kingdom itself	왕도의 성벽이 왕도보다 오래 가리라
阿伊特巴拉斯的紀錄	Eitbaras' Records	아이트바라스의 기록
考古學家尤斯達斯	Archeologist Justas	고고학자 유스타스
考古學家阿爾魯達	Archeologist Alruida	고고학자 알뤼다
倒塌的石塔	Collapsing Stone Tower	무너지는 돌탑
鐵匠依拉娜伊	Blacksmith Ilanai	대장장이 일라나이
裝備商人尤拉	Equipment Merchant Jura	장비 상인 율라
還有什麼想知道的嗎？	Is there anything else you want to ask?	혹시 더 궁금한 게 있는가?
祭司 伊內亞	Priest Inea	사제 이네아
祭司路歐德爾	Priest Ruodell	사제 루오델
祭司約瑟那	Priest Yosana	사제 요사나
祭司阿爾莉莎	Priest Alisha	사제 알리샤
朝聖者歐比爾	Pilgrim Orville	순례자 오빌
祭司露亞那	Priest Loana	사제 로아나
台上刻的文字	Writing on the Platform	단상에 새겨진 글귀
露克立斯部隊將校的靈魂	Ruklys Army Officer's Spirit	루클리스 부대 장교의 영혼
什麼嘛，沒有？	What? There isn't anything?	뭐야, 없어?
阿曼達	Amanda	아만다
品質證明有轉交給他們嗎？	Did you deliver the certificates? 	품질 인증서를 잘 전달하고 오셨나요?
尹歐娜	Iona	이오나
奎波爾阿露納	Kupole Arune	큐폴 아루네
德魯伊艾爾利	Druid Ellie	드루이드 엘리
農夫達阿西	Farmer Darcy	농부 다아시
農夫米雷	Farmer Miren	농부 미렌
調查官莫納漢	Investigator Monahan	조사관 모나한
農場監督官多稜	Farm Supervisor Dorn	농장 감독관 도른
農場士兵蓋德森	Farm Soldier Gedson	농장 사병 게드슨
佃戶夏爾洛	Tenant Farmer Charlotte	소작인 샬롯
德魯伊馬勒提內	Druid Martinek	드루이드 마르티넥
佃戶拜斯	Tenant Farmer Weiss	소작인 바이스
庫魯德夏頓	Gord Shaton	고르드 샤튼
芭內莎夏頓	Vanessa Shaton	바네사 샤튼
士兵隊長布洛斯	General Buros	사병대장 뷰로스
管家巴雷	Steward Valen	집사 바렌
還沒完成暮星之鑰嗎？	Is the Evening Star Key still not ready?	저녁별 열쇠는 아직인겁니까?
救援者可以負責卡巴拉孤立區的轉移縫隙嗎？	Can you deal with the dimensional crack at Gavara Isolation District?	구원자님께서 가바라 고립구의 전이 틈새를 맡아 주실 수 없을까요?
受到詛咒的朝聖者	Cursed Pilgrim	저주받은 순례자
克爾雷歐巴斯	Cleopas	클레오파스
米可羅斯	Mikolas	미콜라스
商人托爾納斯	Merchant Dolonas	상인 돌로나스
托馬洛弗	Tomalov	토말로프
怎麼樣？有什麼反應嗎？	How was it? How did they react?	어때. 뭔가 반응이 있었나?
梅伊班的傳聞	Maven's Message	메이번의 전언
證明的祭司	Priest of Evidence	증명의 사제
脫隊的士兵歐漢	Straggling Soldier Upham	낙오된 사병 업햄
沒有其他所得嗎？	Did you find anything?	별 다른 소득은 없었나요?
修道院長	Abbot	수도원장
開始搜查	Start searching	수색 시작
搜查結束	Finished searching	수색 종료
慘叫聲	Sound of a scream	비명 소리
死靈法師亞多瑪斯	Necromancer Adomas	네크로맨서 아도마스
陳舊的信件	Old Letter	낡은 편지
部隊長留下的紙條	Memo left by the Commander	부대장이 남긴 쪽지
躲藏中的部隊長	Hidden Commander	숨은 부대장
戀人之墓	Lover's Grave	연인의 무덤
愛德華	Edward	에드워드
正要清除那些可疑的陷阱的時候，才猛然想到你是不是說那些陷阱可能是用來捕捉怪物用的呢？	Are you saying the suspicious trap you found was made to attract monsters?	수상해 보이는 것이 있어서 제거하려고 했더니, 몬스터를 부르는 함정이었다는 말씀이시지요?
警備兵豪頓	Guard Horton	경비병 호튼
警備兵麥德遜	Guard Manderson	경비병 맨더슨
如果害怕和敵人交手就不能稱作劍鬥士了吧？	How can you claim yourself to be a gladiator if you are afraid of combat?	적과 붙는 것을 두려워한다면 검투사라고 할 수 없잖아?
兩種命令	Two Types of Orders	두 가지 명령
幫忙偵查	I'll help scout around	정찰을 도와 준다고 한다
士兵的珍貴物品(1)	Soldier's Precious Belongings (1)	병사의 소중한 물건(1)
幫忙找	I will find it	찾아 주겠다고 한다
士兵的珍貴物品(2)	Soldier's Precious Belongings (2)	병사의 소중한 물건(2)
要收集枯樹枝回來	I will collect the dried twigs	마른 나뭇가지를 모아오겠다고 한다
不想再插手	I don't want to touch it anymore	더 이상 손대고 싶지 않다고 한다
士兵的珍貴物品(3)	Soldier's Precious Belongings (3)	병사의 소중한 물건(3)
委託	Leave it to me	맡겨달라고 한다
紅樹林哥布林的襲擊	Attack of the Giant Red Wood Goblin	레드 우드 고블린의 습격
確保通往大王關口的路(1)	Secure Route to the Gateway of the Great King (1)	대왕의 관문으로 가는 길 확보(1)
無視	Ignore	무시한다
淨化區域內部	Secure the Area	구역 안정화
確保通往大王關口的路(2)	Secure Route to the Gateway of the Great King (2)	대왕의 관문으로 가는 길 확보(2)
要支援	I will apply for it	지원하겠다고 한다
沒有這種閒暇時間	I don't have time for that	그럴 여유는 없다고 한다
貓頭鷹雕像的小幫助	Owl Sculpture's Little Help	부엉이 조각상의 작은 도움
代替你去消滅	I'll get rid of them for you	대신 처치해 주겠다고 한다
確保通往大王關口的路(3)	Secure Route to the Gateway of the Great King (3)	대왕의 관문으로 가는 길 확보(3)
看起來危險	It looks dangerous	위험해 보인다고 한다
離開的路	Off To A Journey	떠나는 길
遭到襲擊的搜索隊	Search Scouts under Attack	습격받은 수색대
要去德利耶查濕地看一下	I'll go to Drieza Waterland	드리에자 습지로 가 보겠다고 한다
一起去避一下	Let's get out of here together	함께 몸을 피하자고 한다
墳墓的主人	Grave's Owner	무덤의 주인
詢問是因為什麼事	What is it ?	무슨 일 때문인지 묻는다
正在安設裝置	Piling up the firewoods	장작 쌓는 중
恐懼之森	Forest of Fear	공포의 숲
會轉交翅膀碎片	I will deliver the Piece of Wing	날개 조각을 전해주겠다고 한다
翅膀碎片(1)	Piece of Wing (1)	날개 조각(1)
支援後防部隊	Support of Rearguard Troops	후방부대 지원
會幫忙減少周圍怪物的數量	I will lessen the monsters around	주변 몬스터의 수를 줄여 주겠다고 한다
抱歉無法幫忙	Sorry but I can't help you	미안하지만 도와줄 수 없다고 한다
關於森林之路	About the Forest Road	숲속 길에 대해
消失的部隊員(1)	The Missing Troop (1)	사라진 부대원(1)
要幫忙找偵察兵	I will find the scout	정찰병을 찾아 주겠다고 한다
雖然很抱歉，但我還是拒絕	I'm sorry but I can't	미안하지만 거절한다
消失的部隊員(2)	The Missing Troop (2)	사라진 부대원(2)
先幫你消滅怪物	I will kill the monsters first	몬스터를 먼저 처치해 주겠다고 한다
需要一點準備的時間	I need some time to prepare	잠시 준비 할 시간이 필요하다고 한다
補給部隊在哪裡(1)	Where are the Supply Troops (1)	보급부대는 어디에(1)
幫你找補給部隊	I will find the supply troops	보급부대를 찾아 주겠다고 한다
補給部隊在哪裡(2)	Where are the Supply Troops (2)	보급부대는 어디에(2)
幫忙回收補給物	I'll help retrieve the supplies	보급품 회수를 돕겠다고 한다
會等到回收完所有補給品為止	I'll wait until all the supplies are retrieved	보급품을 전부 회수할때까지 기다리겠다고 한다
補給部隊在哪裡(3)	Where are the Supply Troops (3)	보급부대는 어디에(3)
除了任務還是任務	Mission over Mission	임무보다 임무
要幫忙收集鉤子	I'll help collect the hooks	갈고리를 모으는 것을 돕겠다고 한다
等到都收集好為止	Let's wait until everything is collected	다 모을때까지 기다리자
皮爾力巴斯的指揮力	Leadership of Philipas	필리파스의 지휘력
打算協助	I will cooperate	협조하겠다고 한다
不太妥當	That is unfair	부당하다고 한다
獨自留下的分隊員	Troop Left Alone	홀로 남은 분대원
找出卷軸吧	Find the report	보고서를 찾아 주자
最好快點回去	Better return quickly	빨리 돌아가는 게 좋겠다고 한다
最後一次一起	Spend the Last Together	마지막은 함께
要幫你收拾遺物	I will collect the keepsakes	유품을 수습해 주겠다고 한다
史可尼斯原野的災難(1)	Disaster of Saknis Plains (1)	사크니스 벌판의 재앙(1)
跟著去依茲達金卡斯街道吧	Let's follow to Isdaigininko Highway	이즈다깅카스 가도로 따라가자
需要一點準備的時間	I need some time to prepare	잠시 준비할 시간이 필요하다고 한다
史可尼斯原野的災難(2)	Disaster of Saknis Plains (2)	사크니스 벌판의 재앙(2)
我會參與戰鬥	I will join the battle	전투에 참여하겠다고 한다
要求給一點準備的時間	Give me some time to prepare	잠시 준비할 시간을 요청하자
某位無名士兵的恨	Grudge of A Nameless Warrior	어느 무명 용사의 한풀이
正在試戴項鍊	Trying on the necklace	목걸이를 걸어 보는 중
正在祈求冥福	Consoling the soul	명복을 빌어 주는 중
禁止出入	Do Not Enter	출입금지
要求支援	Requesting Support	지원 요청
會守護	I will protect you	지켜주겠다고 한다
要躲好	Stay hidden	잘 숨어 있으라고 한다
易燃石[造箭者轉職]	Burning Stones [Fletcher Advancement]	잘 타는 돌멩이[플레쳐 전직]
受到歡迎的不速之客	Welcomed Uninvited Guest	환영받는 불청객
光榮之路	Glorious Road	영광의 길
關於這座城市	About this city	이 도시에 대해
石化霜預報(1)	Petrifying Frost Forecast (1)	석화서리 예보(1)
要去確認看看	I will check it	확인해 보겠다고 한다
說沒有必要幫忙	Tell him that there's no reason for you to help	도울 이유는 없다고 한다
關於石化霜的詛咒	About the curse of the Petrifying Frost	석화서리 저주에 대해
石化霜預報(2)	Petrifying Frost Forecast (2)	석화서리 예보(2)
說能夠與之抗衡	Tell him that you can get rid of it	상대할 수 있다고 한다
有點勉強	That's too much	무리라고 한다
石化霜預報(3)	Petrifying Frost Forecast (3)	석화서리 예보(3)
說最好等安全一點再說	Tell him that you will wait until it gets safe	안전한 시간을 기다리는 것이 좋겠다고 한다
整理作業場	Cleaned Up Workshop	작업장 정리
合法的所得	Legal Profit	합법적 소득
會收集給你	I will collect for her	모아 주겠다고 한다
敵對的打劫	Hostile Extortion	적대적 갈취
說會帶來贓物	Tell him that you would bring the goods	장물을 가져 오겠다고 한다
拒絕偷東西	Tell him that you don't want to steal	도둑질은 거절한다
關於迪庫盜墓團 	About the Dico Thieves	디코 도굴단에 대해
他們的方式	Their Ways	그들의 방식
避開石化霜的方法	The way to avoid Petrifying Frost	석화서리를 피하는 방법
善意的謊言(1)	White Lie (1)	선의의 거짓말(1)
我會收集回來	I will collect it	수집해 오겠다고 한다
說無法幫忙	Tell him that you can't help	도울 수 없다고 한다
善意的謊言(2)	White Lie (2)	선의의 거짓말(2)
現在好像還不是時候	It's not yet time	아직 때가 아닌 것 같다고 한다
善意的謊言(3)	White Lie (3)	선의의 거짓말(3)
祈求武運	Wish you luck	무운을 빈다
說現在還不是時候	Tell him that it's not the time	아직 때가 아니라고 한다
打雜	Cleaning Up	뒤치다꺼리
說他能夠幫忙除掉怪物	Tell him that you can defeat monsters on behalf of him	대신 몬스터를 처리 해 줄 수 있다고 한다
輕拍你的肩膀，要你加油	Cheer him up	힘내라고 다독인다
關於凱爾利斯騎士團	About the Knights of Kaliss	칼리스 기사단에 대해
不需要的紀錄	Unnecessary Records	불필요한 기록
關於科斯塔斯	About Kostas	코스타스에 대해
最後的收集	The Last Collection	최후의 수집
我會幫忙收拾遺物	I will collect the keepsakes	대신 유품을 거두어 주겠다고 한다
會很辛苦	That will be hard	힘들겠다고 한다
關於王國軍隊與凱爾利斯騎士團	About the Royal Army guards and the Knights of Kaliss	왕국군과 칼리스 기사단에 대해
恢復的機會(1)	A Chance of Recovery (1)	회복의 기회(1)
說應當要幫忙	Tell him that you would help	응당 돕겠다고 한다
關於希爾特的信物	About the symbol of Schilt	실트의 증표에 대해
恢復的機會(2)	A Chance of Recovery (2)	회복의 기회(2)
我會進行實驗	I will experiment it	실험해 보겠다고 한다
說無法再幫忙了	Tell him that you can't help anymore	더 이상 도울 수 없다고 한다
關於石化的研究	About the research of the petrification	석화의 연구에 대해
恢復的機會(3)	A Chance of Recovery (3)	회복의 기회(3)
我會找來驅動核	I will get the activating nucleus	구동핵을 구해 오겠다고 한다
幫忙祈求研究順利	Pray for the successful research	연구가 잘 되길 빌어 준다
敵人的敵人是怪物(1)	The Enemies of the Enemies are Monsters (1)	적의 적은 몬스터(1)
敵人的敵人是怪物(2)	The Enemies of the Enemies are Monsters (2)	적의 적은 몬스터(2)
說會好好處理這件事	Tell him that you would finish the task well	잘 처리하겠다고 한다
說不再插手這件事	Reject	발을 빼겠다고 한다
歸隊時間	Time of Return	복귀 시간
會幫你消滅	I'll take care of it	처리해주겠다고 한다
戰友之愛	Camaraderie	전우애
關於支援	About the support	지원에 대해
踩尾巴	Treading a Tail	꼬리밟기
打發時間	Passing Time	시간 때우기
說會立即找來	Tell him that you would bring it fast	금방 구해오겠다고 한다
不會有事的	Everything will be alright	별 일 없을 거라고 한다
關於莎比納	About Sabina	사비나에 대해
被遺忘的時間	Lost Time	잊혀진 시간
要去做	I'll do it	해오겠다고 한다
關於真相	About the truth	진실에 대해
傳點大逃脫(1)	Great Escape Portal (1)	대탈출 포탈(1)
說不會去做危險的事	Tell him that you won't do anything dangerous	위험한 일은 하지 않겠다고 한다
關於莎比納所說的危險	About the danger that Sabina is talking about	사비나가 말하는 위험에 대해
傳點大逃脫(2)	Great Escape Portal (2)	대탈출 포탈(2)
說會就此罷手	Tell him that you would quit from here	여기서 손을 떼겠다고 한다
傳點大逃脫(3)	Great Escape Portal (3)	대탈출 포탈(3)
都準備好了	I'm ready	준비됐다고 한다
稍等一下	Wait for a while	기다려달라고 한다
不自在的同盟	Uncomfortable Alliance	불편한 동맹
說接受提案	Tell him that you would accept the suggestion	제안을 수락한다고 한다
關於危險的交易	About the dangerous deal	위험한 거래에 대해
同伙(1)	All the Same (1)	한통속(1)
說不想做危險的事	Tell him that you don't want to do something dangerous	위험한 일은 하고 싶지 않다고 한다
同伙(2)	All the Same (2)	한통속(2)
說很危險，要就此打住	Tell him to quit since it's dangerous	이만 위험하니 그만두겠다고 한다
關於做這種事是否沒關係	About whether we could continue to do this	이런 일을 해도 괜찮은지에 대해
殘存的謊言	Surviving Lie	살아남은 거짓말
關於紀錄品	About the records	기록물에 대해
微小差異(1)	Small Difference (1)	작은 차이(1)
詢問該幫忙什麼	Ask him how you can help	무엇을 도우면 될 지 묻는다
說好像很危險，要就此打住	Tell him that you will leave since it seems dangerous	위험할 것 같으니 이만 가겠다고 한다
微小差異(2)	Small Difference (2)	작은 차이(2)
詢問該怎麼做	Ask him what to do	어떻게 하면 되는지 방법을 묻는다
微小差異(3)	Small Difference (3)	작은 차이(3)
說能收集到	Tell him that you would gather them	모아올 수 있다고 한다
微小差異(4)	Small Difference (4)	작은 차이(4)
腦中想起的真相	Surfacing Truth	떠오르는 진실
我會去破壞	I'll destroy it	파괴하겠다고 한다
關於過去的都市	About the city in the past	과거의 도시에 대해
偉大的首相	The Great Chancellor	위대한 재상
我會代替你去做	I will cover for you	대신 해주겠다고 한다
說拒絕做沒用的事	Tell him that you would reject irrelevant tasks	쓸떼없는 일은 거절하겠다고 한다
越發嚴重的動亂	Intensified Rampage	심해진 난동
說要幫忙除掉怪物	Tell him that you would help get rid of monsters	몬스터 처치를 돕겠다고 한다
清爽的工作	Refreshing Work	상쾌한 근무
我會回收回來	I'll retrieve it	회수해 오겠다고 한다
無法挽回的意外(1)	Irrevocable Accident (1)	돌이킬 수 없는 사고(1)
咒術的見解(1)	Magical Opinion (1)	주술적 견해(1)
關於石化霜的詛咒	About the curse of the Petrifying Frost	석화서리의 저주에 대해
咒術的見解(2)	Magical Opinion (2)	주술적 견해(2)
感覺哪裡不太對勁，拒絕這件事吧	Reject	왠지 꺼림칙하니 거절하자
凱爾利斯想知道真相	Kaliss Wants the Truth	칼리스는 진실을 원한다
說要去生火	I'll come back after I light up the bonfire	불을 피우고 오겠다고 한다
練金術士的價值	Value of the Alchemist	연금술사의 가치
關於石化的詛咒	About the curse of petrification	석화의 저주에 대해
有趣的標本	Interesting Copy	흥미로운 표본
說要帶過來	Tell him that you would bring it	가져 오겠다고 한다
實驗室破壞者	Lab Destroyer	실험실 파괴자
秘密交易(1)	Secret Trade (1)	비밀거래(1)
是凱爾利斯騎士團方面	I am on the same side with the Knights of Kaliss	칼리스 기사단 편이라고 한다
是王軍那一邊的	I am on the same side with the Kingdom Soldiers	왕국군 편이라고 한다
秘密交易(2)	Secret Trade (2)	비밀거래(2)
秘密交易(3)	Secret Trade (3)	비밀거래(3)
我會消滅滴水嘴怪	I will defeat Gargoyle	가고일을 처리하겠다고 한다
不好對付	They are too strong to face against	상대하기 버겁다고 한다
跟著盜墓者阿曼達進入大地要塞	Go to the Fortress of the Land by following the Grave Robber Amanda	도굴꾼 아만다를 따라 대지의 요새로 들어가세요
正在確認魔法陣	Checking the magic tile	마법진 확인 중
說要去找女神	I will go to the goddess	여신에게 가겠다고 한다
前往朝聖者之路	To Pilgrim's Way	순례자의 길로
抵達了加比婭女神所說的卡汀森林入口	Arrived at Kateen Forest as Goddess Gabija mentioned	가비야 여신이 이야기한 카틴 숲 입구에 도착했습니다
說現在無法使用魔力，詢問應該怎麼辦	What are you going to do if you can't use the spell?	마력을 쓰지 못하는데 어떻게 할 건지 묻는다
無法使用魔力的原因	Why the spell can't be used	마력을 못 쓰는 이유
支援兵力	Military Support	병력 지원
即使如此也想幫忙	I still want to help	그래도 도움을 주고 싶다고 한다
繼續走走過的路	Continue going your way	가던 길을 계속 간다
拒絕	Refuse	거절
都是因為蜂蜜(1)	It's the Honey (1)	꿀 때문이야(1)
要去看一下再回來	I'll check it out	살펴보고 오겠다고 한다
因為有點忙，還是拒絕吧	I'm busy so I'll pass	바쁘니까 거절하자
關於村莊	About the town	마을에 대해
都是因為蜂蜜(2)	It's the Honey (2)	꿀 때문이야(2)
我會試著去找	I'll take a look	한 번 찾아 보겠다고 한다
這樣事情就差不多都做完了，直接走吧	I've done enough so just go my way	이 정도면 할 일은 다 한것 같으니 그냥 간다
關於怪物與養蜂	About the monsters and bee farming	몬스터와 양봉에 대해
被毀掉的釀造業	Ruined Brewery	망쳐버린 양조업
我先告辭了	I'll get going then	그만 가보겠다고 한다
釀造業者的希望	Brewer's Last Hope	양조업자의 희망
試著安撫他冷靜	Calm down	진정하라고 달래 본다
關於其他啟示者	About the other Revelator	다른 계시자에 대해
找到了都勒傑所說的蜂蜜酒 	Found the mead that Dorjen asked you to bring	도르젠이 가져오라고 한 벌꿀술을 찾았습니다
甜蜜的復仇	Sweet Revenge	달콤한 복수
已經幫了該幫的，那我就先走一步了	I've helped enough so I'm leaving	도와줄 만큼 도와줬으니 자리를 뜬다
占領養蜂場的斯帕露娜絲	Apiary-invader Sparnas	양봉장을 장악한 스파르나스
把蜂蜜全吃掉的比特雷巨蜂	Honey-eating Biteregina	꿀을 전부 먹어치운 비테레지나
討厭危險的東西	Dislike for Danger	위험한 건 싫어
我會幫你整理周圍的怪物	I'll take care of the monsters around	주변의 몬스터를 정리해 주겠다고 한다
勸你最好別掉以輕心，回去的路上要小心	Be careful and don't let your guard down on your way back	긴장을 늦추지 말고 조심히 돌아가라고 충고한다
硬要僱用啟示者的理由	Reason behind hiring Revelators	굳이 계시자를 고용하려는 이유
要去確認怪物是否真的是被蜂蜜香氣引來的	I'll check if the monsters are really attracted to the scent of honey	몬스터가 정말 꿀 향기에 이끌리는지 확인해보겠다고 한다
關於祭壇	About the Altar	제단에 대해
會去確認比奇吳祭壇	I'll check Bichiu Altar	비치우 제단을 확인하겠다고 한다
比爾那森林的祭壇(1)	Altar of Vilna Forest (1)	빌나 숲의 제단(1)
要確認看看	I'll check	확인해보겠다고 한다
正在察看祭壇	Looking at the altar	제단을 살펴보는 중
比爾那森林的祭壇(2)	Altar of Vilna Forest (2)	빌나 숲의 제단(2)
最好去見祭司	Better meet the priest	사제를 만나보는 게 좋을 것 같다고 한다
請種田	Help My Farm Recover	농사를 짓게 해주세요
會幫你找農具	I will find the farm tools	농기구를 찾아 주겠다고 한다
甜甜的真好	Desirable Combs	달콤한게 좋아
會幫忙找	I'll get it	구해주겠다고 한다
播種好可怕	Too Scared to Sow	파종은 무서워
耕作地的秘密(2)	Secret of the Farmland (2)	경작지의 비밀(2)
負起責任去善後	I will take care of it	책임지고 일을 수습하겠다고 한다
裝不知道	Ignore it	모른척한다
關於封印	About the Seal	봉인에 대해
耕作地的秘密(1)	Secret of the Farmland (1)	경작지의 비밀(1)
會啟動守護石	I will activate the Guardian Stone	수호석을 가동하겠다고 한다.
別管了	Let's just leave it	놔두자고 한다.
關於比爾那森林的治療	About the treatment at Vilna Forest	빌나 숲에서의 치료에 대해
正在使喚傭人	Activating it	가동시키는 중
蜂樹樹枝裡蘊含的力量	Power Within the Bee Tree Branch	벌나무 가지에 깃든 힘
收集灰回來	I will collect the ashes	재를 모아 오겠다고 한다
蘊涵女神之力的土地(1)	Land Bestowed with the Goddess' Power (1)	여신의 힘이 깃든 땅(1)
要去補充魔力	I will fill the evil power	마력을 채워 오겠다고 한다
蘊涵女神之力的土地(2)	Land Bestowed with the Goddess' Power (2)	여신의 힘이 깃든 땅(2)
要一點準備的時間	Give me some time to prepare	잠시만 준비할 시간을 달라고 한다
正在淨化封印塔	Purifying the Sealed Tower	봉인탑 정화 중
奧斯特雅女神的情況	Goddess Austeja's Situation	아우스테야 여신의 사정
聽故事	Listen to the Story	이야기를 듣는다
稍微休息一下吧	Let's rest for a while	조금만 쉬자고 한다
為了災難的降臨	The Advent of Disaster	재앙의 강림을 위해
就算是稻草人的手也好(1)	Scarecrow's Hand (1)	허수아비 손이라도(1)
就算是稻草人的手也好(2)	Scarecrow's Hand (2)	허수아비 손이라도(2)
會把它立起來	I'll have it stand	세워두겠다고 한다
取消	Cancel	취소
安慰它吧	Comfort him	위로해주자
被蠱惑的啟示者們	Addled Revelators	현혹된 계시자들
詢問找回象徵的方法	Ask how to regain the symbol	상징을 되찾는 방법에 대해 묻는다
是與我無關的事	It's not related to me	나와는 상관 없는 이야기라고 한다
關於春光樹林的封印	About the Seal in Spring Light Wood	봄볕나무 숲의 봉인에 대해
奧斯特雅女神的象徵	Symbol of Goddess Austeja	아우스테야 여신의 상징
修復中	Restoring	복원 중
首要之急是治療啟示者們	The Revelators come First	계시자들을 치료하는 게 우선
粉碎的封印塔(1)	Destroyed Seal Tower (1)	부서진 봉인탑(1)
我會復原封印	I will restore the seal	봉인을 복구하겠다고 한다
關於封印崩壞的原因	Why the seal is destroyed	봉인이 망가진 이유에 대해
正在賦予女神的力量	Endowing the power of the Goddesses	여신의 힘을 부여하는 중
粉碎的封印塔(2)	Destroyed Seal Tower (2)	부서진 봉인탑(2)
春光樹林祭壇的切波勒	Chafer of the Spring Light Woods	봄볕나무 숲 제단의 체이퍼
摧毀塔的犯人	The Tower's Destroyer	탑을 부서버린 범인
商人遺失的行李	Merchant's Lost Wares	상인의 잃어버린 짐
我會幫你找，你別擔心	I will find it back so don't worry	찾아줄테니 걱정 말라고 한다
關於被蠱惑的啟示者	About the addled Revelators	현혹된 계시자에 대해
確保安全的單行道	Securing a Safe Route	안전한 통행로 확보
我會幫忙消滅怪物	I'll get rid of the monsters	몬스터를 처치해주겠다고 한다
用春光草做的藥	Medicing Made of Spring Light Grass	봄볕초로 만드는 약
直接無視吧	Just ignore it	그냥 무시한다
討厭	I don't want to	싫다고 한다
失敗與成功	Failure and Success	실패와 성공
一步一腳印的收集	Each Step United	한걸음 한걸음이 모여
我會幫忙討伐	I'll help subjugate	토벌을 돕겠다고 한다
波塞林奇斯森林的威脅(1)	Threat at Poslinkis Forest (1)	포슬린키스 숲의 위협(1)
要去看一下	I'll go take a look	살펴 보겠다고 한다
波塞林奇斯森林的威脅(2)	Threat at Poslinkis Forest (2)	포슬린키스 숲의 위협(2)
會去拯救貓頭鷹們	I'll save the owls	부엉이들을 구해 주겠다고 한다
無法填滿的飢餓感(1)	Insatiable Hunger (1)	채워지지 않는 허기(1)
詢問想吃哪種食物	Ask her what kind of food she wants	어떤 음식을 원하냐고 묻는다
無法填滿的飢餓感(2)	Insatiable Hunger (2)	채워지지 않는 허기(2)
詢問是否有特別想要的東西	Ask her if there's anything she particularly wants	특별히 원하는 것이 있는지 묻는다
別沒事找事還是離開比較好	You better leave without being involved in the matter	괜히 얽히지 말고 자리를 뜨는 게 좋을 것 같다
無法填滿的飢餓感(3)	Insatiable Hunger (3)	채워지지 않는 허기(3)
無法填滿的飢餓感(4)	Insatiable Hunger (4)	채워지지 않는 허기(4)
繼續聽他說	Keep listening to him	계속 말을 들어 주자
已蓋好莉莉亞的墳墓	Made a grave for Liliya	릴리야의 무덤을 만들어 주었습니다
永無止盡的嘴饞(1)	Endless Gluttony (1)	끝없는 식탐(1)
就算是怪物的肉也好，幫我帶回來	I will get you some meat from the monsters	몬스터의 고기라도 괜찮다면 구해 오겠다고 한다
無視並繼續走曾走過的路	Ignore it and go your way	무시하고 가던 길 간다
永無止盡的嘴饞(2)	Endless Gluttony (2)	끝없는 식탐(2)
快交出音樂盒	Give him the music box	어서 오르골을 내 준다
永無止盡的嘴饞(3)	Endless Gluttony (3)	끝없는 식탐(3)
詢問我是否也有能幫上忙的事情	Ask him if there's anything you could help	내가 도울 수 있는 일이 있는지 묻는다
現在可以休息了	Tell him to take some rest now	이제 그만 휴식을 취하라고 한다
嘴饞的項鍊	Necklace of Gluttony	식탐의 목걸이
正在挖開腐壞的肉堆	Searching through the rotten meat	썩은 고기 더미를 파헤치는 중
餓鬼爭鬥	Argument	아귀다툼
等看看	Wait	기다려 본다
就走要走的路	Just go your way	그냥 갈 길 간다
不能被搶走(1)	Can't Be Taken Away (1)	빼앗길 수 없어(1)
想要幫忙	I want to help	도움이 되고 싶다고 한다
不想被牽扯進去就離開了	Leave since you don't wanna get involved	엮이고 싶지 않으니 떠난다
不能被搶走(2)	Can't Be Taken Away (2)	빼앗길 수 없어(2)
會幫忙做實驗	I will test it out	시험해 주겠다고 한다
離開吧	Leave now	이만 떠나자
正在翻找糧食堆	Searching through the stack of food	식량무지를 뒤지는 중
懶惰的詛咒 - 偷懶	Curse of Sloth - Laziness	나태의 저주 - 게으름
懶惰的詛咒 - 有氣無力	Curse of Sloth - Lethargy	나태의 저주 - 무기력
就在水晶核被破壞的同時，水晶也跟著被破壞了。	You destroyed all the cores and the Tree Root Crystal was destroyed as well	핵을 모두 파괴하자 수정 또한 파괴되어 버렸습니다
懶惰的詛咒 - 午覺	Curse of Sloth - Siesta	나태의 저주 - 낮잠
正在搖晃	Shaking	흔들어 보는 중
懶惰的詛咒 - 詛咒	Curse of Sloth - Curse	나태의 저주 - 저주
懶惰的詛咒 - 暈倒	Curse of Sloth - Faint	나태의 저주 - 기절
正在察看變質的樹根水晶	Checking the Mutated Tree Root Crystal	변질된 나무뿌리 수정을 살펴 보는 중
懶惰的詛咒 - 無底洞	Curse of Sloth - Abyss	나태의 저주 - 무저갱
察看樹根水晶	Checking the Tree Root Crystal	나무뿌리 수정 살펴 보기
懶惰的詛咒 - 水深火熱	Curse of Sloth - Misery	나태의 저주 - 도탄
察看水晶中	Looking at the crystal	수정을 살펴 보는 중
從樹根水晶內掉出了遺書	The will dropped from Tree Root Crystals	나무뿌리 수정에서 유언장이 떨어졌습니다
不明所以的事	Mysterious Incident	영문 모를 일
不要妨礙他，在旁邊看著就好	Let's just look at it quietly without disturbing	방해하지 말고 가만히 지켜보자
解除憤怒的封印實驗(1)	Raging Soul Releasing Test (1)	분노의 봉인 풀기 시험(1)
詢問要怎麼做才可以	What should I do?	어떻게 하면 되느냐고 물어 본다
因為很忙，要離開	Let's get out since you are busy	바쁘니 자리를 뜨자
關於這裡發生的事情	About the incident that occurred here	여기서 벌어진 일에 대해
正在祭壇裡祈禱	Praying to the altar	제단에 기도 하는 중
解除憤怒的封印實驗(2)	Raging Soul Releasing Test (2)	분노의 봉인 풀기 시험(2)
感覺好像是麻煩事，還是拒絕吧。	Reject it since it seems tiresome	귀찮은 일인 듯 하니 거절하자
解除憤怒的封印實驗(3)	Raging Soul Releasing Test (3)	분노의 봉인 풀기 시험(3)
會幫忙找經典	I will find the scripture for him	경전을 찾아 주겠다고 한다
能幫的都已經幫了，要離開了	I will leave since you helped him a lot	도와줄 만큼 도와줬으니 떠나겠다고 한다
解除憤怒的封印實驗(4)	Raging Soul Releasing Test (4)	분노의 봉인 풀기 시험(4)
看來應該會很辛苦	Tell him that it would be hard	힘들 것 같다고 한다
關於憤怒的靈魂們	About the furious spirits	분노한 영혼들에 대해
靈魂們的憤怒	Rage of the Souls	영혼들의 분노
關於魔族的目的	About the demons' objectives	마족의 목적에 대해
憤怒的靈魂花瓣	Flowers to the Enraged Soul	분노한 영혼의 꽃잎
正在祈禱	Praying	기도하는 중
請為受到束縛的靈魂們採下周圍的花並獻到祭壇上。	Gather flowers and offer it to the altar-bound souls	속박당한 영혼들을 위해 주변의 꽃을 모아 제단에 바치세요
正在整理祭壇	Cleaning the altar	제단을 정리하는 중
獻給憤怒的靈魂們	Offering to the Angry Souls	분노한 영혼들에게 바침
給憤怒者自由	Freedom to the Enraged Souls	분노한 자에게 자유를
正在上呈經典	Placing the Scripture	경전을 올려 놓는 중
被壓縮的憤怒	Condensed Anger	응축된 분노
被破壞的祭壇秘密	Secret of the Destroyed Altar	파괴된 제단의 비밀
靈魂的碎片	Fragment of a Soul	영혼의 파편
正在察看祭壇	Checking the altar	제단을 살피는 중
正在噴灑怪物體液	Spraying Cold Fluid	뿌리는 중
捐款看看	Make some contribution	헌금을 해 본다
這種時候不要浪費銀幣	Let's not waste silvers on this kind of thing	이런 데에 실버를 낭비하지 말자
為了祝福的膜拜(1)	Worship for the Blessing (1)	축복을 위한 경배(1)
將周圍的怪獸當成財物獻上去吧	Let's offer the monsters nearby as sacrifices	주변의 몬스터를 제물로 바쳐 보자
不需要祝福所以直接離開	You don't need blessings just go on your way	축복은 필요 없으니 그냥 간다
別提給予什麼祝福了，聖所似乎受到了污染	The sanctum has been corrupted instead of being blessed	축복은 커녕 성소가 오염된 것 같습니다
為了祝福的膜拜(2)	Worship for the Blessing (2)	축복을 위한 경배(2)
正在察看聖所	Looking at the sanctum	성소를 살펴보는 중
為了祝福的膜拜(3)	Worship for the Blessing (3)	축복을 위한 경배(3)
要淨化聖所	I will purify the sanctum	성소를 정화하겠다고 한다
好像會很危險，決定放棄淨化	Give up on the purification since it looks dangerous	위험할 것 같으니 정화는 포기한다
正在噴灑聖水	Spraying the Holy Water	성수를 뿌리는 중
神聖的女神像	Holy Goddess Statue	성스러운 여신상
真正的女神像(1)	Genuine Goddess Statue (1)	참된 여신상(1)
正在說明關於祈願森林女神像的事情	Explaining about the Goddess Statue in the Forest of Prayer	기원의 숲 여신상에 대해 설명 중
真正的女神像(2)	Genuine Goddess Statue (2)	참된 여신상(2)
去修女神像	Go repair the Goddess Statue	여신상을 보수하러 간다
好像會很危險，還是收手吧。	Stop it since it looks dangerous	위험할 것 같으니 손을 떼자
真正的女神像(3)	Genuine Goddess Statue (3)	참된 여신상(3)
正在修理女神像	Repairing the Goddess Statue	여신상 수리 중
真正的女神像(4)	Genuine Goddess Statue (4)	참된 여신상(4)
正在察看女神像	Inspecting the Goddess Statue	여신상을 살펴 보는 중
假假真真的聖所？(1)	Sanctum of Truth or Lie? (1)	거짓 또는 진실의 성소?(1)
假假真真的聖所？(2)	Sanctum of Truth or Lie? (2)	거짓 또는 진실의 성소?(2)
詢問關於淨化聖所的方法	Ask her about how to purify the Sanctum	성소를 정화할 방법에 대해 묻는다
情勢很危險，最好撤退	Better stand back as it's dangerous	위험하니까 물러서는 게 좋을 것 같다
假假真真的聖所？(3)	Sanctuary of Truth or Lie? (3)	거짓 또는 진실의 성소?(3)
正在取出標誌	Pulling out the Symbol	표식을 꺼내는 중
正在燃燒徽章	Burning the Badge	휘장을 태우는 중
已淨化聖所	The Sanctum has been purified	성소가 정화되었습니다
祝福的必要條件	Prequisite Blessing	축복의 필수 조건
裝來清澈的水	Get some Pure Water	맑은 물을 떠 온다
就這樣算了吧	Quit	그만 두자
正在舀水	Scooping up the Water	물 뜨는 중
放置好清水，進行膜拜	Worshiping with Pure Water	맑은 물을 놓고 경배 중
窒息的女神像	Suffocating Goddess Statue	질식하는 여신상
在聖所付出真心	Sincerity in the Sanctum	진심을 성소에
帶回草花	Obtain some flowers	풀꽃을 구해 오자
就這樣經過	Pass by	그냥 지나간다
不捐款	Don't donate	헌금하지 않는다
正在說明聖所的事情	Explaining about the Sanctum	성소의 일을 설명 하는 중
正在燃燒淨化符	Burning the purifier	정화부를 태우는 중
已淨化聖所！	The Sanctum has been purified	성소가 정화 되었습니다!
用虔誠的心	With Devotion	경건한 마음으로
擺脫迷惑(1)	Avoiding Infatuation (1)	미혹에서 벗어나(1)
要吃藥	I will consume the medicine	약을 먹겠다고 한다
感覺很可疑，還是拒絕吧	Reject it since it seems suspicious	의심되니 거절하자
擺脫迷惑(2)	Avoiding Infatuation (2)	미혹에서 벗어나(2)
要去收集材料回來	I will get the materials	재료를 구해 오겠다고 한다
約好下一次	Wait for the next chance	다음을 기약한다
關於受傷的理由	About the cause of the wound	다친 이유에 대해
擺脫迷惑(3)	Avoiding Infatuation (3)	미혹에서 벗어나(3)
擺脫迷惑(4)	Avoiding Infatuation (4)	미혹에서 벗어나(4)
正在建造墳墓	Making a grave	무덤을 만드는 중
已建好衛塔斯的墳墓	You've made the grave for Witas	위타스의 무덤을 만들어 주었습니다
對某人來說重要的	Precious to Someone	누군가에겐 소중한
正在察看墓碑	Looking at the epitaph	묘비를 살펴 보는 중
被丟棄的箱子	The Abandoned Chest	버려진 상자
在箱子內找到了陳舊的手帕！	You've found an old handkerchief in the chest	상자 안에서 낡은 손수건을 찾았습니다
正在尋找甕	Obtaining the Pot	항아리 구하는 중
正在噴灑樹液	Spraying Water for the Tree	수액을 뿌리는 중
這個空間的秘密	Secret of the Unusual Place	이공간의 비밀
消滅衝過來的怪物	Defeat the attacking monsters	달려드는 몬스터 처치
再次挖掘中	Digging it again	다시 파 보는 중
打開寶物箱	Open the Treasure Chest	보물 상자 열기
貓頭鷹的永眠	Eternal Sleep of the Owls	부엉이의 영면
令人擔心的伊修拉十字路口貓頭鷹	The Worrying Owl at Ishrai Crossroads	걱정되는 이쉬라이 사거리의 부엉이
擺設倒下的雕像	Standing up the fallen statue	쓰러진 조각상을 세우는 중
貓頭鷹雕像的葬禮	Owl Sculpture Funeral	부엉이 조각상 장례
裝靈魂的容器(1)	A Vessel for a Spirit (1)	영혼을 담는 그릇(1)
詢問要怎麼做才能受到引導	Ask him how you can get guidance	어떻게 하면 안내를 받을 수 있는지 묻는다
既然如此決定自己去找	I will find it alone	그렇다면 혼자 찾겠다고 한다
裝靈魂的容器(2)	A Vessel for a Spirit (2)	영혼을 담는 그릇(2)
要把經典找回來	I will find the scripture	경전을 찾아 오겠다고 한다
完成了靈魂召喚聖書	Completed the scripture for the spirit	영혼 소환 성서가 완성되었습니다
裝靈魂的容器(3)	A Vessel for a Spirit (3)	영혼을 담는 그릇(3)
詢問召喚方法	Ask him how to call him	부르는 방법을 물어 본다
慈悲與救援(1)	Mercy and Salvation (1)	자비와 구원(1)
要去找回慈悲的聖遺物	I will look for the divine artifacts of the mercy	자비의 성유물을 찾아 오겠다고 한다
裝置裡出現了水滴狀的寶石	A teardrop-shaped jewel appeared from the device	장치 안에서 물방울 모양의 보석이 나왔습니다
慈悲與救援(2)	Mercy and Salvation (2)	자비와 구원(2)
詢問那應該怎麼做才好	Ask him what to do	그럼 어떻게 해야 하는지 묻는다
錯過的東西就沒辦法了	Tell him that there is nothing that can be done for the ones missed	놓친 건 어쩔 수 없다고 한다
從那柯堤斯的部下的手中找回了圓形的寶石！	Acquired a round-shaped jewel from Naktis' subordinate	나크티스의 부하에게서 동그란 모양의 보석을 되찾았습니다
慈悲與救援(3)	Mercy and Salvation (3)	자비와 구원(3)
說要回到小會堂	I will go to the Small Hall	소회당으로 가겠다고 한다
無止盡的不敬	Endlessly Blasphemous	끝없이 불경스러운
會幫你找聖物	I will retrieve the Relics	성물을 찾아 주겠다고 한다
藏得很隱密的聖物	Well Hidden Holy Relics	꼭꼭 숨은 성물
別擔心，交給我吧	Tell her not to worry and trust you	걱정 말고 맡겨달라고 한다
情勢很危險，最好放棄	Better give up as it's dangerous	위험하니 포기하는 게 좋겠다고 한다
祭司們的研究報告書	Research Reports of the Priests	사제들의 연구 보고서
會幫你帶回研究報告書	I will retrieve the research reports	연구 보고서를 구해 주겠다고 한다
機械裝置的秘密	The Secret of the Machine	기계장치의 비밀
要解開秘密	I will solve the secret	비밀을 풀겠다고 한다
緊急狀況	Critical Situation	긴급 상황
要搶奪靈力信物	I will retrieve the Holy Symbol of Spiritual Power	영력의 신표를 쟁탈하겠다고 한다
貝伊尼卡祭壇的鑰匙	Karuna Altar Key	베이니카 제단의 열쇠
要幫靈力信物充電	I will recharge the Holy Symbol of Spiritual Power	영력의 신표를 충전하겠다고 한다
用魔族來補充魔力實在是太不像話了	Tell him that it doesn't make sense to recharge magical power using demons	마족으로 마력을 채우는건 말도 안된다고 한다
關於神聖的魔力和魔族	About the divine magical power and the demons	신성한 마력과 마족에 대해
正在將信物插入	Inserting the Holy Relic	신표를 끼워넣는 중
積滿灰塵的古書	Dusty Old Books	먼지 쌓인 고서
以後會幫你	I will help him later	나중에 도와주겠다고 한다
轉眼之間	Eyes Off for a Moment	한눈 판 사이
要再更多	More and More	많이 더 많이
詢問要如何幫忙	Ask her how you can help	어떻게 도와줄지를 묻는다
超強效能	Tremendous Effects	엄청난 효능
要去實驗看看	I will test it out	시험해 보겠다고 한다
為了朝聖者(1)	For the Pilgrim (1)	순례자를 위해(1)
會幫你收集月薊	I will get thistles for him	달엉겅퀴를 구해 주겠다고 한다
為了朝聖者(2)	For the Pilgrim (2)	순례자를 위해(2)
會幫你帶回肉	I will get some meat	고기를 구해 오겠다고 한다
詛咒的真面目(2)	True Origin of the Curse (2)	저주의 실체(2)
為了朝聖者(3)	For the Pilgrim (3)	순례자를 위해(3)
餵他吃藥看看	I will try feeding him the medicine	약을 먹여 보겠다고 한다
這種事情自己試看看吧	Tell her to do that herself	그 정도는 직접 하라고 한다
詛咒的真面目(1)	True Origin of the Curse (1)	저주의 실체(1)
無視他然後繼續走原路吧	Ignore and keep going on your way	무시하고 가던 길 가자
為了讓朋友能回到女神身邊把他埋起來吧！	Tell him to bury him so that he could go to the goddesses	친구가 여신께 갈 수 있도록 묻어주자고 하자
安慰他後就離開吧！	Comfort him before you leave	위로하고 자리를 떠나자
要一起做	I will be with him	함께 하겠다고 한다
就先告辭了	I will leave now	이만 떠나겠다고 한다
隨機應變(1)	Adapting to Circumstances (1)	임기응변(1)
詢問要找的東西是什麼	Ask him what you should look for	찾아야 할 것이 무엇인지 묻는다
不知道為什麼不是很喜歡	I don't have a good feeling about it	왠지 께름칙하다고 한다
隨機應變(3)	Adapting to Circumstances (3)	임기응변(3)
完成卷軸後就會回來	I will complete the scroll	스크롤을 완성해 오겠다고 한다
隨機應變(4)	Adapting to Circumstances (4)	임기응변(4)
隨機應變(5)	Adapting to Circumstances (5)	임기응변(5)
要去卡烏爾雷祭壇看看	Tell him to go to Apgaule Altar	가울레 제단으로 가 보겠다고 한다
最後的鑰匙	The Last Key	마지막 열쇠
要去找鑰匙	I will find the key	열쇠를 찾으러 가겠다고 한다
往帕薩拉祭壇	To Pasala Altar	파사라 제단으로
要去帕薩拉祭壇	I will go to Pasala Altar	파사라 제단으로 가겠다고 한다
在秘密的終點	The Secret at the End	비밀의 끝에서
那柯堤斯的憤怒	Naktis' Wrath	나크티스의 분노
正在開啟門	Opening the door	문 여는 중
詛咒的寶珠	Cursed Orb	저주의 보주
如果有看到的話就帶給你	I will bring it if you see it	보게 된다면 가져다 주겠다고 한다
偽裝	Masquerade	위장
要調查看看	I will investigate it	조사해 보겠다고 한다
正在察看機械裝置	Looking at the machinery device	기계 장치 살피는 중
主教的最後使命(1)	The Bishop's Last Mission (1)	주교의 마지막 사명(1)
去試驗最後的證明	Go to test the last verification	마지막 증명을 시험하러 간다
先暫時留點準備的時間吧	Take some time to prepare	잠시 준비할 시간을 갖자
隨機應變(2)	Adapting to Circumstances (2)	임기응변(2)
會幫你找朋友	I will find his friend	친구를 찾아 주겠다고 한다
正在搜索祭司的屍體	Collecting the corpses of the priests	사제의 시신 수습 중
弟子萊恩斯的事情	Disciple Laius' Circumstances	제자 라이어스의 사정
要是不嫌棄我的話我能協助研究	I am going to help the research if you are okay with me	나라도 괜찮다면 연구를 돕겠다고 한다
安慰之後離開了位子	Comfort him and leave	위로하고 자리를 떠난다
組合中	Combining	조합하는 중
師父留下的東西	The Master's Legacy	스승이 남긴 것
說會去收集靈氣	Tell him that you will go gather vigor	영기를 모아오겠다고 한다
說接下來自己看著辦吧	Tell him to do it himself from now on	이제부터는 알아서 하라고 한다
關於師父的研究	About the research of the master	스승의 연구에 대해
智慧的引領	Wisdom of Guidance	지혜의 인도
說會將智慧的引領石找來	Tell him that you will obtain the guide stone of the wisdom	지혜의 인도석을 구해 오겠다고 한다
弟子侯內斯的事情	Disciple Hones' Circumstances	제자 호네스의 사정
正在傳達萊恩斯的事情	Passing the words of Laius	라이어스의 이야기를 전하는 중
要求仔細說清楚	Ask him what he meant	무슨 말인지 자세히 알려달라고 한다
危險的探勘準備(1)	Preparations for the Dangerous Search (1)	위험한 탐색 준비(1)
詢問要幫忙什麼	Ask him how you could help him	무엇을 도우면 되냐고 묻는다
要你去問其他人	Ask him to look for another person	다른 사람을 알아보라고 한다
危險的探勘準備(2)	Preparations for the Dangerous Search (2)	위험한 탐색 준비(2)
說沒有辦法而放棄	Give up since there's nothing to do	어쩔 수 없다며 포기한다
弟子萊恩斯的內心	Mind of Disciple Laius	제자 라이어스의 속마음
要求說出這段時間發生的事情	Tell him what has happened so far	그 간의 일을 이야기 해 준다
沒有回答	Don't answer	대답하지 않는다
正在說這段時間的事情	Telling him what has happened lately	그 간의 일을 이야기하는 중
契約的空間魔石(1)	The Spatial Magic Gem of Contract (1)	계약의 공간마석(1)
契約的空間魔石(2)	The Spatial Magic Gem of Contract (2)	계약의 공간마석(2)
安置中	Laying the remains	안치 중
正在投入空間魔石	Inserting the Spatial Magic Gem	공간마석 투입 중
約定的空間魔石(1)	The Spatial Magic Gem of Promise (1)	약속의 공간마석(1)
約定的空間魔石(2)	The Spatial Magic Gem of Promise (2)	약속의 공간마석(2)
正在破壞	Destroying it	파괴하는 중
祭物的空間魔石(1)	The Spatial Magic Gem of Sacrifice (1)	제물의 공간마석(1)
祭物的空間魔石(2)	The Spatial Magic Gem of Sacrifice (2)	제물의 공간마석(2)
完成的空間魔石(1)	Completed Spatial Magic Gem	완성된 공간마석
正在融合空間魔石	Combining the Spatial Magic Gem	공간마석 융합 중
師父隱藏空間	Master's Hidden Space	스승의 숨겨진 공간
正在使用空間魔石	Using the Spatial Magic Gem	공간마석 사용 중
師父留下的東西	Object Left by the Master	스승이 남긴 물건
遺產確認中	Checking the inheritance	유산 확인 중
想傳達的話(1)	Passing Words (1)	전하고 싶은 말(1)
想傳達的話(2)	Passing Words (2)	전하고 싶은 말(2)
訴說與徘徊靈魂所說的對話	I've talked with the wandering spirit	헤메는 영혼과 대화한 것을 말해준다
就這樣離開位子	Leave now	이만 자리를 떠난다
想傳達的話(3)	Passing Words (3)	전하고 싶은 말(3)
前去破壞沉默之甕	Let's go to destroy the pot	침묵의 항아리를 파괴하러 간다
說看起來很危險，要就此打住	Tell him that you will quit since it looks dangerous	위험해보이니 그만두겠다고 한다
關於消滅靈魂	About the elimination of the spirit	영혼의 소멸에 대해
也很會察言觀色	You have some senses	눈치도 빠르지
並非自由之身(1)	No Freedom (1)	자유의 몸이 아냐(1)
說會再去尋找靈魂	I'll look for the spirit again	다시 영혼을 찾아보겠다고 한다
並非自由之身(2)	No Freedom (2)	자유의 몸이 아냐(2)
說會用淨化粉燒掉	Tell him that you would burn him with the purification powders	정화가루로 태워버리겠다고 한다
說自己的過錯自己擔	Tell him to resolve his fault himself	자신의 과오는 스스로 해결하라고 한다
正在堆屍骨	Piling up the skeletons	유골 쌓는 중
往自由邁出一步	One Step Closer to Freedom	자유로 한걸음
說不用擔心，把事情交給他	Tell him not to worry	걱정말고 맡겨달라고 한다
神速精準[擊劍手轉職]	Quick and Accurate [Fencer Advancement]	신속정확[펜서 전직]
念力法師的魔法學習[念力法師轉職]	Magic Studies of Psychokino [Psychokino Advancement]	사이코키노의 마법공부[사이코키노 전직]
詢問哪裡能找到	Where can I find it?	어디서 찾아볼 수 있는지 묻는다
要求給予其他課題	Give me a different task	다른 과제를 달라고 한다
靈魂和感情的研究[鎖鏈法師轉職]	Research of Spirits and Emotions [Linker Advancement]	영혼과 감정의 연구[링커 전직]
渾沌的魔法師之塔[奇術師轉職]	Mage Tower in Chaos [Thaumaturge Advancement]	혼돈의 마법사의 탑[쏘마터지 전직]
最好讓開	It's best to face it	물러나는 게 좋을 것 같다
元素使的實戰經驗[元素使轉職]	Real Experiences of Elementalist [Elementalist Advancement]	엘리멘탈리스트의 실전 경험[엘리멘탈리스트 전직]
詢問做什麼才好	What should I do?	무엇을 하면 되는 지 묻는다
工兵的實力證明[工兵轉職]	Sapper's Proven Abilities [Sapper Advancement]	새퍼의 실력 증명[새퍼 전직]
這裡那裡[獵人轉職]	This and That [Hunter Advancement]	여기저기[헌터 전직]
活下來的毒[巫蠱師轉職]	Living Poison [Wugushi Advancement]	살아있는 독[무고사 전직]
看起來很危險所以拒絕	That sounds dangerous; I'll pass	위험해 보이니 거절한다고 한다
魔法師之塔偵察任務[斥侯轉職]	Reconnaissance Duty at Mage Tower [Scout Advancement]	마법사의 탑 정찰 임무[스카우트 전직]
那樣的話太勉強了	That's a bit too much for me	그것까진 무리라고 한다
魔力控制測試[奇術師轉職]	Controlling Magic Test [Thaumaturge Advancement]	마력 제어 시험[쏘마터지 전직]
我會展示給你看	I'll show you	보여 주겠다고 한다
還不具備那種實力	I'm not powerful enough for that yet	아직 그럴 실력은 못 된다고 한다
以暗屬性當作對象的姿態[元素使轉職]	The Attitude towards the Dark Property [Elementalist Advancement]	암속성을 상대하는 자세[엘리멘탈리스트 전직]
不能有弱點	There can be no weaknesses	약점은 있을 수 없다고 한다
多練練再來	I'll come back after I train a bit more	수련을 더 쌓고 오겠다고 한다
毒的高手[巫蠱師轉職]	The Master of Poison [Wugushi Advancement]	독의 고수[무고사 전직]
接受委託	I'll accept your request	의뢰를 받겠다고 한다
我拒絕到那麼危險的地方	That place is dangerous; I'll pass	그런 위험한 곳은 거절하겠다고 한다
斥侯的戰鬥能力[斥侯轉職]	The Battle Abilities of Scout [Scout Advancement]	스카우트의 전투 능력[스카우트 전직]
詢問委託的內容	Tell me about the request	의뢰의 내용을 묻는다
好像很危險，我拒絕	That sounds dangerous; I'll pass	위험할 것 같으니 거절한다
支援德巴西安嶺的王國軍[隨軍牧師轉職]	Supporting the Royal Army at Dvasia Peak [Chaplain Advancement]	드바시아 고개의 왕국군 지원[채플린 전직]
會幫助王國軍	I'll help the Royal Army	왕국군을 돕겠다고 한다
和我無關的事	It does not concern you	나랑은 관계없는 일이라고 한다
符文師和符文石[符文師轉職]	The Rune Caster and the Rune Stone [Rune Caster Advancement]	룬캐스터와 룬 스톤[룬캐스터 전직]
詢問材料是什麼	Ask what the materials are	재료가 무엇인지 묻는다
危急的賓申塔斯部隊(1)	Vincentas' Squan In Peril(1)	위기의 빈센타스 부대(1)
危急的賓申塔斯部隊(2)	Vincentas' Squan In Peril(2)	위기의 빈센타스 부대(2)
暗殺者艾保尼風(1)	Assassin Ebonypawn(1)	암살자 에보니폰(1)
暗殺者艾保尼風(2)	Assassin Ebonypawn(2)	암살자 에보니폰(2)
暗殺者艾保尼風(3)	Assassin Ebonypawn(3)	암살자 에보니폰(3)
暗殺者艾保尼風(4)	Assassin Ebonypawn(4)	암살자 에보니폰(4)
暗殺者艾保尼風(5)	Assassin Ebonypawn(5)	암살자 에보니폰(5)
暗殺者艾保尼風(6)	Assassin Ebonypawn(6)	암살자 에보니폰(6)
詢問王室的故事	What is the story behind the royal family?	왕실의 사연에 대해 물어본다
暗殺者艾保尼風(7)	Assassin Ebonypawn(7)	암살자 에보니폰(7)
暗殺者艾保尼風的最後	The End of Ebonypawn	암살자 에보니폰의 최후
暗殺者的信物	The Sign of the Assassin	암살자의 증표
巫女的大結界[巫女轉職]	Great Miko Barrier[Miko Advancement]	무녀의 대결계[무녀 전직]
觀察中	Observing	관찰 중
在周圍找找看拓本材料	Let's obtain the materials for rubber copies around here	탁본 재료를 주위에서 구해 보자
在戰利品口袋裡頭找到了可以拓印拓本的合適材料。	You have found adequate materials to make rubbings from the monster's inventory	전리품 주머니 안에서 탁본을 뜰 만한 적당한 재료들을 찾았습니다
比王國歷史更悠久的城牆(1)	The Ramparts More Durable Than the Kingdom (1)	왕도보다 오래 가는 성벽(1)
正在察看碑石	Looking at the tombstone	비석 살펴 보는 중
比王國歷史更悠久的城牆(2)	The Ramparts More Durable Than the Kingdom (1)	왕도보다 오래 가는 성벽(2)
有可以來幫忙的人嗎？	Can Someone Help?	도와 줄 사람?
接受提議	Accept the suggestion	제안을 받아들인다
食用凱帕的方法(1)	How to Eat a Kepa (1)	케파를 먹는 법(1)
關於在這裡做的事	About the work you are doing here	여기에서 하는 일에 대해
食用凱帕的方法(2)	How to Eat a Kepa (2)	케파를 먹는 법(2)
正在塗草汁	Applying the Grass Juice	풀즙을 바르는 중
我會前往貝吉歐絕壁並回來	I will go to Vseio Cliffs	베지오 절벽으로 다녀 오겠다고 한다
第一個碑文(1)	The First Epitaph (1)	첫 번째 비문(1)
第一個碑文(2)	The First Epitaph (2)	첫 번째 비문(2)
正在察看碑石	Looking at the tombstone	비석을 살펴 보는 중
閱讀祕文	Read the epitaph	비문 읽기
第二個碑文(1)	The Second Epitaph (1)	두 번째 비문(1)
第二個碑文(2)	The Second Epitaph (2)	두 번째 비문(2)
第二個碑文(3)	The Second Epitaph (3)	두 번째 비문(3)
說明白了	Tell him that you understand	이해했다고 한다
說會找其他辦法	Tell him that you will look for other methods	다른 방법을 찾겠다고 한다
請按照鐵匠的建議製做出黏著劑	Make the glue the blacksmith advised to you	대장장이의 조언대로 접착제를 만드세요
第二個碑文(4)	The Second Epitaph (4)	두 번째 비문(4)
正在黏貼碑石	Gluing the tombstone fragments	비석을 붙이는 중
第二個碑文(5)	The Second Epitaph (5)	두 번째 비문(5)
正在閱讀祕文	Reading the epitaph	비문을 읽는 중
第三個碑文(1)	The Third Epitaph (1)	세 번째 비문(1)
正在撥開藤蔓	Searching through the bushes	덩굴을 헤쳐보는 중
第三個碑文(2)	The Third Epitaph (2)	세 번째 비문(2)
正在藤蔓上點火	Lighting up the bushes	덩굴에 불 붙이는 중
正在閱讀祕文	Reading the epitaph	비문 읽는 중
可能知道碑石的的人…？	Interpreting the Tombstone's Story	비석의 이야기를 알 만한 사람..?
油味	The Smell of Oil	기름 냄새
只有這個辦法	The Only Method	방법은 이것 뿐
關於正在研究的東西	About the research	연구하고 있는 것에 대해
我會帶給尤斯達斯	I will hand them over to Justas	유스타스에게 전해 주겠다고 한다
石塔封印	Sealing the Stone Tower	돌탑 봉인
嚐試移動	Move	이동해 본다
運氣差的日子	An Unlucky Day	운수 나쁜 날
有需要暫時確認的事情	I have something to do	잠시 다른 볼 일이 있다고 한다
破碎法(1)	Disintegration (1)	파쇄법(1)
這點程度我可以幫你找	I can get them	그 정도는 구해 줄 수 있다고 한다
破碎法(2)	Disintegration (2)	파쇄법(2)
當然能找給你	I can get them for sure	물론 구해 줄 수 있다고 한다
那就先走一步了	I should go back	그만 가 보겠다고 한다
大教堂淨化作業	Purifying the Great Cathedral	대성당 정화 작업
會幫你消滅魔族們	I will defeat the monsters	마족들을 처치해 주겠다고 한다
我會用單眼鏡看看	Look around with Monocle	모노클로 둘러보라고 한다
吸引視線(1)	Drawing Attention (1)	시선 끌기(1)
詢問是否有計畫	Do you have any plans?	계획이 있는지 묻는다
爆音彈好像很危險	The Resounding Bomb may be dangerous	폭음탄은 위험할 것 같다고 한다
吸引視線(2)	Drawing Attention (2)	시선 끌기(2)
我會偷來炸彈	I will go steal the bombs	폭탄을 훔쳐 오겠다고 한다
吸引視線(3)	Drawing Attention (3)	시선 끌기(3)
吸引視線(4)	Drawing Attention (4)	시선 끌기(4)
等待並摀住耳朵	Wait with your ears covered	귀를 막고 기다린다
遞給啞彈	Hand over the unexploded bombs	불발탄을 건네준다
我會找看看	I will try finding it	한번 찾아보겠다고 한다.
說以後再做。	Tell him that you would do it later	나중에 하겠다고 한다.
四面楚歌	Surrounded by Enemies	사면초가
一起移動	Let's move	이동하자고 한다
我還有暫時要看的事情	I have something to do	잠깐 다른 볼일이 있다고 한다
奪回屯駐地(1)	Reclaim the Camp (1)	주둔지 탈환(1)
我無法幫忙	I can't help you	도와줄 수 없다고 한다
奪回屯駐地(2)	Reclaim the Camp (2)	주둔지 탈환(2)
我會收集裝備回來	I will go collect the equipment	장비를 모아 오겠다고 한다
我無法幫忙	I can't help you	돕지 않겠다고 한다
奪回屯駐地(3)	Reclaim the Camp (3)	주둔지 탈환(3)
說現在還不行	I'm not yet ready	아직 안됐다고 한다
奪回屯駐地(4)	Reclaim the Camp (4)	주둔지 탈환(4)
奪回屯駐地(5)	Reclaim the Camp (5)	주둔지 탈환(5)
我會再想想	Think about it one more time	다시 한번 생각하라고 한다
被隱藏的聖所	Hidden Area	숨겨진 장소
我會去收集	I'll collect it	수집하겠다고 한다
觸碰不到的地方(1)	A Place Unreachable (1)	닿을 수 없는 곳(1)
我不會和魔族做交易	I won't deal with the demons	마족과는 거래를 하지 않겠다고 한다
觸碰不到的地方(2)	A Place Unreachable (2)	닿을 수 없는 곳(2)
我會那樣做	I will do that	그렇게 하겠다고 한다
觸碰不到的地方(3)	A Place Unreachable (3)	닿을 수 없는 곳(3)
復仇的牙齒(1)	The Teeth of Revenge (1)	복수의 이빨(1)
我會借給力量	I will lend you my power	힘을 빌려주겠다고 한다
那個力量還不夠	I am not competent enough yet	아직 그럴 힘이 못 된다고 한다
復仇的牙齒(2)	The Teeth of Revenge (2)	복수의 이빨(2)
關於魔君主布爾魯	About Demon Lord Blut	마군주 블룻에 대해
復仇的牙齒(3)	The Teeth of Revenge (3)	복수의 이빨(3)
稍微再等一下	Tell her to wait a bit	잠깐 기다려달라고 한다
關於奎波爾	About the Kupoles	큐폴에 대해
過時的矜持	Old Pride	오래된 긍지
整理背叛者(1)	Ridding the Traitor (1)	배신자 정리(1)
快點告知阿爾多納幫忙的方法	Tell me how I can help Aldona	빨리 알도나를 도울 방법을 알려 달라고 한다
整理背叛者(2)	Ridding the Traitor (2)	배신자 정리(2)
那好像會有點危險	That sounds dangerous	그건 좀 위험할 것 같다고 한다
整理背叛者(3)	Ridding the Traitor (3)	배신자 정리(3)
整理背叛者(4)	Ridding the Traitor (4)	배신자 정리(4)
要消滅	I'll take care of it	처리하겠다고 한다
關於哈勃克與努亞耶雷的關係	About Hauberk and Nuaele's relationship	하우벅과 누아엘레와의 관계에 대해
鑲嵌的石頭	Lodged Stone	박힌 돌
需要做準備	I need to prepare	준비가 필요하다고 한다
對話中	Talking	대화 중
暮星	The Night Star	저녁별
暮星之鑰(1)	The Evening Star Key (1)	저녁별 열쇠(1)
我會幫忙製造鑰匙	I will help you to make the keys	열쇠를 만드는 것을 돕겠다고 한다
暮星之鑰(2)	The Evening Star Key (2)	저녁별 열쇠(2)
我會誓死守護	I will make sure to protect it	꼭 지켜주겠다고 한다
再準備一下吧	Tell her that we should prepare little more	조금 더 준비하자고 말한다
暮星之鑰(3)	The Evening Star Key (3)	저녁별 열쇠(3)
要解除封印後再回來	I will come back after unleashing the seal	봉인을 해제하고 오겠다고 한다
好像應付不來	I don't think I can handle it	감당할 수 없을 것 같다고 한다
被鎖在夜晚裡的暮星	The Evening Star at Night	밤에 잠긴 저녁별
要再準備一下	I will prepare a little more	좀 더 준비하겠다고 한다
計畫和逃走	The Planned Escape	계획과 도주
要報告	I will report about it	보고하겠다고 한다
迷宮中的哈勃克(1)	Hauberk in the Maze (1)	미로 속 하우벅(1)
追哈勃克	I will chase after Hauberk	하우벅을 쫓겠다고 한다
要再準備一下	I will prepare little more	좀 더 준비한다고 한다
迷宮中的哈勃克(2)	Hauberk in the Maze (2)	미로 속 하우벅(2)
這好像不是個好辦法	It doesn't sound like a good idea	좋은 방법이 아닌 것 같다고 한다
迷宮中的哈勃克(3)	Hauberk in the Maze (3)	미로 속 하우벅(3)
沒自信能消滅那麼多的魔族	I'm not sure if I can take down all those demons	저 많은 마족을 처치할 자신이 없다고 한다
迷宮中的哈勃克(4)	Hauberk in the Maze (4)	미로 속 하우벅(4)
一定要抓住他	I will get him for sure	반드시 잡겠다고 한다
迷宮中的哈勃克(5)	Hauberk in the Maze (5)	미로 속 하우벅(5)
好好準備吧	I will prepare a lot	확실히 준비하자고 한다
轉移縫隙(1)	The Dimensional Crack (1)	전이 틈새(1)
要進行儀式	Let's begin the ritual	의식을 시작하자고 한다
轉移縫隙(2)	The Dimensional Crack (2)	전이 틈새(2)
要將轉移傷痕收集起來	I will collect the Traces of Transference	전이의 흔적을 모아 오겠다고 한다
轉移縫隙(3)	The Dimensional Crack (3)	전이 틈새(3)
去一趟再回來	I'll go now	다녀 오겠다고 한다
轉移縫隙(4)	The Dimensional Crack (4)	전이 틈새(4)
轉移縫隙(5)	The Dimensional Crack (5)	전이 틈새(5)
轉移縫隙(6)	The Dimensional Crack (6)	전이 틈새(6)
快準備好了	Tell her that it will be ready soon	곧 준비된다고 한다
關門	Shutting the Door	문 닫기
說要阻止那些魔族	I will defeat those demons	그 마족들을 저지하겠다고 한다
會沒事的	I will be fine	괜찮을 것이라 한다
遵照本分	According To One's Duty	본분에따라
說會去找遺物	I will look for keepsakes	유품을 찾아 보겠다고 한다
還有更緊急的事	Tell her that there is a more emergent issue	더 급한 일이 있다고 한다
無差別處治	Unreasonable Defeat	무분별한 처치
要去消滅他再回來	I will come back after defeating it	처리하고 오겠다고 한다
下次再做	I will do it next time	다음에 하겠다고 한다
恢復權威	Recovering Prestige	권위 회복
我會回收碎片	I will retrieve the fragments	파편을 회수하겠다고 한다
說要先去見瓦卡麗涅	I will meet the Vakarine first	바카리네를 먼저 만나겠다고 한다
無處可去的憤怒	The Fury	갈 곳 잃은 분노
說要除掉那些魔族	I will defeat the demons	그 마족들을 처리하겠다고 한다
迪歐尼斯的腳趾甲	Dionys' Claws	디오니스의 발톱
我會把腳趾甲回收	I will retrieve the claws	발톱을 회수해 오겠다고 한다
關於迪歐尼斯	About Dionys	디오니스에 대해
沒有主人的星星	Lost Star	주인 없는 별
說要去收集星之標誌	I will collect the Marks of Star	별의 징표를 모아 오겠다고 한다
好像沒那個時間	I don't have for that	그럴 시간은 없을 것 같다고 한다
女神之眼	Eyes of the Goddess	여신의 눈
以後再消滅	I will take care of it later	나중에 처리하겠다고 한다
藏匿的背叛者	The Hidden Betrayer	숨어든 배신자
交叉路的魔族	Demons at the Crossroads	교차로의 마족
搞不好會被女神臭罵一頓	I might be scolded by the goddess	여신께 혼날지도 모른다고 한다
阻塞的地方	A Dead End	막다른 곳
不會有事的	Everything will be alright	별 일 없을거라고 한다
迪歐尼斯的食物	Food for Dionys	디오니스의 먹이
馬上就會好起來的	He'll be cured soon	금방 나을 것이라고 한다
消除小縫隙	Eliminate the Small Gaps	작은 틈 없애기
我會除掉	I will get rid of it	제거하겠다고 한다
再給一點時間	I need some more time	조금만 더 시간을 달라고 한다
轉移縫隙(7)	The Dimensional Crack (7)	전이 틈새(7)
凱都拉商團志願者	Kedoran Merchant Alliance Applicant	케도라 상단 지원자
神祕的樹苗	The Mysterious Tree	신비한 묘목
還有很多還沒做的事情所以拒絕	Decline since you still have some tasks to complete	아직 못 다한 일이 남았다며 거절한다
關於神祕的少女	About the mysterious girl	신비한 소녀에 대해
未知的力量	Unknown Power	알 수 없는 힘
詢問是否還有需要幫忙的事	Ask her if there's anything more to help	더 도와줄 것이 있느냐고 묻는다
既然已經幫完忙所以打算先走	You leave since you've helped her enough	도와줬으니 이만 가 보겠다고 한다
實驗淨化結果	The Result of the Test Purification	시험 정화의 결과
鼓勵說一切會很順利	Tell her that everything will be alright	잘 될거라고 격려한다
該做的事都做完了所以想先離開	Leave since you completed all the tasks	볼 일은 전부 마쳤으니 떠난다
大規模淨化的準備	Preparing for Large-Scale Purification	대규모 정화의 준비
轉交箱子	Box Delivery	상자 배달
現在全都錯了	It's All Over Now	이젠 다 틀렸어
詢問發生了什麼事然後說要幫忙	Ask him what's the matter and I will help	무슨 일이 있는지 묻고 도와주겠다고 한다
別在意走就走自己該走的路吧	Ignore and just go on your way	무시하고 갈 길 가자
關於克林卡的莊園	About the Greene family farm	그린가의 장원에 대해
除草作業	Weeding	제초작업
幫你消除蒲公英種子	I will get rid of the dandelions	민들레 싹을 제거해 주겠다고 한다
路途還很遙遠要先離開	Leave since you are busy	갈 길이 바쁘니 떠난다
不可信的人們	Unreliable Folk	못 믿을 사람들
非常可惡	Big Inconvenience	아주 괘씸해
要幫你找包袱	I will find her luggages	봇짐을 찾아 주겠다고 한다
柯拉佩達的調查	The Klaipeda Investigation	클라페다에서의 조사
要你接受其他人的幫助	Tell him to get help from other people	다른 사람의 도움을 받으라고 한다
好兆頭	A Good Sign	좋은 징조
監督官的橫行霸道	The Supervisor's Tyranny	감독관의 횡포
有要求的說會答應	I will listen to his requests	요구사항이 있다면 들어 주겠다고 한다
沒打算讓他利用我	I don't want be controlled	이용당할 생각은 없다고 한다
關於夏頓家的農場	About the farm of Shaton family	샤튼 가의 농장에 대해
逃不過我的法眼	You Can't Fool Me	내 눈은 못 속여
不想被捲進這件事裡	I don't want to be involved in this kind of matters	이런 일에 휘둘리고 싶지 않다고 한다
德魯伊的行蹤	The Druid's Whereabouts	드루이드의 행방
陷入危機的農夫們	Farmers in Danger	위기의 농부들
要先把人救出來	I will rescue the people first	일단 사람들을 구하겠다고 한다
關於農場的汙染	About the Corruption in the Farm	농장의 오염에 대해
放了很久的種子(1)	Old Seeds (1)	오래된 씨앗(1)
好像沒有我能做的事	Tell him that the tasks can't be completed by you	내가 할 수 있는 일은 없을 것 같다고 한다
關於種子	About the seeds	씨앗에 대해
放了很久的種子(2)	Old Seeds (2)	오래된 씨앗(2)
我去裝水	I will get the water	물을 떠 오겠다고 한다
這點程度應該沒問題	Tell him that it will be alright	그 정도는 괜찮을 거라고 한다
放了很久的種子(3)	Old Seeds (3)	오래된 씨앗(3)
哄騙	Steam Boiled	구워 삶기
拜託他住在農場看看	Ask him so that you could stay in the farm	농장에 머물게 해 달라고 부탁해 본다
離開農場	Leave the farm	농장을 나가자
眼中釘怪物	The Disturbing Monster	눈엣 가시 몬스터
要離開農場	I will leave the farm	농장에서 나가겠다고 한다
計畫歉收	Intentional Failed Harvest	의도된 흉작
詢問發生了什麼事可以幫忙	Ask her what's the matter and help	도와줄 테니 무슨 일인지 묻는다
苗頭不對，快避一下	You don't feel good about it so avoid it	조짐이 안좋으니 피하자
關於農場的作物	About the crops at the farm	농장의 작물에 대해
意料之外的結果	Unexpected Results	예상치 못한 결과
會幫你消滅他不用擔心	Tell her not to worry since you will defeat them	처치해 줄 테니 걱정 말라고 한다
今天也要工作	Today's Work	오늘도 일을 한다
對自己來說也是很麻煩的工作	Tell him that it's hard	자신도 버거운 일이라고 한다
關於夏頓農場的管理者們	About the managers at the farm of Shaton family	샤튼 농장의 관리자들에 대해
隱藏種子	Hidden Seeds	숨겨둔 종자
要幫忙找種子	I will find the seeds for him	씨앗을 찾아 주겠다고 한다
無奈的農場主人	The Farm's Stubborn Owner	막무가내 농장주
要試著說服看看	I will try persuading him	설득 해 보겠다고 한다
就算是啟示者應該也沒辦法	Tell him that even a Revelator can't do it	계시자라도 안될 것 같다고 한다
說服的鑰匙	The Key to Persuasion	설득의 열쇠
不想被捲進去	I don't want to get involved	엮이고 싶지 않다고 한다
關於庫魯德夏頓	About Gord Shaton	고르드 샤튼에 대해
由我來報仇	Revenge Shall Be Mine	복수는 나의 것
再去說服一次	Persuade one more time	다시 한번 설득한다
看他心情好像很不好先避開耳目	Leave since he doesn't seem like he is in a good mood	기분이 매우 좋지 않은 것 같으니 물러난다
不知道他會作出什麼危險的事要好好盯著他	He may do something dangerous so keep looking at him	위험한 짓을 할 지도 모르니 지켜본다
好不安，還是先避一下吧	Leave here since you feel something dangerous	불안하니 자리를 피하자
現在才要開始	Just the Beginning	이제부터 시작
要去跟芭內莎夏頓進行對話	I will talk to Vanessa Shaton	바네사 샤튼과 대화해 보겠다고 한다
從這裡開始，就是由德魯伊負責了	Tell him that the druid should take care from here	여기서부턴 드루이드가 할 일이라고 한다
總之我們的主人	Anything For Our Master	어쨌거나 우리 주인님
有同感	I agree	공감한다고 한다
但好像不應該是這樣	Tell him that it's not right	그래도 이건 아닌 것 같다고 한다
管家的人事管理	Managing the Steward's People	집사의 사람 관리
要去找藥袋	I will find the pocket that contains the medicine	약 주머니를 찾아 주겠다고 한다
地道看起來有點那個	The Underground Tunnel	땅굴은 좀 그래
太猶豫不決了，還是決定拒絕	Reject it since you don't feel good about it	찜찜하니 거절한다
將責任推給別人	Shifting Responsibility	책임을 떠넘기기
只是照指示去作而已所以我拒絕	Reject it since you just did what you were told	하란대로 했을 뿐이니 거절한다
落伍者(脫隊的人)	The Straggler	낙오자
會去接你	I will take him	데려다 주겠다고 한다
自己去	Tell him to go alone	혼자 가라고 한다
堤拉修道院的苦難	Trouble at the Tyla Monastery	틸라 수도원의 고난
說能幫得上忙的一定會幫	Tell him that you would help	도울 수 있는 데까지 돕겠다고 한다
說身體還沒完全恢復	Tell him that you are not completely healed yet	아직 몸이 다 낫지 않았다고 한다
關於艾保尼風	About Ebonypawn	에보니폰에 대해
救援活動輔助	Relief Assistance	구호활동 보조
說會向獵人詢問	Tell him that you will ask the Hunters	헌터들에게 물어보겠다고 한다
說很遺憾地，他不知道方法	Tell him that you don't know how to do it	안타깝지만 방법을 모르겠다고 한다
關於修道院的情況	About the circumstances at the monastery	수도원의 상황에 대해
找到證據	Searching for Evidence	증거를 찾아서
說要去找獵人雷伊娜	Tell him that you will meet with Hunter Reina	헌터 레이나에게 가보겠다고 한다
搜查陷阱	Search for the Trap	함정 수색
詢問是否有找到陷阱的方法	Ask him if there's any way to find the trap	함정을 찾을 방법이 없느냐고 묻는다
麻痺解除之前只能等待	Wait until the paralysis goes away	마비가 풀릴 때까지 기다린다
關於知道陷阱主人的方法	The way to know the owner of the trap	함정의 주인을 아는 방법에 대해
協助的第一步	The First Step of Cooperation	협조를 위한 첫걸음
正在展示陷阱	Showing the trap	함정을 보여주는 중
把陷阱交給佛特斯	Go see Potos to give him the trap	포토스에게 함정을 전해 주러 간다
珍貴的經典	The Precious Scripture	소중한 경전
盡可能減少危險	Reducing the Danger	위험을 하나라도 줄여보기
說那種事情就交給他	Tell him that you could handle the task	그런 일이라면 맡겨 달라고 한다
偶爾要看看後頭	Looking Back Sometimes	가끔은 뒤를 돌아보자
會盡力提供協助	Tell him that you will help	기꺼이 도와주겠다고 한다
因為很忙錄而拒絕了	Reject since you are busy	바쁘다며 거절한다
製作箭頭	Making Arrowheads	화살촉 만들기
聽看看是什麼事	Listen what happened	무슨 일인지 들어 보자
說在這附近沒事情要做而拒絕了	Reject since there isn't anything to do	더 이상 주변에 볼일은 없다며 거절한다
可信賴的夥伴	Reliable Partner	듬직한 파트너
說快回去同伴身邊	Tell him to go back to his colleagues	어서 동료들에게 돌아가라고 한다
絕對不行	Not A Chance	절대 안돼
說會試著說服馬勒寇	Tell him that you would persuade Marko	마르코를 설득해 보겠다고 한다
說放棄吧	Tell him that we should give up	포기하자고 한다
都準備好了嗎？	Everyone Ready?	모두들 준비 되었나?
說傳達之後再回來	Tell him that you would hand them over to him	전하고 오겠다고 한다
未知的毒(1)	Unknown Poison (1)	모르는 독(1)
說會儘早回來	Tell him that you would come back fast	빠르게 다녀 오겠다고 한다
說希望能搬到都市去	Tell him that it will be better to move to a city	도시로 옮기는 것이 좋겠다고 한다
未知的毒(2)	Unknown Poison (2)	모르는 독(2)
未知的毒(3)	Unknown Poison (3)	모르는 독(3)
還有一樣最後的材料	The Last Material One More Time	마지막 재료가 하나 더
說會立刻找來	Tell him that you would gather them quickly	금방 모아 오겠다고 한다
說需要準備一下	Tell him that you need some time to prepare	잠시 준비가 필요하다고 말한다
中途報告	Interim Report	중간 보고
不可小看下一個對手	A Difficult Opponent	다음 상대는 만만하지 않다
不簡單的對手	A Worthy Opponent	녹록치 않은 상대
香甜的膏藥(1)	Sweet Ointment (1)	달콤한 고약(1)
說有比那更急迫的事	Tell him that you have more urgent issue that that	그런 것보다 더욱 급한일이 있다고 한다
香甜的膏藥(2)	Sweet Ointment (2)	달콤한 고약(2)
挑剔的修道士	Fastidious Ointment (2)	까칠한 수도사
說會試著說服古斯	Tell him that you would persuade Goss	거스를 설득해 보겠다고 한다
力量的證明	Proof of Strength	힘의 증명
可疑的異鄉人	A Suspicious Stranger	석연치 않은 이방인
關於艾保尼風的保護	About the protection of Ebonypawn	에보니폰의 보호에 대해
慘遭殺害的旅人	The Murdered Traveler	살해당한 여행자
詢問是否還有其他奇怪的事情	Ask him if there were any other strange things	다른 이상한 것은 없었는지 묻는다
露出馬腳	True Colors Revealed	드러난 마각
感覺很不情願並且拒絕了	Reject since you don't feel good about it	왠지 꺼림칙하니 거절한다
為了見到修道院長	Meeting the Abbot	수도원장을 만나기 위해
關於艾保尼風的追蹤	About the chase of Ebonypawn	에보니폰의 추적에 대해
製造安靜的環境	Creating a Quiet Environment	조용한 환경 만들기
說會幫忙消滅怪物，不用擔心	I will defeat the monsters so don't worry	몬스터를 처치해 줄 테니 걱정 말라고 한다
說現在已經很安全了	It looks safe	충분히 안전해 보인다고 한다
經常淨水	Filtered Water	물은 항상 걸러서
說應當要幫忙	I will definitely help	응당 도와주겠다고 한다
打掃入口	Cleaning Up The Entrance	진입로 청소
修道院修復作戰(1)	Mission to Retake the Monastery (1)	수도원 수복 작전(1)
修道院修復作戰(2)	Mission to Retake the Monastery (2)	수도원 수복 작전(2)
修道院修復作戰(3)	Mission to Retake the Monastery (3)	수도원 수복 작전(3)
說暫時喘口氣	Let's take a rest for a while	잠시만 숨을 돌리자고 한다
修道院修復作戰(4)	Mission to Retake the Monastery (4)	수도원 수복 작전(4)
說一起去祈禱室	Let's go to the Prayer Room	기도실로 가자고 한다
一起休息	Rest together	같이 쉰다
修道院修復作戰(5)	Mission to Retake the Monastery (5)	수도원 수복 작전(5)
召喚的事前準備(1)	Preparations for the Call (1)	부름을 위한 준비작업(1)
說會去找莫漢	I will find Moheim	모하임을 찾겠다고 한다
召喚的事前準備(2)	Preparations for the Call (2)	부름을 위한 준비작업(2)
將危機告訴他人	Notify About the Crisis	위기를 알려라
要求停一下	Stop for a while	잠시 멈춰달라고 한다
保護撤回宣言	Declare Withdrawal of Protection	보호 철회 선언
全新追擊的開始	Start of a New Chase	새로운 추격의 시작
說會去追擊艾保尼風	I will chase Ebonypawn	에보니폰을 쫓겠다고 한다
減少人頭	Lessen the Head Count	머릿수 줄이기
說自己也會幫忙	I will help too	자신도 돕겠다고 한다
清掃室內	Clean Inside	실내 청소
物品放在原位	Where it Belongs	물건은 제자리에
我最討厭課題了	The last thing I need is another task	과제라면 질색이라고 한다
我馬上消滅他再回來	I'll go and defeat it right away	당장 처치하고 오겠다고 한다
那種程度太勉強了。	That's a little too much for me	그 정돈 무리라고 한다
變得微弱的呼吸	Fading breaths	옅어지는 호흡
意識確認中	Checking consciousness	의식을 확인하는 중
以調養身體為優先	You should first get yourself together	몸을 추스리는 게 우선이라고 한다
尋找紙條中	Looking for the memo	쪽지 찾는 중
不信任的眼神	Stare of the distrust	불신의 눈초리
正在傳達亞多瑪斯的話	Relaying the story about Adomas	아도마스의 이야기 전달 중
一起走吧	Let's go together	같이 가보자고 한다
這裡發生過的事 (1)	The Incident That Happened Here (1)	이 곳에서 있었던 일 (1)
尋找殘跡中	Looking for the traces	흔적을 찾는 중
這裡發生過的事 (2)	The Incident That Happened Here (2)	이 곳에서 있었던 일 (2)
為他們的安息祈禱 (1)	Praying for Their Rest (1)	그들의 안식을 기도하며 (1)
詢問該做什麼才好	Ask what you should do	뭘 하면 되는지 묻는다
在遭受更大的殃禍之前躲開吧	Let's avoid before we receive anymore damage	더 큰 화를 입기 전에 피하자고 한다
為他們的安息祈禱 (2)	Praying for Their Rest (2)	그들의 안식을 기도하며 (2)
我再也做不下去了	I can't do it anymore	더는 못하겠다고 한다
為他們的安息祈禱 (3)	Praying for Their Rest (3)	그들의 안식을 기도하며 (3)
現在馬上就出發吧	Let's leave now	지금 바로 출발하자고 한다
真相大白	The Unfolding Truth	밝혀지는 진실
他們的下場	The Results for Them	그들을 위한 결말
沒有那種時間	We don't have time for it	그럴 시간 없다고 한다
正在安慰蕾米亞	Comforting Lemija	레미야를 위로하는 중
收件人不詳	Unknown Recipient	수취인 불명
他們的事由 (1)	The Story Behind Them (1)	그들의 사연 (1)
他們的事由 (2)	The Story Behind Them (2)	그들의 사연 (2)
無法傳達	I can't hand it over	전할 수 없다고 한다
士兵們的遺物	Soldiers' Belongings	병사들의 유품
法杖的用途(1)	Good Use For a Wand (1)	지팡이의 쓰임새(1)
法杖的用途(2)	Good Use For a Wand (2)	지팡이의 쓰임새(2)
法杖的用途(3)	Good Use For a Wand (3)	지팡이의 쓰임새(3)
法杖的用途(4)	Good Use For a Wand (4)	지팡이의 쓰임새(4)
法杖的用途(5)	Good Use For a Wand (5)	지팡이의 쓰임새(5)
法杖的用途(6)	Good Use For a Wand (6)	지팡이의 쓰임새(6)
安息之路	To the Path of Eternal Rest	안식의 길로
為了女兒(1)	Anything for the Daughter (1)	딸을 위해(1)
為了女兒(2)	Anything for the Daughter (2)	딸을 위해(2)
濃醇香(1)	An Awful Smell (1)	고약한 냄새(1)
濃醇香(2)	An Awful Smell (2)	고약한 냄새(2)
花的價值(1)	The Worth of a Flower (1)	꽃이 지닌 가치(1)
花的價值(2)	The Worth of a Flower (2)	꽃이 지닌 가치(2)
可替代的新飼料	For the Lack of Better Nourishment	대체할 새로운 먹이
恢復體力	Revitalized	기력 회복
確保安全(1)	Ensuring Safety (1)	안전확보(1)
確保安全(2)	Ensuring Safety (2)	안전확보(2)
干擾監視(1)	We're Being Watched (1)	감시방해(1)
干擾監視(2)	We're Being Watched (2)	감시방해(2)
干擾監視(3)	We're Being Watched (3)	감시방해(3)
只是個石子	It's Only a Stone	그저 돌일 뿐이야
點到為止的騙術	Useful Deception	적당한 속임수
實力堅強	Outstanding Eyesight	대단한 시력
緊急涼食	Emergency Food Supplies	비상식량
找回貴重物品(1)	Treasure Hunting (1)	귀중품 찾기(1)
找回貴重物品(2)	Treasure Hunting (2)	귀중품 찾기(2)
消滅衝過來的魔族	Defeat the Incoming Demons	몰려오는 마족 저지
魔族正式遷移	Demons on the Move	본격적인 마족들의 움직임
前往前往大地要塞	To the Fortress of the Land	대지의 요새로
很珍貴的物品啊!	Precious Object	귀한 물건이군
過度的好勝心	Competitive to the Extreme	지나친 호승심
偉大的盜墓者與冒險家的故事	Notable Grave Robbers and Adventurers	위대한 도굴꾼과 모험가 이야기
詢問能不能找到工具	Would it be possible to get the tools?	도구를 구할 수 있냐고 묻는 중
未知文字的真正意涵(1)	Deciphering the Mysterious Writings (1)	알 수 없는 문자의 정체(1)
未知文字的真正意涵(2)	Deciphering the Mysterious Writings (2)	알 수 없는 문자의 정체(2)
問問有甚麼打算	Do you have anything in mind?	짚이는 것이 있는지 물어 본다
未知文字的真正意涵(3)	Deciphering the Mysterious Writings (3)	알 수 없는 문자의 정체(3)
意料之外的地點	In an Unexpected Place	예상치 못한 장소에서
隨軍牧師大師的任務	The Chaplain Master's Errand	채플린 마스터의 임무
詛咒的根本	Origins of the Curse	저주의 근원
發怒的蜜蜂們(1)	Angry Bees (1)	성난 벌들(1)
詢問能讓	How can we make the bees calm down?	벌들을 안정시킬 수 있는 방법을 묻는다
發怒的蜜蜂們(2)	Angry Bees (2)	성난 벌들(2)
我最優秀的同伴	My Best Buddy	내 최고의 동료
不想做	Do not do it	하지 않는다
安撫神靈	Appease the Divine Spirit	신령 달래기
叫他自己做不行嗎？	Why don't you do it yourself?	직접 하라고 말한다
干擾安息者的人	Eternal Rest Interrupted	영면을 방해하려는 자
品質證明[鑑定師轉職](1)	Quality Certificate [Appraiser Advancement](1) 	품질 인증서[감정사 전직](1)
品質證明[鑑定師轉職](2)	Quality Certificate [Appraiser Advancement](2) 	품질 인증서[감정사 전직](2)
去轉交品質證明	Deliver the Quality Certificate	품질 인증서를 전달하러 간다
作賊心虛[工兵轉職]	Guilty Conscience [Sapper Advancement] (1)	도둑이 제 발 저린다[새퍼 전직]
與士兵杜米尼克對話	Talk to Soldier Dominic	병사 도미니크와 대화
偵查貝爾圖伊交叉路	Patrol Veltui Crossroads	벨투이 교차로로 정찰
消滅出現在交叉路上的怪物	Defeat the monsters that appeared near the Crossroads	교차로에 나타난 몬스터 처치
與士兵山姆森對話	Talk to Soldier Samson	병사 샘슨과 대화
在毛蟲獸肚子裡尋找訂婚戒指	Look for the engagement ring in Meleech's stomach	멜리치의 뱃속에서 약혼반지 찾기
交給士兵山姆森	Give it to Soldier Samson	병사 샘슨에게 전달
收集伊薛希奈堤懸崖裡乾掉的樹枝	Collected Dry Thorn Forest Wood from Ishisineti Cliff	이쉬시네티 벼랑에서 마른 나뭇가지 수집
調查腐爛的樹木殘根	Inspect the Rotten Stump	썩은 나무 등걸 조사
消滅樹林巨獸哥布林	Defeat Giant Red Wood Goblin	거대한 우드 고블린을 처치
與士兵里納斯對話	Talk with Soldier Rinas	병사 리나스와 대화
消滅樹林巨獸哥布林	Defeat Giant Red Wood Goblin	자이언트 레드 우드 고블린 처치
與指揮官朱利安對話	Talk to Commander Julian	지휘관 줄리안과 대화
交給士兵福爾特	Hand it over to Soldier Poulter	병사 폴터에게 전달
與士兵福爾特對話	Talk to Soldier Poulter	병사 폴터와 대화
幫助福爾特消滅附近的怪物	Defeat the monsters nearby to help Poulter	폴터를 도와 근처 몬스터 처치
消滅周圍的怪物	Defeat the nearby monsters	주변 몬스터 처치
與指揮官歐路克對話	Talk to Commander O'Rourke	지휘관 오루크와 대화
消滅攻過來的樹林哥布林	Defeat the attacking Wood Goblins	습격해오는 우드고블린 처치
與離開的貓頭鷹雕像對話	Talk to the Substitute Owl Sculpture	떠나가는 부엉이 조각상과 대화
消滅畢雷堤空地的樹精庫爾	Defeat Treegools at Byreti Vacant Lot	비레티 공터의 트리굴 처치
向離開的貓頭鷹雕像報告	Report to the Substitute Owl Sculpture	떠나가는 부엉이 조각상에게 보고
消滅樹精庫爾	Defeat Treegools	트리굴 처치
與歐路克對話	Talk with O'Rourke	오루크와 대화
在尼爾羅斯街道尋找士兵	Look for the soldiers at Niurus Highway	니우러스 가도에서 병사 찾기
與士兵卡爾路斯對話	Talk to Soldier Kallus	병사 칼루스와 대화
消滅威脅士兵的怪物	Defeat the monsters threatening the soldier	병사를 위협하는 몬스터 처치
與定居的貓頭鷹雕像對話	Talk to the Settled Owl Sculpture	정착한 부엉이 조각상과 대화
消滅周圍的樹林哥布林	Defeat nearby Ravinelarvae	주변의 우드 고블린 처치
消滅毒妖花	Defeat Ravinelarva	러바인러바 처치
與士兵戴伊紐斯對話	Talk to Soldier Dainus	병사 다이뉴스와 대화
尋找位於德利耶查濕地的其他士兵們	Look for the other soldiers at Drieza Waterland	드리에자 습지에서 다른 병사들 찾기
消滅鋼鐵巴溫	Defeat Ironbaum	아이언바움 처치
發現在破旗森林裡的墳墓	Find the grave at the Sunset Flag Forest	해진깃발숲에 있는 무덤을 발견하기
請發掘在破旗森林裡的墳墓。	Find the grave at the Sunset Flag Forest	해진깃발숲에 있는 무덤을 발견하세요.
消滅喀葛拉斯山崖的巨大怪物	Defeat the gigantic monster at Kaklas Cliff	카클라스 낭떠러지의 거대한 몬스터 처치
請消滅喀葛拉斯山崖的蘑菇型巨獸。	Defeat the gigantic mushroom-like monster at Kaklas Cliff	카클라스 낭떠러지의 버섯 모양의 거대 몬스터를 처치해 주세요.
消滅蘑菇沃特	Defeat Mushwort	머쉬워트 처치
與恐懼的貓頭鷹雕像對話	Talk to the Scared Owl Sculpture	두려운 부엉이 조각상과 대화
交給老實的貓頭鷹隊長	Give it to the Earnest Owl Chief Sculpture	성실한 대장 부엉이 조각상에게 전달
與老實的貓頭鷹隊長雕像對話	Talk with the Earnest Owl Chief Sculpture	성실한 대장 부엉이 조각상과 대화
交給意志的貓頭鷹雕像	Send the wing to the Devoted Owl Sculpture	의지의 부엉이 조각상에게 날개 전달
與軍官達扭斯對話	Talk to Officer Danus	장교 다뉴스와 대화
消滅對後防部隊虎視眈眈的怪物	Defeat the monsters that are attacking the Readguard Unit	후방부대를 노리는 몬스터 처치
尋找達扭斯的偵查兵	Look for Danus' scouts 	다뉴스의 정찰병 찾기
與達扭斯的偵查兵對話	Talk to Danus' Scout	다뉴스의 정찰병과 대화
消滅大黃蜂	Defeat Bites	바이트 처치
尋找補給官	Look for the Supply Officer	보급관 찾기
與補給官對話	Talk to the Supply Officer	보급관과 대화
回收補給品	Retrieve the Supplies	보급품 회수
交給補給官	Hand it over to the Supply Officer	보급관에게 전달
將補給品交給軍官達扭斯	Hand over the supplies to Officer Danus	장교 다뉴스에게 보급품 전달
與士兵羅伊對話	Talk to Soldier Roy	병사 로이와 대화
收集普朗基的鉤子	Obtain a Puragi's Hook	푸라기의 갈고리 수집
交給士兵羅伊	Hand it over to Soldier Roy	병사 로이에게 전달
與上級軍官皮爾力巴斯對話	Talk to Senior Officer Philipas	선임장교 필리파스와 대화
消滅丘陵上的藍色大蘑菇精	Defeat a Big Blue Griba at the hills	언덕 위의 푸른 빅 그리바 처치
向皮爾力巴斯報告	Report to Philipas	필리파스에게 보고
消滅藍色大蘑菇精	Defeat Big Blue Griba	푸른 빅 그리바 처치
尋找分隊長約翰	Look for Squad Commander Johan	분대장 요한 찾기
從周圍的怪物身上尋找報告書	Look for the report from the monsters nearby	주변 몬스터에게서 보고서 찾기
交給分隊長約翰	Give them to Squad Commander Johan	분대장 요한에게 전달
與分隊長約翰對話	Talk to Squad Commander Johan	분대장 요한과 대화
收拾分隊員的遺物	Collect the remains of a soldier	분대원의 유품 수습
交給分隊長約翰	Hand them over to Squad Commander Johan	분대장 요한에게 전해주기
追隨上級軍官皮爾力巴斯	Follow the Senior Officer Philipas	선임장교 필리파스 따라가기
上級軍官皮爾力巴斯的任務	Senior Officer Philipas' Mission	선임장교 필리파스의 임무
向上級軍官皮爾力巴斯報告	Report to Senior Officer Philipas	선임장교 필리파스에게 보고
發現一群小蘑菇精	Found a herd of small Gribas	작은 그리바 무리 발견
消滅猛攻而來的赤紅漁人怪	Defeat Red Fisherman	몰려드는 붉은 피셔맨 처치
消滅狼人	Defeat Werewolf	웨어 울프 처치
為亡者祈福	Pray for his soul	명복 빌어 주기
與士兵魯特爾巴斯對話	Talk with Soldier Rudolfas	병사 루돌파스와 대화
請與士兵魯特爾巴斯進行對話	Talk with Soldier Rudolfas	병사 루돌파스와 대화하세요
消滅突然出現的毛蟲獸	Defeat the Meleeches that suddenly appeared	갑자기 나타난 멜리치 처치
與士兵阿斯巴斯對話	Talk to Soldier Aspas	병사 아스파스와 대화
消滅展開攻擊的樹林哥布林	Defeat Wood Goblin	공격해오는 우드고블린 처치
在魔法師之塔1層與克莉妲對話	Talk to Grita at Mage Tower 1F	마법사의 탑 1층에서 그리타와 대화
在魔法師之塔2樓與克莉妲對話	Talk to Grita at Mage Tower 2F	마법사의 탑 2층의 그리타와 대화
在魔法師之塔3樓與克莉妲對話	Talk to Grita at Mage Tower 3F	마법사의 탑 3층의 그리타와 대화
在魔法師之塔4樓與克莉妲對話	Talk to Grita at Mage Tower 4F	마법사의 탑 4층에서 그리타와 대화
啟動穩定魔力裝置	Activate the Magic Stabilizer	마력 안정화 장치 작동
尋找魔力控制室	Find the Magic Control Room	마력 제어실 찾기
移動至魔法師之塔5樓	Go to Mage Tower 5F	마법사의 탑 5층으로 이동
消滅前往5樓時阻擋去路的克萊獰怪	Defeat Grinender that is blocking the way to the 5th Floor	5층으로 가는 길을 막는 그라이넨더 처치
收集紅色礦石龜的核	Collect the nucleuses of Red Infrorocters	붉은 인프로 락터의 핵 수집
尋找圓盾劍士次級大師	Look for the Rodelero Submaster 	로델레로 서브 마스터 찾기
與圓盾劍士次級大師對練	Spar with the Rodelero Submaster 	로델레로 서브 마스터와 대련
消滅圓盾劍士次級大師	Suppress the Rodelero Submaster	로델레로 서브 마스터 제압
去找巫蠱師次級大師	Look for the Wugushi Submaster 	무고사 서브 마스터 찾아가기
交給巫蠱師次級大師	Deliver it to Wugushi Submaster	무고사 서브 마스터에게 전달
去找重裝步兵次級大師	Look for the Hoplite Submaster 	하플라이트 서브 마스터 찾아가기
向重裝步兵次級大師報告	Report to the Hoplite Submaster 	하플라이트 서브 마스터에게 보고
巫蠱師次級大師的呼喚	Call for the Wugushi Submaster 	무고사 서브 마스터의 부름
向巫蠱師次級大師報告	Report to Wugushi Submaster 	무고사 서브 마스터에게 보고
進入貝魯克堤廣場	Enter Verkti Square	베르크티 광장 진입
與王國軍蕾堤亞對話	Talk to Royal Army Guard Retia	왕국군 레티아와 대화
貝魯克堤廣場上的王國軍蕾堤亞好像在等誰的援助。	Royal Army Guard Retia is waiting for someone's help at Verkti Square	베르크티 광장의 왕국군 레티아가 누군가의 도움을 기다리고 있습니다
消滅工房廢墟的怪物	Defeat the monsters in the Workshop Ruins	공방 폐허의 몬스터 처치
向王國軍蕾堤亞報告	Report to Royal Army Guard	왕국군 레티아에게 보고
確認石化探測器	Examine the Petrification Detector	석화 탐지기 확인
消除微弱的霜	Remove the weak Petrifying Frost	미약한 서리 제거
確認石化探測器後消滅斯帕娜史霍	Examine the Petrification Detector and defeat Sparnashorn	석화 탐지기 확인 뒤 스파나스혼 처치
與盜墓者胡貝爾塔斯對話	Talk to Grave Robber Hubertas	도굴꾼 후베르타스와 대화
貝魯克堤廣場的盜墓者胡貝爾塔斯好像在等誰的援助。	Grave Robber Hubertas at Verkti Square is waiting for someone's help	베르크티 광장의 도굴꾼 후베르타스가 누군가의 도움을 기다리고 있습니다
消滅集會場的怪物	Defeat the monsters in Assembly Hall Site	집회장 터의 몬스터 처치
收集蘭姆貝兒的腳趾甲	Collect Rambear Claws	램베어의 발톱 수집
向盜墓賊胡貝爾塔斯傳達此事	Give it to Grave Robber Hubertas	도굴꾼 후베르타스에게 전달
竊取石化贓物	Steal the petrified stolen goods	석화된 장물 훔치기
與盜墓者班賈米那斯對話	Talk to Grave Robber Benjaminas	도굴꾼 벤자미나스와 대화
交給盜墓賊班賈米那斯	Give it to Grave Robber Benjaminas	도굴꾼 벤자미나스에게 전달
收集會發出香味的石粉	Collect Fragrant Stone Powder	향나는 돌가루 수집
讓蘭姆貝兒身上沾滿芳香石粉	Rub the Fragrant Stone Powser on Rambear	램베어에게 향기나는 돌가루 묻히기
消滅薩爾提斯托	Defeat Saltistter	살티스터 처치
與警備兵葛普坦對話	Talk to Guard Gofden	경비병 고프덴과 대화
向警備兵葛普坦報告	Report to Guard Gofden	경비병 고프덴에게 보고
破壞叛亂軍記錄物	Destroy the Rebel Army Records	반란군 기록물 파괴
收集王國軍選拔隊的遺物	Collect the keepsakes of the advance Royal Army	왕국군 선발대의 유품 수집
交給警備兵葛普坦	Give it to Guard Gofden	경비병 고프덴에게 전달
恢復的機會	Chance to Recover	회복의 기회
與寒冰法師科斯塔斯對話	Talk to Cryomancer Kostas	크리오맨서 코스타스와 대화
收集反應石	Collect Reaction Stones	반응석 수집
交給寒冰法師科斯塔斯	Give it to Cryomancer Kostas	크리오맨서 코스타스에게 전달
獲得反應石	Obtained Reaction Stone	반응석 획득
在匠人之街實驗希爾特的信物	Test the Mark of Silt in Master Craftman's Street	장인의 거리에서 실트의 증표 실험
寒冰法師科斯塔斯請求使用希爾特的信物，對匠人之街的怪物進行實驗。	Cryomancer Kostas asked you to test teh Mark of Silt on the monsters in Master Craftman's Street	크리오맨서 코스타스는 장인의 거리에서 실트의 증표를 몬스터에게 실험해달라고 했습니다.
回收石化探測器的驅動核	Retrieve the Petrification Detector Activation Core	석화 탐지기의 구동핵 회수
敵人的敵人是怪物	Enemy's foe is an enemy	적의 적은 몬스터
與盜墓者魯特爾巴斯對話	Talk with Grave Robber Rudolfas	도굴꾼 루돌파스와 대화
在商業區收集維拉斯草的葉子	Collect Velas Grass in Commercial District	상업지구에서 벨라스 풀잎 수집
交給盜墓賊魯特爾巴斯	Give it to Grave Robber Rudolfas	도굴꾼 루돌파스에게 전달
在凱洛貝工房進行櫃子作業	Work on the boxes in Gerove Workshop Site	게로베 공방 터에서 궤짝 작업
向盜墓賊魯特爾巴斯報告	Report to Grave Robber Rudolfas	도굴꾼 루돌파스에게 보고
與警備兵萊爾對話	Talk to Guard Lyle	경비병 라일과 대화
守護被石化的士兵	Protect the Petrified Soldiers	석화된 병사 지키기
保護石化的士兵	Protect the Petrified Soldiers	석화된 병사 보호
與警備兵諾瑪比斯對話	Talk to Guard Nomabis	경비병 노마비스와 대화
回收被偷的物品	Retrieve the items that were stolen	도둑맞은 물품 회수
回收毀損的遺物	Retrieve the Damaged Relics	훼손된 유물 회수
交給警備兵諾瑪比斯	Give it to Guard Nomabis	경비병 노마비스에게 전달
收集毀損的遺物	Collect the Damaged Relics	훼손된 유품 수집
與時空法師莎比納對話	Talk to Chronomancer Sabina	크로노맨서 사비나와 대화
製作石化書拓本	Craft a copy of the petrified book	석화된 책 탁본 제작
尋找能使用的傳點	Look for the portal that is usable	사용 가능한 포탈 찾기
整理軍事地區	Maintain the Trade District	군사 지구 정리
消滅軍事區傳點周圍的怪物	Defeat the monsters around Barracks District	군사지구 포탈 주변 몬스터 처치
啟動軍事區的傳點	Activate the portal of Barracks District	군사 지구의 포탈 작동
消滅雷普斯	Defeat Lepus	레푸스 처치
與副官漢斯對話	Talk to Adjutant General Hans	부관 한스와 대화
消滅河口堤三岔路口周圍的怪物	Defeat the monsters nearby Estuary Bank Junction	하구 둑 삼거리 주변의 몬스터 처치
在河口堤三岔路口使用光粉劑	Use Monster Stimulant in Estuary Bank Junction	하구 둑 삼거리에서 광분제 사용
哄騙水磨坊廢墟的警備兵	Lure the guards in Decrepit Watermill	물레방앗길 폐허의 경비병 꾀어내기
回收王國軍傳單	Retrieve the propaganda of the Royal Army guard	왕국군 선전물 회수
與盜墓者斯提波納斯對話	Talk with Grave Robber Stephonas	도굴꾼 스테포나스와 대화
收集硬火藥	Gather Hardened Gunpowder	굳은 화약 수집
實驗加工炸彈	Processed Bomb Experiment	가공된 폭탄 실험
收集黏稠體液	Obtain Sticky Liquid	끈적이는 체액 수집
交給盜墓賊斯提波納斯	Talk with Grave Robber Stephonas	도굴꾼 스테포나스에게 전달
獲得生麵糰黏液	Obtain the Kneaded Slime	반죽된 점액 획득
獲得霜核	Obtain the Frosty Core	서리핵 획득
從森林石怪那獲得了霜核	Obtain the Frosty Core from a Stone Froster	스톤프로스터에게 서리핵 획득
與王國軍羅普戴爾對話	Talk with Royal Army Guard Rofdel	왕국군 로프델과 대화
破壞已石化的紀錄物	Destroy the petrified records	석화된 기록물 파괴
黏貼傳單	Put flyers	전단지 부착
與葳荷米娜凱利奧特對話	Talk to Wilhelmina Carriot	빌헬미나 캐리어트와 대화
消滅寇保索殿堂的怪物	Defeat the monsters at Kovos Hall Site	코보소 전당 터의 몬스터 처치
向葳荷米娜凱利奧特報告	Talk to Wilhelmina Carriot	빌헬미나 캐리어트에게 보고
回收止咳藥	Retrieve the Cough Medicine	기침약 회수
安慰犧牲者	Soothe the victims	희생자 위로
與邪靈祭司艾提達對話	Talk to Bokor Edita	보코르 에디타와 대화
收集黑暗結晶	Collect Dark Crystals	어두운 결정 수집
交給邪靈祭司艾提達	Hand them over to the Bokor Master	보코르 에디타에게 전달
解放石化的士兵	Release the petrified soldier	석화된 병사 해방
在畢安提城堡的營火上點火	Light a bonfire in Vienti Fortress	비엔티 성채의 모닥불에 불 피우기
與鍊金術士莎莉亞莫納斯對話	Talk with Alchemist Saliamonas	알케미스트 살리아모나스와 대화
對奈勃基亞城堡的怪物的怪物使用石化融解劑	Use the melting solution to the monsters at Neiveikiama Castle	네베키아 성채의 몬스터에게 석화 융해제 사용
鍊金術士莎莉亞莫納斯請你對在奈勃基亞城堡裡遭到石化霜攻擊的怪物使用石化融解劑。說不定能夠解開石化。	Alchemist Saliamonas told you to use the Petrification Thawing Liquid on the monsters	알케미스트 살리아모나스는 네베키아 성채에서 석화서리에 당한 몬스터들에게 석화융화제를 사용해 달라고 부탁했습니다. 어쩌면 석화를 풀어낼 수도 있으니까요.
向鍊金術士莎莉亞莫納斯報告	Report to the Alchemist Saliamonas	알케미스트 살리아모나스에게 보고
從奈勃基亞城堡的怪物身上收集石化標本	Collect the Petrified Samples from the monsters in Neiveikiama Castle	네베키아 성채의 몬스터에게서 석화 표본 수집
收集石化標本	Collect Petrification Samples	석화 표본 수집
消滅魯巴勃斯	Defeat Rubabos	루바보스 처치
秘密交易	Secret Trade	비밀거래
與盜墓者阿曼達對話	Talk to Grave Robber Amanda	도굴꾼 아만다와 대화
收集露克立斯時代的記錄物	Collect the Record from the Ruklys Era	루클리스 시대의 기록물 수집
消滅滴水嘴怪	Defeat Gargoyle	가고일 처치
消滅在德巴西安嶺的怪物	Defeat the monsters at Dvasia Peak	드바시아 고개에 있는 몬스터 처치
向指揮官朱利安報告	Report to Commander Julian	지휘관 줄리안에게 보고
消滅在德巴西安嶺的怪物	Defeat the monsters at Dvasia Peak	드바시아 고개에 있는 몬스터를 처치
與村莊青年多萊恩對話	Talk to Villager Darren	마을 청년 다렌과 대화
確認洛托儂養蜂場的蜂窩	Check the beehives at Rododun Apiary	로도논 양봉장의 벌집 확인
將空的蜂窩交給村莊青年多萊恩	Hand over the empty beehive to Villager Darren	마을 청년 다렌에게 빈 벌집 전달
將油桶的油抽乾	Draw out the oil from the oil barrels	기름통에서 기름 빼내기
與釀造業者都勒傑對話	Talk to Brewer Dorjen	양조업자 도르젠과 대화
從蜂蜜酒倉庫那帶回蜂蜜酒	Bring back Dorjen's Signature Mead from the Honey Wine Warehouse	벌꿀술 창고에서 벌꿀술 가져오기
消滅摧毀釀造業的怪物	Defeat the monsters who ruined Dorjen's brewery	양조업을 망친 몬스터 처치
確認洛托儂養蜂場的蜂窩	Check the beehives at Rododun Apiary	로도논 양봉장의 벌집을 확인
請去洛托儂養蜂場查看蜂窩。	Check the beehives at Rododun Apiary	로도논 양봉으로 가서 벌집을 살펴보세요.
消滅斯帕露娜絲	Defeat Sparnas	스파르나스 처치
請消滅占領洛托儂養蜂場的斯帕露娜絲。	Defeat the Sparnas that occupied the Rododun Apiary	로도논 양봉을 장악하고 있는 스파르나스를 처치하세요.
確認蜂蜜酒保管箱	Check the mead storage boxes	벌꿀술 보관 상자 확인
與奇利納對話	Talk to Kirina	키리나와 대화
與瑪拉斯對話	Talk to Maras	마라스와 대화
請與正在調查比爾那森林的瑪拉斯進行對話。	Talk with Maras who is investigating in Vilna Forest	빌나 숲에서 조사를 진행하고 있는 마라스와 대화해보세요.
確認發出香甜氣味的蜂箱	Check the Sweet-smelling Beehives	달콤한 향이 나는 벌통 확인
請聽瑪拉斯講解該如何使用香甜的蜂箱碎片。	Ask how Maras will use the fragments of sweet honeycomb	마라스에게 달콤한 벌통조각을 어떻게 사용할 것인지 들어보세요.
對怪獸飄散蜂蜜香氣	Spread the fragrance of honey to the monsters	몬스터에게 꿀 향기를 풍겨보기
確認下方的比奇吳祭壇	Check Bichiu Altar	아랫쪽의 비치우 제단 확인
將魔石碎片交給瑪拉斯	Hand over the magic piece to Maras	마라스에게 마석 조각 전달
確認右方的卡物德奇祭壇	Check the Gaudeji Altar towards the right	오른쪽의 가우데지 제단 확인
與在樹木監視塔附近的拉馬勒對話	Talk to Lamar near Wood Watch Tower	나무 감시탑 근처의 라마르와 대화
與拉馬勒對話	Talk with Lamar	라마르와 대화
與利耶爾利耶對話	Talk with Raeli	라엘리에와 대화
確認北邊的比爾那森林祭壇	Check the altar of Vilna Forest at the north side	북쪽의 빌나 숲 제단 확인
請確認北邊的比爾那森林祭壇。	Check the altar of Vilna Forest at the north side	북쪽의 빌나 숲 제단을 확인해보세요.
消滅比爾那森林祭壇的獨眼巨人	Defeat Cyclops of the altar at Vilna Forest	빌나 숲 제단의 사이클롭스 처치
請消滅比爾那森林祭壇的獨眼巨人。	Defeat Cyclops of the altar at Vilna Forest	빌나 숲 제단의 사이클롭스를 처치하세요.
與利斯對話	Talk to Riesz	리스와 대화
尋找在榭魯榭艾向陽地裝有農具的背包	Find the bag of farming tools at Shirsie Sunny Place	쉬르쉬에 양지에서 농기구가 든 배낭 수색
將農具交給利斯	Hand over the farming tools to Riesz	리스에게 농기구 전달
消滅鬼眼蜘蛛	Defeat Honeypin	허니핀 처치
與巴爾達對話	Talk with Valda	발다와 대화
收集蜂箱碎片	Collect the pieces of honeycomb	벌통조각 수집
在拉丹扎農園播種	Sow seeds at Radanza Farm	라단자 농원에 씨 뿌리기
與祭司利耶爾利耶對話	Talk with Priest Raeli	사제 라엘리에와 대화
採集蜂樹樹枝	Collect Bee Tree Branches	벌나무 가지 채집
啟動守護石	Activate the Guardian Stone	수호석 가동
消滅魔族收集被火燒透的魔族灰	Defeat the demons with the branches and collect the ashes of the demons	마족을 처치하여 불타버린 마족의 재 수집
幫剩餘的晶球補充神聖之氣	Recharge the orb made of ash with holy energy	잔재의 구슬에 신성한 기운 충전
復原變弱的封印塔	Restore the weakened seal tower	약해진 봉인탑 복구
與奧斯特雅女神對話	Talk to Goddess Austeja	아우스테야 여신과 대화
聽奧斯特雅女神說話	Listen to Goddess Austeja's story	아우스테야 여신의 이야기 듣기
確認變弱的封印塔	Check the weakened Seal Tower	약해진 봉인탑 확인
請確認因魔族的攻擊而變弱的封印塔。	Check the Seal Tower that was weakened by demon attacks	마족의 공격으로 약해진 봉인탑을 확인하세요.
消滅魔君主塔武瑪斯	Defeat Demon Lord Taumas	마군주 타우마스 처치
與農夫德魯巴對話	Talk to Farmer Druva	농사꾼 드루바와 대화
收集整理好的木材	Collect Well-Cut Wood	손질된 목재 수집
設置貼有符咒的稻草人	Place the scarecrow with the charm attached	부적을 붙인 허수아비 설치
與完蛋的養蜂專家羅森對話	Talk to Ruined Bee Farmer Logen	망한 양봉가 로센과 대화
與祭司多支奈對話	Talk to Priest Dazine	사제 다지네와 대화
收集變成碎片的奧斯特雅的象徵	Collect the Fragmented Symbol of Austeja	조각난 아우스테야의 상징 수집
在奧斯特雅祭壇上復原象徵	Restore the symbol at the Austeja Altar 	아우스테야 제단에서 상징 복원
淨化被蠱惑的啟示者們	Purify the addled Revelators	현혹된 계시자들을 정화
復原郎基斯封印和郎卡封印	Restore the Rankis Seal and the Ranka Seal	랑키스 봉인과 랑카 봉인 복구
賦予郎基斯封印塔和郎卡封印塔女神之力	Restore the goddess' powers to Rankis Seal Tower and Ranka Seal Tower	랑키스 봉인탑과 랑카 봉인탑에 여신의 힘 부여
確認春光樹林祭壇	Check the Spring Light Woods Altar	봄볕나무 숲 제단 확인
確認崩壞的封印塔	Check the destroyed seal tower	부서진 봉인탑 확인
消滅孟堤肯	Defeat Manticen	맨티켄 처치
和商人圖凱對話	Talk to Merchant Dulke	상인 둘케와 대화
尋找商人圖凱的行李	Find Merchant Dulke's Package	상인 둘케의 짐꾸러미 찾기
將行李交給商人圖凱	Give the packages to Merchant Dulke	상인 둘케에게 짐꾸러미 전달
與居民艾密對話	Talk to Villager Emil	주민 에밀과 대화
消滅村莊附近的怪物	Defeat the monsters around the village	마을 주변의 몬스터 처치
與藥師提阿納對話	Talk to Pharmacist Tiana	약사 티아나와 대화
收集春光草	Collect Spring Light Grass	봄볕초 구하기
將春光草交給藥師提阿納	Give the Spring Light Grass to Pharmacist Tiana	약사 티아나에게 봄볕초 전달
請消滅畢拉空，取得黑煤粉	Defeat Phyracon and collect Black Coal Powder	피라콘을 처치하여 흑탄 가루 구하기
從德雷克手中收集不滅的火種	Collect Eternal Embers from Drakes	드레이크에게서 꺼지지 않는 불씨 수집
消滅怪物，獲得聖櫃碎片	Defeat the monsters and get pieces of the Holy Ark	몬스터를 처치하여 성궤 조각 획득
消滅玷污封印石的亞魯瑪	Defeat Arma that mocked the Sealed Stone	봉인석을 모욕한 아르마 처치
消滅魔瓶怪博學者，獲得束縛的結晶	Defeat the Flask Mage and get the Crystal of Restriction	플라스크 메이지를 처치하여 속박의 결정 획득
黑暗咒術人偶	Black Shaman Doll	검은 주술인형
留下的記憶[邪靈祭司轉職]	Still Needs Memory [Bokor Advancement] (1)	남겨진 기억[보코르 전직]
管理女神像[雕刻師轉職]	Statue Maintenance [Dievdirbys Advancement] (1)	여신상 관리[딥디르비 전직]
財物也是恩惠[寬恕者轉職]	Grace of Wealth [Pardoner Advancement] (1)	재물에도 은혜를[파드너 전직]
跟念力法師次級大師報告	Report to the Psychokino Submaster	사이코키노 서브 마스터에게 보고
與佩迪米安的裝備商人對話	Talk to Equipment Merchant in Fedimian	페디미안의 장비 상인과 대화
收集朝聖者的標誌	Collect Marks of Pilgrim	순례자의 표식 수집
交給佩迪米安的裝備商人	Give them to Fedimian Equipment Merchant	페디미안의 장비 상인에게 전달
見騎士團長烏斯卡	Meet Commander Uska	기사단장 우스카 만나기
討伐祈願森林的怪物	Defeat the monsters at Forest of Prayer	기원의 숲 몬스터 토벌
消滅祈願森林的怪物	Defeat the monsters at Forest of Prayer	기원의 숲의 몬스터 처치
與貓頭鷹隊長雕像對話	Talk to the Owl Chief Sculpture	대장 부엉이 조각상과 대화
查看在伊修拉十字路口的變弱的貓頭鷹雕像	Check on the Weak Owl Sculpture at Ishrai Crossroads	이쉬라이 사거리의 약해진 부엉이 조각상 살펴보기
與變弱的貓頭鷹雕像對話	Talk to the Weak Owl Sculpture	약해진 부엉이 조각상과 대화
尋找被綁架的貓頭鷹們的痕跡	Find traces of the kidnapped Owls	납치된 부엉이들의 흔적 찾기
轉交被摧毀的貓頭鷹碎片	Give the broken owl sculpture parts to the Weak Owl	부서진 부엉이의 조각 전달
消滅破壞貓頭鷹的蘑菇沃特	Defeat the Mushwort that destroyed the Owl	부엉이를 파괴한 머쉬워트 처치
與朝聖者莉莉亞對話	Talk to Pilgrim Liliya	순례자 릴리야와 대화
收集怪物的肉	Collect monster meat	몬스터의 고기 수집
交給朝聖者莉莉亞	Hand them over to Pilgrim Liliya	순례자 릴리야에게 전달
帶回野草的嫩葉	Get some Young Leaves	여린 들풀잎 구해 오기
能填飽朝聖者莉莉亞的飢餓感嗎？請再問她看看。	Did Pilgrim Liliya's hunger go away? Talk to her again	순례자 릴리야의 허기는 채워 진 걸까요? 다시 그녀에게 말을 걸어 봅시다.
消滅魔花卡諾波	Defeat Carnivore	카너버 처치
與暈倒的朝聖者莉莉亞對話	Talk to the fallen Pilgrim Liliya	쓰러져 있는 순례자 릴리야와 대화
消滅由魔花卡諾波變成的莉莉亞	Defeat Liliya who turned into a Carnivore	카버너로 변한 릴리야 처치
幫朝聖者莉莉亞做墳墓	Make a grave for Pilgrim Liliya	순례자 릴리야의 무덤 만들기
與朝聖者由利烏斯對話	Talk to Pilgrim Julius	순례자 율리우스와 대화
取來凱帕力肉片	Get the meat of Kepari	케파리 살점 구해 오기
給朝聖者由利烏斯吃的東西	Give food to Pilgrim Julius	순례자 율리우스에게 먹을 것 전해 주기
說服德拉涪里溫	Persuade Drapeliun	드라페리운 설득
帶回阿賽魯的嫩葉	Obtain Asellu Leaf Buds	아셀루의 어린 잎 구해오기
消滅吞掉項鍊的地心蟲王	Defeat the Reaverpede that swallowed the necklace	목걸이를 삼킨 리버피드 처치
與朝聖者傑紐斯對話	Talk to Pilgrim Zenius	순례자 재뉴스와 대화
用食物殘渣來對怪物做實驗	Experiment the monsters using the Food Scraps	음식 찌꺼기로 몬스터를 실험하기
觀察懶惰的樹根水晶	Observe the Indolent Tree Root Crystal	나태의 나무뿌리 수정 살펴보기
破壞變質的保護石	Destroy the deformed protection stone	변질된 보호석 파괴
破壞詛咒的樹根水晶保護石	Destroy the Cursed Tree Root Crystal Protection Stone	저주의 나무뿌리 수정 보호석 파괴
流民營地裡變質的樹根水晶	Spoiled Tree Root Crystal at the Nomads Camp	유랑민 캠프의 변질된 나무뿌리 수정
解除被召喚的樹根水晶核	Destroy the Reformed Tree Root Crystal's Core	소환된 나무뿌리 수정 핵 해체
破壞懶惰的樹根水晶	Destroy the Indolent Tree Root Crystal	나태의 나무뿌리 수정 파괴
吉寇雷山麓裡變質的樹根水晶	Spoiled Tree Root Crystal at Pusapskritimis Shore	지코레 기슭의 변질된 나무뿌리 수정
在樹根水晶上點火	Light the Tree Root Crystal on fire	나무뿌리 수정에 불 붙이기
破壞吉寇雷山麓裡變質的樹根水晶	Destroy the Tree Root Crystal at Pusapskritimis Shore	지코레 기슭의 변질된 나무뿌리 수정 파괴
朝聖者墳墓右邊的變質樹根水晶	Spoiled Tree Root Crystal at the right side of the Pilgrim's Tomb	순례자의 무덤 오른쪽의 변질된 나무뿌리 수정
消滅仙人掌妖精	Defeat Cactusvel	캑터스벨 처치
帕修克堤蜿蜒路的懶惰的樹根水晶	Tree Root Crystal of Sloth at Posukis Path	파수크티 굽잇길의 나태의 나무뿌리 수정
從怪物身上找樹根水晶	Look for the Core of the Tree Root Crystal from the monsters	몬스터로부터 나무뿌리 수정 핵 찾기
封印變形的樹根水晶	Seal the mutated Tree Root Crystal	변형된 나무뿌리 수정 봉인하기
諾雷堤泉水的樹根水晶	The Tree Root Crystal at Noras Fountain	노레티 샘터의 나무뿌리 수정
消滅變身後的暴食者	Defeat the Shape-shifting Glutton	변신한 글러튼 처치
消滅正在變身成樹根水晶的暴食者	Defeat the Glutton that was once a Tree Root Crystal	나무뿌리 수정으로 변신해 있던 글러튼 처치
將邪惡氣息重新放入箱子裡	Return the evil energy into the Treasure Chest	사악한 기운을 상자에 다시 넣어두기
消滅衝過來的怪物	Defeat the monsters swarming out	몰려나온 몬스터 처치
與朝聖者葛拉奇烏斯對話	Talk to Pilgrim Gracius	순례자 그라치우스와 대화
消滅湧進祭壇附近的怪物	Defeat the monsters that rushed out of the altar	제단 근처에서 몰려 나온 몬스터 처치
在祭壇祈禱	Pray to the altar	제단에 기도
去做實驗	Go and Test the Reagent	시험하러 가기
告訴朝聖者葛拉奇烏斯結果	Let Pilgrim Gracius know the results	순례자 그라치우스에게 결과 알려주기
尋找朝聖者的經典	Get the Scripture from the Pilgrim's Soul	순례자의 경전 구하기
將靈魂從怪物身上解放	Release the souls from the monsters	몬스터로부터 영혼 해방
消滅靈魂被束縛的怪物	Defeat the monsters with souls trapped inside them	영혼이 갇힌 몬스터 처치
拯救祭壇的靈魂們	Save the souls at the altars	제단의 영혼들을 구원
去見朝聖者葛拉奇烏斯	Meet Pilgrim Gracius	순례자 그라치우스와 만나기
在切利茲上坡路上的祭壇	Chliz Uphill Altar	츠리즈 오름길로 가는 길의 제단
為憤怒的靈魂們收集花	Collect flowers for the wrathful souls	분노한 영혼들을 위한 꽃 수집
收拾祭壇	Check the Altar	제단 치우기
祭壇的靈魂們	Souls of the Altar	제단의 영혼들
布朗金堤丘陵的祭壇	Branginti Hill Altar	브랑긴티 언덕의 제단
帶回朝聖者遺失的經典散頁	Gather the Pilgrim's Lost Scripture Pages	순례자가 잃어버린 경전의 낱장 구해오기
從怪物身上收集經典散頁	Obtain Scripture Pages from the monsters	몬스터로부터 경전의 낱장 구하기
祈願森林入口的祭壇	The altar near the Forest of Prayer	기원의 숲 길목의 제단
消滅泰特拉歐克斯	Defeat Tetraox	테트라옥스 처치
消滅藏匿在祭壇裡的泰特拉歐克斯	Defeat the Tetraox that hid in the altar	제단에 숨어 있던 테트라옥스 처치
露達珠林蔭道上方的祭壇	Northern Rudiziu Trail Altar	루다주 숲길 위쪽의 제단
與受到束縛的靈魂對話	Talk to the Trapped Soul	속박되어 있던 영혼과 대화
消滅出現在祭壇上的摩吉	Defeat Merge	제단에서 나타난 머지 처치
冷卻祭壇	Cool the Altar	제단 식히기
噴灑怪物的體液	Spray the Cold Monster Fluid	몬스터의 체액 뿌리기
從怪物身上取得怪物的體液	Get monster's fluid from the monsters	몬스터들로부터 몬스터의 체액 획득
接受聖所的祝福	Receive the Sanctum's Blessing	성소의 축복 받기
向聖所捐款	Offer contributions to the Sanctum	성소에 헌금 하기
將怪物誘導至聖所後消滅	Lure monsters to the sanctum and defeat them	성소로 몬스터 유인 뒤 처치
膜拜聖所	Pay worship to the sanctum	성소에 경배 하기
膜拜聖所	Offer Worship to the Sanctum	성소에 경배 드리기
消滅聖所周圍的怪物	Defeat the monsters near the Sanctum	성소 주변의 몬스터 물리치기
去找聖水祭師大師	Go to the Priest Master	프리스트 마스터 찾아가기
消滅湧入聖所附近的怪物	Defeat the monsters that gathered around the sanctum	성소 주변에 몰려 든 몬스터 처치
用聖水淨化聖所	Purify the sanctum using Holy Water	성수로 성소 정화
膜拜聖者之墓附近的女神像	Pray in front of the Goddess Statue near the grave of the saint	성자의 무덤 근처의 여신상에 경배
消滅假冒女神像的怪物	Defeat the monster that was disguised as a Goddess Statue	가짜 여신상으로 변해있던 몬스터 처치
尋找真的女神像	Find the True Goddess Statue	진짜 여신상 찾기
向雕刻家泰斯拉索取建議	Get advice from Sculptor Tesla	조각가 테슬라에게 조언 구하기
請與雕刻家泰斯拉討論關於毫無反應的女神像。	Talk with Tesla about the Goddess Statue that does respond	아무런 반응도 보이지 않는 여신상에 대해 조각가 테슬라와 상의하세요.
回到祈願森林	Return to the Forest of Prayer	기원의 숲으로 돌아가기
觀察女神像	Inspect the Goddess Statue	여신상 살펴보기
收集修復女神像所需的材料	Obtain the materials to repair the Goddess Statue with	여신상을 보수할 재료 구하기
修復女神像	Repair the Goddess Statue	여신상 보수
觀察女神像是否成功修好	Check if the Goddess Statue is well repaired	여신상이 제대로 보수되었는지 살펴 보기
破壞魔族召喚陣	Destroy the demon summoning circles	마족 소환진 망가뜨리기
消滅蜂擁而至的怪物	Defeat the monsters that rushed out	몰려 나온 몬스터 처치
去找牧師大師	Go to the Cleric Master	클레릭 마스터 찾아 가기
聽牧師大師的建議	Listen to the advice of the Cleric Master	클레릭 마스터에게 조언 듣기
尋找聖所裡的信仰的標誌	Look for the Symbol of Faith at the sanctum	성소에서 신앙의 표식 찾기
在聖所內燒掉聖所的徽章	Burn the badges of the sanctum	성소의 휘장을 성소에서 태우기
去拉薛基歐市內裝清澈的水回來	Obtain some Pure Water from Ryskus Stream	리쉬키오 시내의 맑은 물 떠오기
膜拜瓦卡麗涅女神像	Pray in front of the Vakarine Statue	바카리네 여신상에 경배
女神像守護	Protect the Goddess Statue	여신상 수호
獻花	Devote Flowers	헌화 하기
索取寬恕者大師的建議	Get advice from the Pardoner Master	파드너 마스터에게 조언 구하기
淨化聖所的汙染	Purify the corruption at the sanctum	성소의 오염 정화하기
詢問寬恕者大師淨化聖所的方法	Ask the Pardoner Master how to purify the sanctum	파드너 마스터에게 성소를 정화하는 방법 묻기
消滅鋼鐵巴溫	Defeat Ironbaum	아이언 바움 처치
交給朝聖者泰伍皮里斯	Hand it over to Pilgrim Theophilis	순례자 테오필리스에게 전달
消滅怪物並尋找朝聖者泰伍皮里斯的背包	Defeat monsters and retrieve Theophilis' bag	몬스터를 처치하고 태오필리스의 가방 찾기
收集蘆葦樹液結晶	Obtain Reed Sap Crystals	갈대 수액 결정 구하기
將材料拿給泰伍皮里斯	Take the ingredients to Pilgrim Theophilis	테오필리스에게 재료 가져다 주기
搜查衛塔斯的攜帶品	Search through Witas' belongings	위타스의 소지품 수색
交給朝聖者衛塔斯	Give them to Pilgrim Witas	순례자 위타스에게 전달
相會廣場的墓碑	The Tombstone at the Meeting Plaza	만남의 광장의 묘비
尋找畫的碎片	Look for Pieces of the Portrait	그림 조각 찾기
獵殺怪物後尋找畫的碎片	Look for the pieces of the Portrait by hunting the monsters	몬스터를 사냥해서 그림 조각 찾기
被丟棄在威德羅卡入口的箱子	The Abandoned Chest at Klajone Access Road	위드로카 진입로에 버려진 상자
尋找箱子鑰匙	Look for the Chest's key	상자 열쇠 찾아 보기
打開箱子	Open the chest	상자 열기
消滅怪獸獲得鑰匙	Obtain the key by defeating the monsters	몬스터를 처치하여 열쇠 획득
淨化虛假之泉	Purify the Pond of Silence	가식의 샘 정화
在兄弟之樹設置能收集樹液的甕	Place the pots that will store the sap of the Tree of the Brothers	형제의 나무에 수액을 모을 항아리 설치
用兄弟之樹的樹液來淨化寂靜之泉	Purify the Pond of Silence with the sap of the Tree of the Brothers	형제 나무의 수액으로 고요의 샘 정화
邪惡氣息的出現	The appearance of an evil energy	사악한 기운의 출현
消滅夢魔	Defeat Succubus	서큐버스 처치
花紋石的秘密	The secret of the symbolized stone	문양석의 비밀
消滅正在守護隱藏空間的怪物	Defeat the monsters that are protecting the hidden space	숨겨진 공간을 지키고 있는 몬스터 처치
觀察凹槽	Look at the pothole	패인 곳 살펴 보기
再次觀察凹槽	Look closely into the pothole	다시 패인 곳 살펴보기
守護箱子的怪物們	The monsters that are protecting the boxes	상자를 지키는 몬스터들
消滅湧入箱子四周的怪物	Defeat the monsters that gathered around the treasure chest	상자 주변으로 몰려 든 몬스터 처치
消滅寶物箱附近的怪物	Defeat the monsters that are around the treasure chest	보물 상자 주변의 몬스터 처치
與變弱的貓頭鷹對話	Talk with the Weak Owl	약해진 부엉이와 대화
從油箱獲得油	Obtain Oil from the Oil Box	기름 상자에서 기름 획득
回去找力量變弱的貓頭鷹	Return to the Weak Owl	약해진 부엉이에게 돌아가기
燃燒粉碎的雕像堆	Burn the destroyed fragments of the Sculptures	부서진 조각상더미를 태우기
請守護火焰直到雕像燒完為止。	Protect the fires until the Sculptures burn completely	조각상이 다 탈 동안 불을 지켜 주세요.
向貓頭鷹隊長雕像報告	Report to the Owl Chief Sculpture	대장 부엉이 조각상에게 보고
與主教亞烏雷利屋斯對話	Talk to Bishop Aurelius	주교 아우렐리우스와 대화
收集靈魂精髓	Collect Spirit Essences	영혼의 정수 수집
與主教亞烏雷利屋斯對話	Talk with Bishop Aurelius	주교 아우렐리우스와 대화하기
在帕瑪朵新郎尋找完整的經典	Look for a Complete Scripture at Pamaldu Groom	파말두 신랑에서 온전한 경전 찾기
在安定祭壇上完成靈魂的容器	Complete the vessel for the spirit at the Altar of Stability	안정의 제단에서 영혼의 그릇 완성
用靈魂的經典來呼喚主教亞烏雷利屋斯	Call Bishop Aurelius with the Spirit's Scripture	영혼의 경전으로 주교 아우렐리우스 호출
解開梅米雷經堂的秘密	Solve the secret of Meile Oratorium	메밀레 경당의 비밀 풀기
尋找救援的聖遺物	Look for the Holy Relic of Salvation	구원의 성유물 찾기
將聖遺物放入小會堂的祭壇內	Insert the Relic of Mercy into the altar at the Small Hall	소회당의 제단에 성유물 끼워넣기
察看梅伊班的秘密	Look at Maven's secret	메이번의 비밀 살펴보기
與祭司伊內亞對話	Talk to Priest Inea	사제 이네아와 대화하기
搜查傳聞的聖物	Look for the Scriptural Relics	말씀의 성물 수색
交給祭司伊內亞	Hand it over to Priest Inea	사제 이네아에게 전달
與祭司伊內亞對話	Talk with Priest Inea	사제 이네아와 대화
使用聖力探測晶球來尋找聖物	Find the relics using the Orb of Divine Detection	성력 탐지 구슬을 사용하여 성물 찾기
與祭司亞汀對話	Talk with Priest Aden	사제 아덴과 대화
接收祭司們的研究報告書	Bring the Priests' Research Reports	사제들의 연구 보고서를 받아오기
將報告書交給祭司亞汀	Hand it over to Priest Aden	사제 아덴에게 전달
與大教堂大回廊的主教亞烏雷利屋斯對話	Talk to Bishop Aurelius at the Grand Corridor	대성당 대회랑의 주교 아우렐리우스와 대화
解開慈愛的講台的秘密	Solve the secret at the Platform of Benevolence	자애의 단상의 비밀 풀기
獲得梅伊班的第二把鑰匙	Obtain Maven's Second Key	메이번의 두 번째 열쇠 획득
與在烏歐利艾禮拜室的主教亞烏雷利屋斯對話	Talk to Bishop Aurelius at Uola Chapel	우올리에 예배실의 주교 아우렐리우스와 대화
消滅覬覦靈力信物的魔族	Defeat the demons that are after the Holy Symbol of Spiritual Power	영력의 신표를 노리는 마족 처치
獲得靈力信物	Obtain the Holy Symbol of Spiritual Power	영력의 신표 획득
幫靈力信物充電	Recharge the Holy Symbol of Spiritual Power	영력의 신표 충전
在貝伊尼卡祭壇獲得梅伊班的第三把鑰匙	Obtain Maven's Third Key at Karuna Altar	베이니카 제단에서 메이번의 세 번째 열쇠 획득
與祭司路歐德爾對話	Talk to Priest Ruodell	사제 루오델과 대화
尋找與那柯堤斯有關的文獻	Look for documents that are related to Naktis	나크티스에 관련된 문헌 찾기
請找出多少能幫忙解開那柯堤斯詛咒的文件。	Find the documents that will be helpful undoing Naktis' curse	나크티스의 저주를 풀 수 도움이 될만한 문서를 찾으세요.
與祭司約瑟那對話	Talk to Priest Yosana	사제 요사나와 대화
找回祭司約瑟那的研究資料	Retrieve Priest Yosana's Research	사제 요사나의 연구 자료 되찾기
與祭司大朗對話	Talk to Priest Daram	사제 다람과 대화
對魔族使用淨化的卷軸並收集溶劑	Collect solvents by using the Scroll of Purification on the demons	마족에게 정화의 스크롤을 사용하여 용매 수집
將祭司大朗做的藥拿去對魔族做實驗	Use the reagent Priest Daram created on the demons	사제 다람이 만든 약을 마족에게 실험
確認貝伊尼卡祭壇	Check the Karuna Altar	베이니카 제단 확인하기
請確認貝伊尼卡祭壇。	Check the Karuna Altar	베이니카 제단을 확인해보세요.
消滅突然出現的那柯堤斯部下	Defeat Naktis' servants that suddenly appeared	갑자기 나타난 나크티스의 부하 처치하기
請消滅突然出現的那柯堤斯部下。	Defeat Naktis' servants that suddenly appeared	갑자기 나타난 나크티스의 부하를 처치하세요.
與祭司阿爾莉莎對話	Talk to Priest Alisha	사제 알리샤와 대화
採集月薊	Collect thistles	달엉겅퀴 채집
交給祭司阿爾莉莎	Hand them over to Priest Alisha	사제 알리샤에게 전달
從周圍的怪物身上收集肉	Collect the meats from the monsters nearby	주변 몬스터에게서 고기 수집
抓住赤紅伊普羅霍克鷹並取得肉	Get some meat by defeating Red Infro Hoglans	붉은 인프로 호글란을 잡아 고기 얻기
與祭司露亞那對話	Talk to Priest Loana	사제 로아나와 대화
消滅詛咒的實體	Defeat the True Origin of the Curse	저주의 실체 처치
消滅死靈查普利	Defeat Chapparition	채퍼리션 처치하기
餵朝聖者摻了藥的肉	Feed the pilgrim the meat with medicine in it	순례자에게 약이 든 고기 먹이기
與朝聖者歐比爾對話	Talk to Pilgrim Orville	순례자 오빌과 대화
除掉拉米比耶絕壁的怪物	Defeat the monsters at Taika Cliff	라미비에 절벽의 몬스터 처치
前往拉米比耶絕壁	Go to Taika Cliff	라미비에 절벽으로 가기
消滅突襲的怪物	Defeat the monster that suddenly rushed in	급습한 몬스터 처치
在大教堂至聖所尋找記載著變身成魔族的方法的文獻	Look for documents that describe ways to transform into a demon at the Sanctuary	대성당 지성소에서 마족으로 변신할 수 있는 방법이 적힌 문헌 찾기
在虔誠的祭壇裡完成魔族變身卷軸	Complete the Demon Transformation Scroll at the Altar of Intelligence	지성의 제단에서 마족 변신 스크롤 완성
獲得完成的魔族變身卷軸	Acquire the Demon Transformation Scroll	완성된 마족 변신 스크롤 획득
將魔族引誘至卡烏爾雷祭壇	Lure the demons to Apgaule Altar	마족을 가울레 제단으로 유인
獲得梅伊班的第四把鑰匙	Obtain Maven's Fourth Key	메이번의 네 번째 열쇠 획득
消滅魔族	Defeat the demons	마족 처치하기
解開小接見室的秘密，獲得梅伊班的第五把鑰匙	Obtain Maven's Fifth Key by solving for the secret in the Small Reception Room	소 접견실의 비밀을 풀어 메이번의 다섯 번째 열쇠 획득
進入帕薩拉祭壇	Enter into the Pasala Altar	파사라 제단으로 입장
使用鑰匙並找到隱藏的通道	Look for the hidden path using the keys	열쇠를 사용하여 숨겨진 통로 찾기
利用傳點，移動到隱藏的房間	Move to the hidden room using the portal	포탈을 타고 숨겨진 방으로 이동
消滅那柯堤斯	Defeat Naktis	나크티스 처치
與祭司普羅基特對話	Talk to Priest Prosit	사제 프로지트와 대화
請與祭司進行對話。	Talk to the priest	사제와 대화하세요
收集散播詛咒的寶珠	Collect the curse-spreading orbs	저주를 퍼뜨리고 있는 보주 수집
交給祭司普羅基特	Hand them over to Priest Prosit	사제 프로지트에게 전달
與祭司高達對話	Talk to Priest Goda	사제 고다와 대화
優智瑪拜堂講台的調查	Investigate the Platform of Maskuote Narthex	유지마 배랑의 단상 조사
除掉克羅洛鐘	Defeat Linkroller	링크롤러 처치
通過證明的試驗	Pass the Verification Test	증명의 시험 통과
收集魔族的衣角	Collect demons' garments	마족의 옷자락 수집
交給主教亞烏雷利屋斯	Hand them over to Bishop Aurelius	주교 아우렐리우스에게 전달
搜索朝聖者歐比爾的朋友	Search for Orville's friend	순례자 오빌의 친구 수색
收拾朝聖者歐比爾的好友屍體	Recover the body of Pilgrim Orville's friend	순례자 오빌의 친구 시신 수습
請除掉殺死歐比爾好友的喀拉庫曼 	Defeat the Glackuman who killed Orville's friend	오빌의 친구를 죽인 글락쿠만 처치하기
與弟子萊恩斯對話	Talk to Disciple Laius	제자 라이어스와 대화
搜索蘊含靈氣的寶珠	Search for the orb that can contain vigor	영기를 담는 보주 수색
交給弟子萊恩斯	Hand it over to Disciple Laius	제자 라이어스에게 전달
吸收怪物的靈氣	Absorb vigor from the monsters	몬스터에게 영기 흡수
將靈氣注入堅硬的靈體水晶	Inject the vigor into the crystal of the hardened astral body	굳은 영체의 수정에 영기 주입
與弟子侯內斯對話	Talk with Disciple Hones	제자 호네스와 대화
確認師父留下的紀錄	Examine the records which the master left	스승이 남긴 기록 확인
為危險的探勘做準備	Preparations for dangerous search	위험한 탐색 준비
收集真相之眼碎片	Collect the Eyes of Truth fragments	진실의 눈 파편 수집
交給弟子侯內斯	Hand them over to Disciple Hones	제자 호네스에게 전달
消滅鬼影凱伊洛後，獲得了靈魂的結晶	Obtain the Soul Crystal by defeating Shadowgaler	섀도게일러를 처치해서 영혼의 결정 획득
契約的空間魔石	Spatial Magic Gem of Contract	계약의 공간마석
確認魔石融合劑	Examine the Magic Gem Fusion Device	마석 융합기를 확인
回收契約的空間魔石碎片	Retrieve the fragments of The Spatial Magic Gem of Contract	계약의 공간마석 파편 회수
啟動在記憶神堂的保存魔法陣	Activate the Magic Field of Preservation at the Shrine of Remembrance	기억의 신당에 있는 보존 마법진 가동
保護保存魔法陣	Protect the Magic Field of Preservation	보존 마법진 보호
將空間魔石投入魔石融合劑裡	Insert the Spatial Magic Gem into the Magic Gem Fusion Device	마석 융합기에 공간마석 투입
約定的空間魔石	Spatial Magic Gem of Promise	약속의 공간마석
收集濃縮的怨念 	Collect the Condensed Spite	응축된 원한 수집
破壞西亞烏拉坑道的結界石	Destroy the Barrier Stone at Siaura Mine	시아우라 갱도의 결계석 파괴
破壞結界石	Destroy the Barrier Stone	결계석 파괴
避開黑影追蹤者，回收被封印的空間魔石	Retrieve the Sealed Spatial Magic Gem by avoiding the Black Chaser	검은 추적자를 피해 봉인된 공간마석 회수
祭物的空間魔石	Spatial Magic Gem of Offer	제물의 공간마석
在記憶的神堂裡搜索神殿射手	Find Templeshooter at the Shrine of Remembrance	기억의 신당에서 템플슈터 수색
請使用智慧的引導石搜索神殿射手	Find Templeshooter using the Wisdom Guiding Stone	지혜의 인도석을 이용해서 템플슈터 수색
確認黑影	Check the Black Shadow	검은 그림자 확인
啟動魔石融合劑	Activate the Magic Gem Fusion Device	마석 융합기 가동
在勞迪樓閣裡啟動空間移動裝置	Activate the teleportation device to Laudi Tower	라우디 누각에서 공간 이동 장치 가동
在空間移動裝置上使用完成的空間魔石	Use the completed Spatial Magic Gems at the teleportation device	공간 이동 장치에 완성된 공간마석 사용
確認師父的遺產 	Examine the Master's Legacy	스승의 유산 확인
想傳達的話	Longing to Speak	전하고 싶은 말
與徘徊的靈魂對話	Talk to the wandering spirit	헤메는 영혼과 대화
在周圍尋找線索	Look for clues nearby	주변에서 단서 찾기
與奎波爾碧塔對話	Talk with Kupole Vita	큐폴 비타와 대화
找到其他靈魂並與其對話	Look for the remaining spirits and talk to them	다른 영혼들을 찾아서 대화
尋找靈魂們所說的物品	Look for an object that the spirits were describing	영혼들이 말하는 물건 찾기
請除去沉默之甕周圍凝聚的邪惡氣息	Eliminate the ominous energy that is condensing around the Pot of Silence	침묵의 항아리 주변에서 응집된 사악한 기운 제거
破壞沉默之甕	Destroy the Pot of Silence	침묵의 항아리 파괴
消滅展開突襲的魔族	Defeat the monsters that rushed in	습격해 온 마족 처치
並非自由之身	Unfree Beings	자유의 몸이 아냐
搜索能讓人聽到話的靈魂	Look for spirits wishing to speak to you	이야기를 들려줄 영혼 수색
交給里莫斯的靈魂	Hand them over to the Rimos' Spirit	리모스의 영혼에게 전달
與里莫斯的靈魂對話	Talk with the Rimos' Spirit	리모스의 영혼과 대화
燒毀肉體的契約陣	Burn the Contract of Flesh	육신의 계약진 태우기
向里莫斯的靈魂報告	Report to the Rimos' Spirit	리모스의 영혼에게 보고
消滅卡勒賓凱墓室的怪物吉尼	Defeat Master Genie at Garbingal Burial Chamber	가르빙갈 묘실의 마스터 지니 처치
和擊劍手大師對話	Talk with the Fencer Master	펜서 마스터와 대화
向擊劍手大師報告	Report to the Fencer Master	펜서 마스터에게 보고
閱讀念力法師魔法書前卷	Read all magic books of Psychokino	사이코키노 마법서 전권 읽기
在魔法師之塔1層消滅火焰蜥蜴王	Defeat Salamander at Mage Tower 1F	마법사의 탑 1층에서 샐러맨더 처치
消滅各地區的多樣怪物	Defeat a variety of monsters in different areas	여러 지역의 다양한 몬스터 처치
魔法師之塔偵查	Reconnoiter Mage Tower	마법사의 탑 정찰
奇術師的測試修行	Do the test of Thaumaturge	쏘마터지의 시험 수행
和隨軍牧師大師對話	Talk to the Chaplain Master	채플린 마스터와 대화
消滅德巴西安嶺的怪物回收遺失的材料	Retrieve stolen material by dealing with the monsters at Dvasia Peak	드바시아 고개의 몬스터를 처치하여 유실된 자재 회수
跟隨軍牧師大師報告	Report to the Chaplain Master	채플린 마스터에게 보고
和符文師大師對話	Talk with the Rune Caster Master	룬캐스터 마스터와 대화
到堤拉修道院收集符文石材料	Collect Rune Stone materials from Tyla Monastery	틸라 수도원에서 룬 스톤 재료 수집
跟符文師大師報告	Report to the Rune Caster Master	룬캐스터 마스터에게 보고
危急的賓申塔斯部隊	Vincetas' Squad In Peril	위기의 빈센타스 부대
與賓申塔斯對話	Talk to Vincentas	빈센타스와 대화
回收賓申塔斯部隊的物品	Retrieve Vincetas' Squad Keepsakes	빈센타스 부대의 물품 회수
在兵器庫搜索艾保尼風	Search for Ebonypawn in the Armory	병기고에서 에보니폰 수색
破壞艾保尼風的陷阱	Destroy Ebonypawn's Traps	에보니폰의 함정 파괴
破壞艾保尼風設置的陷阱	Destroy Ebonypawn's Traps	에보니폰이 설치한 함정 파괴
在補給地搜索艾保尼風	Search the Supplies Camp for Ebonypawn	보급지에서 에보니폰 수색
請前往補給地搜索艾保尼風。	Search Ebonypawn in the Supplies Camp 	보급지에서 에보니폰을 수색하세요.
障礙物清除	Remove Obstacle	장애물 제거
在糧倉搜索艾保尼風	Search for Ebonypawn in the Food Storage	식량창고에서 에보니폰 수색
回收賓申塔斯部隊的遺物	Retrieve the keepsakes of Vincentas' Squad	빈센타스 부대의 유품 회수
看到廢都連接路上有受到艾保尼風攻擊的賓森塔斯部隊隊員遺物。請將遺物收集完後交給賓森塔斯。	The keepsakes of Vincentas' Squad soldiers who have fallen at the hands of Ebonypawn	폐도 연결로에 에보니폰에게 당한 빈센타스 부대원들의 유품이 보입니다. 유품을 모아 빈센타스에게 전해주세요.
在兵營搜索艾保尼風	Find Ebonypawn in the Barrack	병영에서 에보니폰 수색
在整頓區域搜索艾保尼風的痕跡	Find the traces of Ebonypawn in the repair shop	정비구역에서 에보니폰의 흔적 수색
消滅暗殺者艾保尼風	Defeat Assassin Ebonypawn	암살자 에보니폰 처치
向賓申塔斯報告	Report to Vincentas	빈센타스에게 보고
與巫女大師對話	Talk to Miko Master	무녀 마스터와 대화
請與隱居者的通道的巫女大師對話。	Talkt to Miko Master at Passage of the Recluse	은둔자의 통로에 있는 무녀 마스터와 대화하세요.
確認巫女大師設下的結界	Check the Barrier Set By Miko Master	무녀 마스터가 펼쳐둔 결계 확인
命運的線頭，以及徬徨	Fluttering Threads of Destiny	운명의 실타래, 그리고 방황
發現碑石	Discover the tablet	비석 발견하기
請到努歐洛汀瀑布的小道岔路附近尋找碑石。	Look for the tablet near Sodo Fork of Nuoridin Falls	누오로딘 폭포의 소도 갈림길 근처의 비석을 찾아 보세요.
收集拓本材料	Collect materials to rubbings with	탁본 재료 수집
拓印拓本	Make rubbings	탁본 뜨기
尋找想要拓本的人	Look for someone who wants rubbings	탁본을 원할 만한 사람 찾기
比王國歷史更悠久的城牆	The Walls Outlasting the Kingdom	왕도보다 오래 가는 성벽
察看碑石	Examining the tablet	비석 살펴 보기
請察看斯克拉達後院的碑石。	Look at the tablet of Sklada Court	스클라다 안뜰의 비석을 살펴 보세요.
消滅展開突擊的怪物	Defeat the monsters that rushed in	습격해 오는 몬스터 처치
與亞特利尤斯對話	Talk to Adrijus	아드리유스와 대화
吃凱帕的方法	How to Eat a Kepa	케파를 먹는 법
請與中央聖所的亞特利尤斯對話。	Talk to Adrijus at The Central Sanctum	중앙 성소의 아드리유스와 대화 해 보세요.
收集亞特利尤斯請求的材料	Collect the materials Adrijus requested of you	아드리유스가 부탁한 재료 수집
交給亞特利尤斯	Hand them over to Adrijus	아드리유스에게 전달
請將好不容易取得的酸性體液與稀釋液拿給亞特利尤斯。	Hand over the acidic body fluid and the diluting solution to Adrijus	어렵사리 구한 진득한 산성 체액과 희석액을 아드리유스에게 건네 주세요.
向亞特利尤斯詢問碑石的內容	Ask Adrijus what's written on the tablet	아드리유스에게 비석의 내용 묻기
第一個碑文	The First Epitaph	첫 번째 비문
察看土堆	Inspect the lump of soil	흙더미 살펴 보기
製作石鍬	Craft a stone shovel	돌삽 만들기
用石鍬挖開堅硬的土堆	Shovel the soil away	삽으로 단단하게 굳은 흙더미 파기
為了讀碑石上頭的訊息，將碑石倒過來看	Turn the tombstone around to read the epitaph	비문을 읽을 수 있도록 비석 뒤집기
閱讀倒過來的碑石上的祕文	Read the epitaph of the flipped tombstone	뒤집힌 비석의 비문 읽기
第二個碑文	The Second Epitaph	두 번째 비문
察看過去殿堂的碑石	Look at the tombstone at the Hall of the Past	과거의 전당의 비석 살피기
從米諾斯手中收集碑石碎片	Collect the fragments of the tombstone from Minos	미노스에게서 비석 조각 수집
回到碑石那邊並嘗試復原碑石	Return to the tombstone and try to restore it	비석으로 돌아가 복원 시도
向柯拉佩達的鐵匠詢問有關黏著劑的事情	Ask the blacksmith in Klaipeda about adhesives	클라페다의 대장장에게 접착제에 대해 묻기
向柯拉佩達鐵匠詢問有關黏合劑	Ask the Blacksmith in Klaipeda About Adhesives	클라페다 대장장에게 접착제에 대해 묻기
向柯拉佩達的鐵匠詢問有關黏著劑的事情	Ask the blacksmith in Klaipeda about adhesives	클라페다의 대장장이에게 접착제에 대해 물어 보기
請回到那穆寺院的碑石	Return to the tombstone in the Namu Temple Ruins	나뮤 사원터의 비석으로 돌아가기
察看碑石	Inspect the tombstone	비석 살피기
收集黏稠樹脂	Collect Sticky Resin	끈적이는 수지 수집
黏貼碑石碎片	Restore the tombstone	비석 조각 붙이기
第三個碑文	The Third Epitaph	세 번째 비문
察看內畢耶達祭壇的碑石	Look at the tombstone in the Nevieda Altar Area	네비에다 제단 터의 비석 살펴 보기
請察看內畢耶達祭壇的碑石。	Look at the tombstone near the Nevieda Altar Area	네비에다 제단 터의 비석을 살펴 보세요.
收集乾草與油	Collect dry bushes and oil	잘 마른 덤불과 기름 수집
回到內畢耶達祭壇的碑石那	Return to the tombstone near Nevieda Altar Area	네비에다 제단 터의 비석으로 돌아가기
點燃包圍碑石的藤蔓 	Burn down the vines that are binding the tombstone	비석을 휘감고 있는 덩굴 태우기
在藤蔓燃燒的同時消滅怪物	Defeat the monsters while burning down the vines	덩굴 태우는 동안 몬스터 처치
尋找柯拉佩達的巴伊寶拉之翼	Meet the Wings of Vaivora in Klaipeda	클라페다의 바이보라의 날개를 찾아 가기
遇見尤斯達斯	Meet Justas	유스타스 만나기
請到研究營地與尤斯達斯見面。	Meet Justas at the Research Camp	연구 캠프에 있는 유스타스를 만나보세요.
與尤斯達斯對話	Talk to Justas	유스타스와 대화
收集骨頭碎片	Collect Bone Fragments 	뼛조각 수집
交給尤斯達斯	Give it to Justas	유스타스에게 전달
與祭司貝內地特對話	Talk to Priest Benedict	사제 베네딕트와 대화
收集研究所需的魔族標本	Collect demon samples that are needed for the research	연구에 필요한 마족의 표본 수집
交給祭司貝內地特	Deliver them to Priest Benedict	사제 베네딕트에게 전달
收集魔族的標本	Collect demon samples	마족의 표본 수집
消滅弄髒大教堂的魔族	Defeat the demons that are ruining the Great Cathedral	대성당을 더럽히는 마족 처치
大教堂至聖所全區域	All Areas of the Sanctuary	대성당 지성소 전 지역
吸引視線	Drawing Attention	시선 끌기
收集雷鳴草	Collect the herbs	우레초 수집
帶給在上層通道的下方的盜墓者阿曼達	Hand them over to the Grave Robber Amanda who is at the lower side of Upper Story Hallway	상층 통로 아랫쪽에 있는 도굴꾼 아만다에게 전달
偷走王軍警備兵擁有的炸彈	Steal the bombs from the guards	왕국군 경비병이 가지고 있는 폭탄 훔치기
帶給盜墓者阿曼達	Hand them over to the Grave Robber Amanda	도굴꾼 아만다에게 전달
和盜墓者阿曼達一起前往對立的訓練場	Move to Drill Ground of Confliction with Amanda	도굴꾼 아만다와 함께 대지의 요새 대립의 훈련장으로 이동
解除時代久遠的陷阱	Neutralize the old trap	오래된 트랩 해제하기
安全帶著回收的未爆彈給工兵大師。	Hand over the unexploded bombs to Sapper Master	안전하게 회수한 불발탄을 새퍼 마스터에게 전달하세요.
前往大地要塞 對立的訓練場	Move to Drill Ground of Confliction	대지의 요새 대립의 훈련장으로 이동
消滅攻擊王軍的怪物	Defeat the monsters that are attacking the soldiers	왕국군을 공격하는 몬스터 처치
與王國軍警備兵戴爾魯斯對話	Talk to Royal Army Guard Delus	왕국군 경비병 델루스와 대화
奪回屯駐地	Reclaim the Camp	주둔지 탈환
帶回脫隊的王國軍警備兵	Bring the Royal Army Guards who fell behind	낙오된 왕국군 경비병 데려오기
收集可以使用的裝備	Collect the equipment that can be used	사용 가능한 장비 모으기
跟著王軍警備兵往營地	Move to the base camp by following the guards	왕국군 경비병들을 따라 주둔지로 이동
消滅佔領營地的怪物	Defeat the monsters that are occupying the base camp	주둔지를 점령하고 있는 몬스터 처치
設置柵欄	Set the barricade	방책 설치
和露克立斯部隊將校的靈魂對話	Talk to the Ruklys Army Officer's Spirit	루클리스 부대 장교 영혼과 대화
消滅惡靈君主	Defeat Specter Monarch	스펙터 군주 처치하기
探索隱藏場所	Search for the hidden place	숨겨진 장소 탐색
大地要塞居住區域的盜墓者阿曼達對話	Speak with Grave Robber Amanda in the Residents' Area of the Fortress of the Land	대지의 요새 거주구역의 도굴꾼 아만다와 대화
消滅魔族	Defeat the demons	마족 처치
與大地要塞 貯藏區域年邁的管理者對話	Speak with the Old Manager in the Storage Quarter	대지의 요새 저장구역에서 늙은 관리인과 대화
與雕刻師大師對話	Talk to Dievdirbys Master	딥디르비 마스터와 대화
與阿斯塔對話	Talk to Hasta	아스타와 대화
與魔君主哈勃克對話	Talk to Demon Lord Hauberk	마군주 하우벅과 대화
請聽魔君主哈勃克的計畫。	Listen to Hauberk's plan	마군주 하우벅의 계획을 들으세요.
進入魔族收監所第1區	Enter the 1st District of the Demon's Prison	마족수감소 1구역 진입
與哈勃克的幻影對話	Talk to Hauberk's Spirit	하우벅의 환영과 대화
請與哈勃克的幻影對話	Talk to Hauberk's Spirit	하우벅의 환영과 대화하세요
與奎波爾奧德拉對話	Talk to Kupole Audra	큐폴 아우드라와 대화
請與魔族收監所受刑區的奎波爾奧德拉對話	Talk to Kupole Audra at the Demon's Prison	마족수감소 수형 구역의 큐폴 아우드라와 대화하세요
消滅正在進行儀式的魔族	Defeat the demons performing the ritual	의식을 진행중인 마족 처치
獲得布爾魯的信物	Obtain Blut's Marks	블룻의 증표 획득
交給奎波爾奧德拉	Give them to Kupole Audra	큐폴 아우드라에게 전달
幫助哈勃克吸收布魯爾的力量	Help Hauberk absorb Blut's powers	하우벅이 블룻의 힘을 흡수하도록 돕기
與奎波爾吉德羅勒對話	Talk to Kupole Zydrone	큐폴 지드로네와 대화
請與奎波爾吉德羅勒對話	Talk to Kupole Zydrone	큐폴 지드로네와 대화하세요
處治魔君主布魯爾	Punishment of the Demon Lord Blut	마군주 블룻의 처단
消滅布爾魯	Defeat Blut	블룻처치
與奎波爾阿露納對話	Talk to Kupole Arune	큐폴 아루네와 대화
已利用轉移縫隙除掉越界的魔族	Defeat the demons that arrived from the dimensional crack	전이 틈새로 넘어온 마족 처치
消滅第1隔離區的魔族 	Defeat the demons of the 1st Isolation Area	제1 격리구의 마족 처치
獲得哈勃克的信物	Obtain Hauberk's Marks	하우벅의 증표 획득
審問關於努亞耶雷的計畫	Interrogation of Nuaele's plan	누아엘레의 계획 심문
消滅哈路卡爾	Defeat the Harugals	하루갈 처치
消滅第4隔離區的哈路卡爾	Defeat Harugals in the 4th Isolation Area	제4 격리구의 하루갈 처치
消滅魔君主努亞耶雷	Defeat Demon Lord Nuaele	마군주 누아엘레 처치
尋找女神瓦卡麗涅	Meet Goddess Vakarine	여신 바카리네 찾아가기
與女神瓦卡麗涅對話	Talk to Goddess Vakarine	여신 바카리네와 대화
請與女神瓦卡麗涅對話	Talk to Goddess Vakarine	여신 바카리네와 대화하세요
除去小的轉移縫隙	Remove Small Dimensional Crack	작은 전이 틈새 제거
保護奎波爾吉德羅勒	Protect Kupole Zydrone	큐폴 지드로네 보호
與奎波爾阿爾多納對話	Talk to Kupole Aldona	큐폴 알도나와 대화
封印解除	Release the Seals	봉인 해제
打倒迪歐尼斯	Defeat Dionys	디오니스 제압
與奎波爾達伊巴對話	Talk to Kupole Daiva	큐폴 다이바와 대화
追擊魔君主哈勃克	Pursue Demon Lord Hauberk	마군주 하우벅 추적
消滅哈勃克的走卒	Defeat the servants of Hauberk	하우벅의 졸개 처치
收集哈勃克的靈魂碎片	Collect Hauberk's Soul Fragments	하우벅의 영혼조각 수집
交給奎波爾達伊巴	Give them to Kupole Daiva	큐폴 다이바에게 전달
回收哈勃克的靈魂碎片	Retrieve the pieces of the spirit of Hauberk	하우벅의 영혼조각 회수
逼迫哈勃克	Pursue Hauberk	하우벅 몰아넣기
追擊哈勃克	Chase after Hauberk	하우벅 추적
與奎波爾希奇答對話	Talk to Kupole Sigita	큐폴 시기타와 대화
制壓魔君主哈勃克	Suppress Demon Lord Hauberk	마군주 하우벅 제압
進行關閉轉移縫隙的儀式	Perform ritual to close the dimensional crack	전이 틈새를 닫는 의식 진행
請幫助女神瓦卡麗涅進行關閉轉移縫隙的儀式。	Help Goddess Vakarine in her ritual to close the dimensional crack	여신 바카리네의 전이 틈새를 닫는 의식을 도와 주세요.
收集轉移傷痕	Collect the traces of the metastasis	전이의 흔적 수집
以暮星符文制壓魔族	Suppress demons using the Evening Star Rune	저녁별 룬으로 마족 제압
獲得封印信物	Obtain Sealing Tokens	봉인의 증표 획득
交給女神瓦卡麗涅	Give it to Goddess Vakarine	여신 바카리네에게 전달
收集死囚標誌	Collect the symbols of the condemend criminal	사형수의 징표 수집
保護女神瓦卡麗涅	Protect Goddess Vakarine	여신 바카리네 보호
消滅想逃跑的怪物	Defeat the monsters that are trying to escape	탈출하려는 몬스터 처치
收集探查隊的遺物	Collect the keepsakes of the investigation team	탐사대의의 유품 수집
獲得探查隊的遺物	Obtain the belongings of the investigation team	탐사대의 유품 획득
消滅努亞耶雷的餘黨	Defeat the remnants of Nuaele	누아엘레의 잔당 처치
收集努亞耶雷的碎片	Collect the fragments of Nuaele	누아엘레의 파편 수집
交給奎波爾阿露納	Take it to Kupole Arune	큐폴 아루네에게 전달
回收努亞耶雷的碎片	Retrieve the fragments of Nuaele	누아엘레의 파편 회수
除掉巴特羅斯的殘黨	Defeat the remnants of Valtross	발트러스의 잔당들 처치
收集迪歐尼斯的腳趾甲	Collect Dionys' Claws	디오니스의 발톱 수집
交給奎波爾艾爾杜納	Give it to Kupole Aldona	큐폴 알도나에게 전달
收集被破壞的星之標誌	Collect the destroyed Mark of Stars	파괴된 별의 징표 수집
消滅哈勃克的殘黨	Defeat Hauberk's remnant forces	하우벅의 잔당 처치
收集魔族的牙齒	Collect Demon's Teeth	마족의 이빨 수집
取得魔族的牙齒	Obtain the teeth of the demons	마족의 이빨 획득
除掉巴那卡監視區的魔族	Defeat the demons of Vanaga Monitor District	바나가 감시구의 마족 처치
收集空洞的靈魂	Collect the empty spirits	텅빈 영혼 수집
交給奎波爾希奇答	Deliver to Kupole Sigita	큐폴 시기타에게 전달
獲得空洞的靈魂	Obtain the empty spirit	텅 빈 영혼 획득
除去小型轉移縫隙	Remove the Small Dimensional Crack	소형 전이 틈새 제거
關閉轉移縫隙	Seal the dimensional crack	전이틈새 닫기
和托馬洛弗對話	Talk to Tomalov	토말로프와 대화
收集堅韌的翅膀	Collecting Sticky Wings	끈적한 날개 수집
向托馬洛弗報告	Report to Tomalov	토말로프에게 보고
和德魯伊艾爾利對話	Talk to Druid Ellie	드루이드 엘리와 대화
收集橘色蜥蜴人的皮革	Collect Orange Lizardman Leather	주황 리자드맨의 가죽 수집
帶給德魯伊艾利皮革	Hand it over to Druid Ellie	드루이드 엘리에게 가죽 전달
收集受污染的土壤樣本	Collect the samples of corrupted soil	오염된 토양의 표본 수집
將受污染的土壤樣本交給艾爾利	Hand over the samples of corrupted soil that you obtained for Druid Ellie	엘리에게 오염된 토양의 표본 전달
與德魯伊艾爾利一起確認實驗結果	Check the experiment's result with Druid Ellie	드루이드 엘리와 함께 실험 결과 확인
收集橘色泰瑪的體液	Collect the body fluid of Orange Tamas	주황 타마의 체액 수집
交給德魯伊艾爾利	Hand it over to Druid Ellie	드루이드 엘리에게 전달
在夏頓農場尋找知道馬勒提內下落的人	Look for a person who is likely to know the whereabouts of Martinek at Shaton Farm	샤튼 농장에서 마르티넥의 행방을 알 만한 사람 찾기
與農夫達阿西對話	Talk to Farmer Darcy	농부 다아시와 대화
除掉橘色蜥蜴人 	Defeat Orange Lizardmen	주황 리자드맨 처치
除掉荒廢的葡萄園附近的橘色蜥蜴人	Defeat Orange Lizardmen at Abandoned Grape Farm	방치된 포도밭 근처에서 주황 리자드맨 처치
除去生長不良的蒲公英	Get rid of the young dandelions	덜 자란 민들레 제거
與農夫米雷對話	Talk to Farmer Miren	농부 미렌과 대화
除掉奇烏拉三岔路口附近的橘色蜥蜴人	Defeat Orange Lizardmen at Ziura Crossroads	지우라 삼거리 주변의 주황 리자드맨 처치
尋找老舊包袱	Find Miren's Old Bag	낡은 봇짐 찾기
交給農夫米雷	Hand it over to Miren	농부 미렌에게 전달
與調查官莫納漢對話	Talk with Investigator Monahan	조사관 모나한과 대화
收集蘭姆貝兒的毛球	Collect Rambear Fur	램베어의 털뭉치 수집
交給調查官莫納漢	Hand it over to Investigator Monahan	조사관 모나한에게 전달
請收集阿巴魯茲葡萄田的葡萄根	Collect the grapevine roots from Avarza Grape Farm	아바르자 포도밭에서 포도 뿌리 수집
與農場監督官多稜對話	Talk to Farm Supervisor Dorn	농장 감독관 도른과 대화
交給農場監督官多稜	Hand them over to Farm Supervisor Dorn	농장 감독관 도른에게 전달
搜索農場各處隱藏的糧食袋 	Search through the sacks of grain that are scattered across the farm	농장의 곳곳에 숨겨진 빼돌린 곡식 주머니 수색
與德魯伊馬勒提內對話	Talk to Druid Martinek	드루이드 마르티넥과 대화
治療中毒的農民	Cure the poisoned farmers	중독된 농민 치료
利用調教木棍，把飛天青蛙帶來	Bring winged frogs with the help of the obedience stick	조련 막대로 날개 개구리 데려오기
使卡伍沙作業場的井水湧出	Get some water from the well at Gausa Workplace	가우사 작업장의 우물물 떠오기
交給德魯伊馬勒提內	Hand it over to Druid Martinek	드루이드 마르티넥에게 전달
往夏頓蓄水區移動	Go to the reservoir district of Shaton	샤튼 저수구역으로 이동
與農場士兵蓋德森對話	Talk with Farm Soldier Gedson	농장 사병 게드슨과 대화
消滅西斯特	Defeat Cysts	시스트 처치
除掉橘色樹妖	Eliminate the Orange Stumpy Trees	주황 몽당나무 처치
與佃戶夏爾洛對話	Talk to Tenant Farmer Charlotte	소작인 샬롯과 대화
把夏爾洛的特製藥水噴灑在葡萄藤蔓上	Spray Charlotte's special potion on the spoiled grape vines	포도 넝쿨에 샬롯의 특제 물약 뿌리기
調查樹叢，消滅橘色泰瑪	Investigate the bushes and defeat Orange Tamas	덤불을 조사해 주황 타마 처치
請回去找佃戶拜斯。	Talk to Tenant Weiss	소작인 바이스와 대화
除掉吉魯拓釀造場附近的西斯特 	Defeat the Cysts near the brewery	지르타 양조장 근처의 시스트 처치
從老舊包袱中獲得種子袋 	Obtain the seed pouch from the old bag	낡은 봇짐에서 씨앗 주머니 획득
交給佃戶拜斯	Take it to Tenant Farmer Weiss	소작인 바이스에게 전달
與庫魯德夏頓對話	Talk to Gord Shaton	고르드 샤튼과 대화
與芭內莎對話	Talk to Vanessa Shaton	바네사 샤튼과 대화
在地道裡搜索夏頓兒子的痕跡 	Look for the traces of Shaton's son at the underground tunnel	땅굴에서 샤튼의 아들의 흔적을 수색
交給芭內莎夏頓	Hand it over to Vanessa Shaton	바네사 샤튼에게 전달
除掉粉紅樹根地鼠	Defeat Pink Tree Root Moles	분홍 나무뿌리 두더지 처치
消滅被召喚的怪物	Defeat the summoned monsters	소환된 몬스터 처치
與管家巴雷對話	Talk to Steward Valen	집사 바렌과 대화
消滅草綠卡樂卡修	Defeat Green Carcashu	초록 카르카슈 처치
尋找藥袋	Find Valen's medicine bags	약 주머니 찾기
交給管家巴雷	Hand it over to Steward Valen	집사 바렌에게 전달
與士兵隊長布洛斯對話	Talk to General Buros	사병대장 뷰로스와 대화
除掉地道的粉紅樹根地鼠	Defeat the Pink Tree Root Moles beyond the tunnels	땅굴 너머의 분홍 나무뿌리 두더지 처치
除掉風向儀之塔附近的葛雷斯墨爾	Defeat the Glass Mole near the Wind Vane Tower	풍향계 탑 근처의 글래스몰 처치
除掉葛雷斯墨爾	Defeat Glass Mole	글래스몰 처치
與脫隊的士兵歐漢對話	Talk with Farm Soldier Upham	낙오된 사병 업햄과 대화
引領農場士兵歐漢到安全地帶	Escort Farm Soldier Upham to a safe place	농장 사병 업햄을 안전지대로 인도
觀察謎樣陷阱	Inspect the Mysterious Trap 	의문의 함정 살펴보기
與資深修道士佛特斯對話	Talk to Senior Monk Potos	선임 수도사 포토스와 대화
與獵人雷伊娜對話	Talk to Hunter Reina	헌터 레이나와 대화
使用賈雷斯以搜查陷阱	Search for the trap using Jareth	쟈레쓰를 이용해 함정 수색
與獵人納塔夏對話	Talk to Hunter Natasha	헌터 나타샤와 대화
與修道士瓦以利對話	Talk to Monk Wiley	수도사 와일리와 대화
收集精典散頁	Collect the pages of the scripture	경전 낱장 수집
交給修道士瓦以利	Hand them over to the Monk Wiley	수도사 와일리에게 전달
採集坦帕斯蘑菇	Collect Tempas Mushrooms	템파스 버섯 채집
收集勒多的石橋	Collect Rocktor's Stony Legs	락터의 돌다리 수집
交給獵人雷伊娜	Hand them over to Hunter Reina	헌터 레이나에게 전달
賈雷斯的狩獵幫助	Hunt together with Jareth	쟈레쓰의 사냥 돕기
與資深修道士馬勒寇對話	Talk to Senior Monk Marko	선임 수도사 마르코와 대화
與修道士們對話	Talk to the monks	수도사들과 대화
未知的毒	Unidentified Poison	모르는 독
收集切波勒的尖刺毒 	Collect Chafperor Thorn Venom	체이퍼러의 가시독 수집
收集尖刺樹木根部濃烈的毒	Collect Toxic Thorn Tree Stump Sap	가시나무 밑둥의 진한 독 수집
收集泉裡聚積的毒液	Collect Spring Water Venom	샘에 고인 독액 수집
交給獵人納塔夏	Hand them over to Hunter Natasha	헌터 나타샤에게 전달
收集烏勒德瓦的葉片	Collect Woodluwa Leaves 	우르드와의 잎사귀 수집
與獵人巴斯提爾對話	Talk to Hunter Bastille	헌터 바스틸과 대화
收集解毒用藥草	Collect herbs for detoxification	해독용 약초 모아오기
交給獵人巴斯提爾	Hand them over to Hunter Bastille	헌터 바스틸에게 전달
與修道士查德對話	Talk to the Monk Chad	수도사 채드와 대화
收集蜜蠟	Collect beeswax	밀랍 수집
交給修道士查德	Hand them over to Monk Chad	수도사 채드에게 전달
補獵烏勒德瓦，收集黏液	Hunt Woodluwas and collect some resin	우드르와를 사냥하고 진액 수집
與資深修道士古斯對話	Talk to Senior Monk Goss	선임 수도사 거스와 대화
請消滅地錢苔與史托內坤收集證據	Defeat Liverworts and Stonacons and collect evidence	우산이끼와 스토내콘을 처치하고 증거 수집
交給資深修道士古斯	Hand them over to Senior Monk Goss	선임 수도사 거스에게 전달
調查帕沙圖休憩地的墳墓	Investigate the grave at Priekis Rest Area	파사로 쉼터의 무덤 조사
請與獵人納塔夏對話，並聽他說明有關信件的事情。	Talk to Hunter Natasha about the letter	헌터 나타샤와 이야기해 편지에 대해 들어보세요.
與堤拉修道院的資深修道士古斯對話	Talk to Senior Monk Goss in Tyla Monastery	틸라 수도원에서 선임 수도사 거스와 대화
與修道士勇斯對話	Talk to Monk Jones	수도사 욘스와 대화
消滅地錢苔與史托內坤	Defeat Liverworts and Stonacons	우산이끼와 스토내콘 처치
消滅地錢苔	Defeat Liverworts	우산이끼 처치
消滅史托內坤	Defeat Stonacons	스토내콘 처치
採集阿錫拉多水草	Collect Acylado Hydrophyte	아실라도 수초 채집
交給修道士勇斯	Hand them over to Monk Jones	수도사 욘스에게 전달
與修道士傑普利對話	Talk to Monk Jeffery	수도사 제프리와 대화
修道院修復計畫	Mission to Retake the Monastery	수도원 수복 작전
攻破艾瑪斯殿堂	Storm through Apmas Hall	앱마스 전당까지 돌파
攻破洛提卡殿堂 	Break through Raktika Hall	락티카 전당 돌파
攻破比提斯噴泉	Storm through Viltis Fountain	빌티스 분수대 돌파
移動到祈禱室前面	Move to the front of the Prayer Room	기도실 앞으로 이동
呼喚前的準備作業	Preparations for the Call	부름을 위한 준비작업
與修道士莫漢對話	Talk to Monk Moheim	수도사 모하임과 대화
請到接待室的樹箱裡搜尋水晶球	Search for the Crystal Ball in the wooden box in the Reception Room	응접실의 나무 상자에서 수정구 수색
與修道院長對話	Talk to the abbot	수도원장과 대화
除去有味道的團塊	Remove the Smelly Lump	냄새나는 덩어리 제거
消滅修道院的怪物	Defeat the monsters in the Monastery	수도원의 몬스터 처치
消滅修道院內的怪物	Defeat the monsters in the Monastery	수도원 내의 몬스터 처치
尋找堤拉修道院的經典	Look for the scripture at Tyla Monastery	틸라 수도원의 경전 찾기
交給修道士莫漢	Hand them over to Moheim	수도사 모하임에게 전달
收集重裝步兵的斷槍碎片和破碎鎧甲	Collect Broken pieces of spear and armor of Hoplites	하플라이트들의 부러진 창 조각과 부서진 갑옷 수집
查看死靈法師亞多瑪斯	Look for Necromancer Adomas carefully	네크로맨서 아도마스 살피기
搜查亞多瑪斯的背包	Search the bag of Adomas	아도마스의 가방 수색
把紙條交給死靈法師蕾米亞	Hand over the memo to Necromancer Lemija	네크로맨서 레미야에게 쪽지 전달
和死靈法師蕾米亞對話	Talk with Necromancer Lemija	네크로맨서 레미야와 대화
前往坎西亞溪邊確認亞多瑪斯的屍體	Move to Kansia Brookside to check the corpses of Adomas	아도마스의 시신을 확인하러 칸시아 개울가로 이동
這裡發生過的事	An incident that occurred here	이 곳에서 있었던 일
搜查士兵屯駐地	Search the soldiers' post	병사 주둔지 수색
士兵屯駐地搜查結果	The results of the search at the soldier post	병사 주둔지 수색 결과
請打聽此地發生了什麼事。	Find out what occurred here	이곳에서 무슨 일이 일어났는지 알아보세요.
追逐慘叫聲	Chase after the sound of the scream	비명소리 쫓아가기
前往傳來慘叫聲的斯沛加泉水	Move to Spega Springs where the sound of the scream came from	비명소리가 난 스패가 샘터 쪽으로 이동
保護蕾米亞並消滅怪物	Defeat the monsters while protecting Lemija	레미야를 지키며 몬스터 처치
為他們的安息祈禱	Praying for their eternal rest	그들의 안식을 기도하며
從怪物那裡收集屍體碎片	Collect the pieces of the corpses of the monsters	몬스터로부터 사체 조각 수집
把屍體碎片交給死靈法師蕾米亞	Hand over the pieces of the corpses to Necromancer Lemija	네크로맨서 레미야에게 사체조각 전달
消滅怪物收集屍體碎片	Defeat the monsters and collect the pieces of the corpses	몬스터를 처치하여 사체 조각 수집
從冰凍的士兵身上吸收帕烏斯達斯的魔力	Absorb the magical power of Faustas from the frozen soldier	얼어붙은 병사에게 깃든 파우스타스의 마력 흡수
把蘊含魔力的符咒交給死靈法師蕾米亞	Hand over the talisman that contains the magical power to Necromancer Lemija	마력이 깃든 부적을 네크로맨서 레미야에게 전달
前往帕烏斯達斯的隱居地	Move to the hideout of Faustas	파우스타스의 은거지로 이동
阻止帕烏斯達斯	Stop Faustas	파우스타스 저지
和死靈法師帕烏斯達斯對話	Talk with Necromancer Faustas	네크로맨서 파우스타스와 대화
消滅突變的亞多瑪斯	Defeat the transformed Adomas	변이한 아도마스 처치
確認陳舊的信件	Check the old letter	낡은 편지 확인
請閱讀從屯駐地找到的陳舊的信件。	Read the old letter which you found from the hideout	주둔지에서 찾은 낡은 편지를 읽어보세요.
把信交給收件人	Pass the letter to the receiver	수취인에게 편지 전달
他們的事由	The Story Behind Them	그들의 사연
確認部隊長的紙條	Check the memo of the commander	부대장의 쪽지 확인
搜查部隊長躲藏的屋子	Search the house where the commander is hiding	부대장이 숨어 있는 집 수색
和貝達高原部隊長對話	Talk with the commander at Vedas Plateau	베다 고원 부대장과 대화
把戒指交給貝魯克堤廣場的將校蕾堤亞	Hand over the ring to Guard Retia at Verkti Square	베르크티 광장의 장교 레티아에게 반지 전달
收集貝達高原士兵的遺物	Collect the relics of the soldiers at Vedas Plateau	베다 고원의 병사 유품 수집
把遺物交給死靈法師蕾米亞	Hand over the goods to Necromancer Lemija	네크로맨서 레미야에게 유품 전달
確認可疑的法杖碎片	Check the Suspicious Wand Fragment	의문의 지팡이 파편 확인
找尋了解法杖的碎片的專家	Find Someone to Ask About the Wand Fragment	지팡이의 파편에 대해 알 만한 사람 찾아가기
消滅那些感受到碎片反應的怪物	Defeat the Monsters Attracted by the Fragment's Reaction	파편이 반응하자 이를 감지하여 몰려드는 몬스터 처치
從周為怪物身上收集碎片	Obtain Another Fragment From the Monsters	주변 몬스터에게서 또 다른 파편 수집
完成製作中的魔法陣	Complete the Unfinished Magic Circle	미완성 마법진 완성
淨化貝里歐羅	Purify the Burialers	베리얼러 정화
跟愛德華對話	Talk to Edward	에드워드와 대화
收集愛德華的裝備	Recover Edward's Equipment	에드워드의 장비 수집
採集不明花朵	Collect the Unknown Flower	정체불명의 꽃 채집
收集西斯特的體液	Collect Cyst Fluid	시스트의 체액 수집
保護愛德華不受怪物攻擊	Protect Edward from the Monsters	몬스터들로부터 에드워드 보호
採集麥菲妮亞藥草 	Collect Melbania Herbs	멜바니아 약초 채집
採集稀有的花	Collect the Rare Flower	희귀한 꽃 채집
採集柯卡特的肉	Collect Cockat Meat	코카트의 고기 수집
確認陷阱	Check the Trap	함정 확인
尋找熟悉陷阱的獵人	Find a Hunter to Ask About the Trap	함정에 대해 알 만한 헌터 찾아가기
從潘德洛希溫取得蜂蜜	Obtain Honey From the Pendrosiums	팬드로시움으로부터 꿀 획득
消滅因普羅卡拉斯博學者	Defeat the Infrogalas Mages	인프로 갈라스 메이지 처치
啟動移動干擾裝置	Activate the Blocking Devices	이동 방해장치 활성화
消滅羅佛特倫	Defeat the Loftlems	로프틀렘 처치
採集地錢苔的孢子	Collect Liverwort Spores	우산이끼의 포자 채집
在野營地附近埋藏幻覺魔法石	Bury the Hallucination Stone Nearby	야영지 주변에 환각마법석 묻기
收集發光的石碎片	Collect Sparkling Stones	빛나는 돌조각 수집
收集水晶碎片	Collect Crystal Fragments	수정조각 수집
與警備兵豪頓對話	Talk to Guard Horton	경비병 호튼과 대화
探勘潛水區域	Check the Flooded District	침수 구역 확인
收集緊急糧食	Retrieve Emergency Food Supplies	비상식량 수집
與警備兵麥德遜對話	Talk to Guard Manderson	경비병 맨더슨과 대화
收集貴重物品	Retrieve the Valuable Objects	귀중품 수집
探勘里榭斯烽火台	Investigate Lyshys Beacon Mound	리쉬스 봉화대 살펴보기
尋找莎勒斯修女院	Find the Saalus Convent	살러스 수녀원 찾아가기
確認自由地下城位置	Find the Hunting Grounds	프리던전 위치 찾기
標記大地要塞中注意事項	Report on the Environment Inside the Fortress of the Land	대지의 요새 안에서 주의해야 할 점들 표시하기
與迪庫盜墓團亞勒奇達斯對話	Talk to Arghidas from the Dico Tomb Thieves	디코 도굴단 아르기다스와 대화
把亞勒奇達斯所取得的物品轉交給葳荷米娜凱利奧特	Deliver the Objects Gathered by Arghidas to Wilhelmina	아르기다스가 구한 물건을 빌헬미나 캐리어트에게 전달하기
以穿戴3個以下的防具的狀態去消滅怪物	Defeat a Strong Monster While Equipping 3 or Less Armor Items	현재 착용 중인 방어구가 3개 이하인 상태로 강한 몬스터를 처치하기
與阿曼達對話	Talk to Amanda	아만다와 대화
接受雕刻師大師的幫忙	Ask the Dievdirbys Master for Help	딥디르비 마스터에게 도움 받기
未知文字的真正意涵	Deciphering the Mysterious Writings	알 수 없는 문자의 정체
去請教了解碑石文字的人吧！	Talk to Barte About the Writings on the Tombstone	비석에 나온 문자에 대해 알고 있을 만한 사람인 바르테와 대화하세요
用探測器找尋詛咒的物品並回收	Find the Cursed Objects Using the Curse Detector	탐지기로 저주의 물건을 찾아 회수하기
帕薩卡峽谷全區	The Entire Region of Fasika Plateau	파사카 협곡 전 지역
利用凱都拉商團探測器去找凱都拉商團的物品	Find the Kedoran Alliance Ledge Using the Detector	케도라 상단의 탐지기로 케도라 상단의 물건 찾기
凱那魯平原全區域	All Over Genar Field	게나르 평원 전 지역
取得聖光之粉	Obtain the Holy Powder	홀리 파우더 구해오기
尋找黃昏侍女精髓	Obtain Dawn Maiden Essence	황혼의 시녀 정수 구하기
發怒的蜜蜂們	Angry Bees	성난 벌들
取得香草材料	Obtain the Materials for the Candle	향초의 재료를 구하기
設置香草	Place the Candle	향초 설치하기
向刀騎兵大師證明你的資格	Prove Yourself to the Hackapell Master	하카펠 마스터에게 자격을 증명하기
撫慰神靈	Appease the Divine Spirit	신령을 달래기
消滅惡靈	Defeat the Evil Spirit	악령 처치하기
品質證明[鑑定師轉職]	Quality Certificate [Appraiser Advancement]	품질 인증서[감정사 전직]
與鑑定師大師對話	Talk to the Appraiser Master	감정사 마스터와 대화
帶來要鑑定的物品	Pick Up the Objects for the Appraiser Master	감정 받을 물건 가져오기
轉交品質證明	Deliver the Quality Certificates	품질 인증서 전달하기
把品質證明轉交給擊劍手大師飾品商人猶勒斯	Deliver the Certificates to the Fencer Master and Accessory Merchant Jurus	펜서 마스터와 악세서리 상인 유르스에게 품질 인증서 전달하기
與鑑定師大師對話	Talk to the Appraiser Master	감정사 마스터와 대화하기
刮取樹叢收集中	Collecting the bushes	덤불을 긁어 모으는 중
正在挖出金屬板	Digging up the Metal Plate	금속판을 파내는 중
對付黑暗屬性的姿勢[元素使轉職]	Attitude Towards the Dark Property [Elementalist Advancement]	어둠 속성을 상대하는 자세[엘리멘탈리스트 전직]
尾巴長就會被捉住	A Long Tail Gets Caught	꼬리가 길면 잡힌다
勒肯家門的名譽	Honor of the Legwyn Family	르귄 가문의 명예
勒肯家門的印章	Legwyn Family's Seal 	르귄 가문의 인장
毒之高手	The Master of Poison 	독의 고수
念力法師的魔法學習	Magic Studies of Psychokino	사이코키노의 마법공부
從波亞塔手上找回勒肯家門的飾品	 Retrieve the Legwyn Family Ornament from the Poata	포아타에게서 르귄 가문의 장식 찾기
消滅怪物收集勒肯家門的印章碎片	Defeat Monsters and Obtain Fragments of Legwyn's Seal	몬스터를 처치해서 르귄 가문의 인장 조각 수집
消滅波亞塔找回勒肯家門的飾品	Defeat Poata and Retrieve the Legwyn Family Crest	포아타를 처치하고 르귄 가문의 장식 찾기
