槍彈者大師	Bullet Marker Master	불릿 마커 마스터
你能幫忙取得我拜託你的東西嗎？	Are you prepared for what I am going to request of you?	그러니 내가 부탁하는 걸 좀 구해주지 않겠어?
龍騎士大師	Dragoon Master	드라군 마스터
咒術師大師	Warlock Master	워록 마스터
妖術師大師	Featherfoot Master	페더풋 마스터
重砲手大師	Cannoneer Master	캐노니어 마스터
火槍手大師	Musketeer Master	머스킷티어 마스터
瘟疫醫師大師	Plague Doctor Master	플레이그 닥터 마스터
卡巴拉大師	Kabbalist Master	카발리스트 마스터
忍者大師	Shinobi Master	시노비 마스터
薩勒瑪	Sarma	사르마
你有找到甚麼蛛絲馬跡嗎？	Have you found out something?	뭔가 알아낸 게 있어?
能啟動魔法的暗號就是 	The magic sentence is	마법을 발동할 수 있는 문장은 
順利取得王之黃寶石了嗎？{nl}	You've acquired the Yellow Jewel?	왕의 노란 보석은 무사히 손에 넣었어?{nl}
卡雷伊瑪斯監獄的啟示	Revelation of Kalejimas Prison	칼레이마스 감옥의 계시
牆壁的塗鴉	Writings on the Wall	벽의 낙서
研究員艾達斯	Researcher Adas	연구원 에이다스
研究員彼特	Researcher Veed	연구원 비드
研究員席蕾亞	Researcher Sireah	연구원 시레아
你都看到了嗎？	Are you back?	보고 오셨나요?
奎波爾 密爾達	Kupole Milda	큐폴 밀다
到底是因為什麼，怪物們才這樣聚集過來了？	What could be making the monsters gather like that?	무엇 때문에 몬스터들이 이렇게 몰려드는 걸까요?
還有看出甚麼了嗎？	Did you find anything else?	뭔가 더 알아낸 게 있으신가요?
補給兵的靈魂	Supply Soldier's Spirit	보급병의 영혼
城壁看守士兵的靈魂	Castle Wall Soldier's Spirit	성벽 병사의 영혼
偵察兵的靈魂	Scout Soldier's Spirit	정찰병의 영혼
碎片都收集完成了嗎？{nl}	Did you bring the sculptures?	조각들은 모아오셨나요?{nl}
麥斯帕斯拉部隊長高曼	Mesafasla Assistant Commander Gomen	메사파슬라 부대장 고먼
補給路的石化探測器是否正常運作呢？{nl}	Is the detector at the supply route working alright?	보급로의 석화탐지기는 제대로 작동을 하고 있는 걸까요?{nl}
守墓人布魯納爾	Forest Keeper Brunonas	산지기 브루노나스
採藥者 柴吉李斯	Herbalist Cesaris	약초꾼 채자리스
樵夫 道維達斯	Lumberjack Dowedas	나무꾼 도위다스
時空法師艾伊達	Chronomancer Ida	크로노맨서 아이다
奎波爾 麗娜	Kupole Lina	큐폴 리나
奎波爾艾格雷	Kupole Aeglei	큐폴 에글레
難民代表摩爾庫斯	Refugee Representative Morcus	피난민 대표 모르쿠스
硬漢艾維德斯	Ejuidas	에이위다스
小女孩嗎？{nl}那小女孩的名字叫做赫莉塔？	A child? The little one is called Willitte?	꼬마?{nl}그 아이 이름이 윌리타?
小女孩赫莉塔	Little Willitte	꼬마 윌리타
難民希達	Refugee Hilda	피난민 힐다
法師 突爾利斯	Wizard Tulis	위저드 튤리스
村莊祭司凱拉依默斯	Village Priest Chaleims	마을 사제 칼레임스
村莊居民 德亞伊蘭	Villager Deailan	마을 주민 드아일란
村莊居民 阿勒基斯	Villager Argis	마을 주민 아르기스
村莊居民 艾密斯	Villager Emils	마을 주민 에밀스
奎波爾席烏太	Kupole Siute	큐폴 시우테
信徒 亞武努斯	Believer Jaonus	신도 야우뉴스
信徒 科斯塔斯	Believer Costas	신도 코스타스
雕刻師亞捷爾	Dievdirbys Asel	딥디르비 아젤
嘉魅爾蘭	Jamelhan	자멜란
士兵 加爾蘭斯	Soldier Guylens	병사 가일랜스
士兵 凱蘭斯	Soldier Callans	병사 칼란스
士兵 加爾連斯	Soldier Guylens	병사 가일렌스
士兵 安德雷	Soldier Andre	병사 안드레
副隊長 必拉斯	Assistant Commander Vilas	부대장 빌라스
你的真面目為何?	Who are you?	자네 정체가 뭔가?
偵查兵寶亞斯	Scout Boas	정찰병 보아스
士兵 海藍斯	Soldier Hyrance	병사 하이란스
士兵 凱爾倫	Soldier Kuijlen	병사 카일른
士兵 哈爾倫	Soldier Heulen	병사 하일른
副隊長是想對我們說什麼呢？	What does the Assistant Commander want to say to us?	부대장님이 저희에게 무슨 말씀을 하시려는 걸까요?
礦山工人	Mine Worker	광산 인부
治療劑做好了嗎？	Did you finish the antidote?	치료제는 어떻게 됐습니까?
附魔師大師	Enchanter Master	인챈터 마스터
道士大師	Taoist Master	도사 마스터
新審判者大師	Inquisitor Master	인퀴지터 마스터
奎波爾 蕾妲	Kupole Leda	큐폴 레다
艾高斯修道士	Elgos Monk	엘고스 수도사
第1代王位繼承紛爭記的忍者大師 - 第1卷	The Shinobi Master of the First Battle for the Throne - Volume 1	제1차 왕위 계승분쟁기의 시노비 마스터 - 제1권
鬥牛士助手	Matador's Assistant	마타도르 조수
死靈法師蕾米亞	Necromancer Lemija	네크로맨서 레미야
商團工人	Merchant Alliance Worker	상단 일꾼
迪比利斯制馭所魔力源	Devries Controller Spell Source	디브리스 제어소 마력원
中央研究室 魔力源	Central Laboratory's Magic Source	중앙연구실 마력원
研究者聚會所魔力源	Researcher Auditorium's Magic Source	연구자 공회당 마력원
高原士兵 巴斯凱茲	Soldier Baskez	고원병사 바스케즈
傳令兵羅傑斯	Military Courier Rochez	연락병 로체스
補給 羅達	Supply Officer Ronda	보급병 론다
帳篷中的患者	Patient in the Tent	텐트 속의 환자
魔法師護拉斯	Mage Horace	마법사 호라스
高原士兵莫提爾	Soldier Motimer	고원병사 모티머
所以，您可以把那些面具給我嗎？	So can't you give me those masks?	그래서 그런데 그 가면들을 제게 주실 수 없겠습니까?
異地居民馬克	Outsider Mark	타지 주민 마크
朝聖者伐利亞	Pilgrim Phylia	순례자 필리아
朝聖者安潔拉	Pilgrim Angela	순례자 안젤라
修道士艾丹	Monk Ethan	수도사 에단
治療中的朝聖者	Pilgrim in Treatment	치료 중인 순례자
把你所觀察的告訴布魯特斯信徒吧。	What happened with Follower Brutus?	브루투스 신도님께 관찰하신 내용을 알려주세요.
朝聖者巴德斯	Pilgrim Vados	순례자 바도스
朝聖者大衛	Pilgrim David	순례자 데이비드
朝聖者依萊伊	Pilgrim Eli	순례자 일라이
朝聖者喬治	Pilgrim George	순례자 조지
你說這就能證明你的不在場證明嗎？	Were there any evidences to prove his alibi?	자신의 행적을 증명할만한 것이 있답니까?
希望你能幫我消滅周圍的怪物。	Could you defeat nearby monsters?	주변의 몬스터라도 처치해 주셨으면 합니다.
能幫我把力量聚集到鏡子上嗎？	Could you help me recharge the mirror?	거울에 힘을 모으는 것을 도와주실 수 있을까요?
沒力氣的朝聖者	Tired Pilgrim	기운없는 순례자
這黑色水晶到底是甚麼呢？	What was that black crystal?	이 검은 수정은 정체가 뭐였을까요?
在我們開始笛隊之前，不是該先好好打聽有關教團的情報嗎？	Don't you think that you should learn more about the Order instead of simply being hostile towards it?	먼저 적대시하기보다 우선 교단에 대해 잘 알아볼 필요가 있을 것 같지 않나요?
我也不清楚現在情況怎樣了。	How would I know if something has happened to her since then?	지금쯤 어떻게 되었을지는 저도 잘 모르겠는데요?
孤零零的墓碑	Remote Tombstone	외딴 묘비
準備好了嗎？	Are you ready?	준비 되셨나요?
你可以幫我打開嗎？	Would you perhaps open it for me?	그대가 열어봐 주지 않겠는가?
王室族譜概要	Abridged Royal Lineage	간추린 왕실의 계보
佩迪米安 銀幣	Fedimian's Silver Coins	페디미안 은화
魯希德 萬托斯芬的 備忘錄	Lucid Winterspoon's Memoranda	루시드 윈터스푼 비망록
巴爾寇與金礦小鬼	Barconsi and the Gold Vein Goblin	바로콘시와 황금광맥의 도깨비
搜尋修道士	Search for the Monk	수도사 수색
搜查牆壁那邊	Searching past the Wall	벽 너머 수색
飢餓	Starved	굶주림
村莊居民奈拉	Villager Nella	마을 주민 넬라
村莊居民 詹姆斯	Villager James	마을 주민 제임스
艾高斯修道院長	Elgos Abbot	엘고스 수도원장
你來幫忙阻擋魔族了？	Are you here to help us stop the demons?	마족을 막는 데 힘을 보태러 오셨군요?
到底是裝了什麼東西，還得將它封印起來呢？	What could possibly be inside it for someone to go this far to seal it?	과연 어떤 물건이 들어 있길래 봉인까지 해둔걸까요?
吵鬧的貓頭鷹雕像	Raucous Owl Sculpture	떠들썩한 부엉이 조각상
著急的貓頭鷹雕像	Hasty Owl Sculpture	다급한 부엉이 조각상
孤獨的貓頭鷹雕像	Lonely Owl Sculpture	외로운 부엉이 조각상
修練生雷力德	Trainee Leryd	수련생 레리드
雕刻師魯托藍	Dievdirbys Ruthalen	딥디르비 루탈렌
雕刻師埃索爾	Dievdirbys Aisol	딥디르비 에솔
安靜的貓頭鷹雕像	Quiet Owl Sculpture	조용한 부엉이 조각상
繼承者 塔魯爾	Loremaster Daroul	전승자 다룰
繼承者 貝爾塔	Loremaster Berta	전승자 베르타
盡力了的貓頭鷹雕像	Exhausted Owl Sculpture	힘이 다한 부엉이 조각상
科斯塔斯	Costas	코스타스
還是願意幫助我嗎？{nl}	You're still here?	그래도 나를 돕겠다고?{nl}
真的都驅趕走了嗎？	What? You really drove them off?	뭐야 정말 다 몰아낸 거야?
布魯納爾要你去的嗎？	Brunonas told me to go?	브루노나스가 가 보라고 했다고?
血液樣本怎麼樣了呢？	How did the blood samples react?	혈액 샘플이 어떻게 되었나요?
阿依達大人是怎麼推測的呢？{nl}	What did Ida think of all this?	아이다님의 추측은 어떻게 되었는가?{nl}
居民代表 摩爾庫斯	Head Villager Morkus	주민대표 모르쿠스
士兵都消失到哪去了呢？..	Where did all the soldiers go?	병사들은 모두 어디로 사라졌을까..
士兵們間到底是發生甚麼事了呢？..	Whatever happened to the soldiers?	병사들 사이에 무슨 일이 일어났던 걸까요..
這樣把好好的人弄成這樣幹嘛呢？	What if the people get harmed?	이러다 사람까지 이렇게 만드는 게 아닐까?
痕跡..現在怎樣了呢？	What happened to the trace?	흔적은.. 어찌 되었습니까?
你說你想學習刀騎兵的戰鬥技巧嗎？	Are you interested in the combat skills of a hackapell?	하카펠의 전투 기술을 배우고 싶다고?
神射手大師	Mergen Master	메르겐 마스터
就是你要學習神射手的弓箭術嗎？	Do you wish to learn the archery of a mergen?	메르겐의 궁술을 배우고자 하는가.
你準備好要被認可為真正的雙酬傭兵了嗎？	Are you ready to be acknowledged as a true Doeppelsoeldner?	진정한 도펠죌트너로 인정 받을 준비가 되었나?
槍騎兵大師	Lancer Master	랜서 마스터
怎樣？要挑戰看看嗎？	How does that sound? Interested?	어때, 도전해보겠어?
現代大師 總攬	Encyclopedia of Masters	현대 마스터 총람
找我有核貴幹!?	What can I do for you?	무슨 일로 저를 찾아오셨나요?
可以再來幫我一下嗎?	Would you be willing to help a bit more?	한번 더 저를 도와주시겠어요?
巴以卡	Baiga	바이가
凱爾希斯的日記	Calsis' Diary	칼시스의 일기
謝爾妃	Selphie	셀피
運用槍彈者的屬性	Bullet Marker's Property Application	불릿 마커의 속성 활용
接受考驗	I'll accept the training	훈련을 받겠다고 한다
總覺得很難	It seems hard	왠지 어려울 것 같다고 한다
我沒把握	I am not confident enough	자신없다고 한다
無論什麼事我都能配合	I can do it	무엇이든 맞출 수 있다고 한다
總覺得很有壓力，我拒絕	I don't want to do it	왠지 부담스러우니 거절하자
我馬上開始	I will start right away	바로 시작하겠다고 한다
我會取得情報	I will go find the book	장부를 찾아오겠다고 한다
我下次再來	I will return next time	다음에 다시 오겠다고 한다
不退卻的勇猛[龍騎士轉職]	The Bravery That Never Backs Down [Dragoon Advancement]	물러서지 않는 용맹함[드라군 전직]
沒問題	Shouldn't be a problem	문제될 것 없다고 한다
我想避開難走的路	I wish to avoid the difficult path	어려운 길은 피하고 싶다고 한다
領導能力是基本功[聖殿騎士轉職]	Basic Leadership [Templar Advancement]	기본은 리더쉽[템플러 전직]
好像太難了	It seems too hard	너무 어려운 것 같다고 한다
可控制惡靈的力量[咒術師轉職]	The Power That Even Controls Evil Spirits [Warlock Advancement]	악령조차도 지배하는 힘[워록 전직]
我是下定決心才來的	I am ready	각오하고 왔다고 한다
好可怕，我放棄	I will quit since I am scared	두려우니 그만두겠다고 한다
詛咒中所蘊含的力量[妖術師轉職]	The Power Imbued In The Curse [Featherfoot Advancement]	저주에 깃든 힘[페더풋 전직]
最好躲開	You better back off	물러서는 게 좋을 것 같다
我要學學看	I will learn it	배워보겠다고 한다
取得射程[火槍手轉職]	Procuring Distance [Musketeer Advancement]	사거리 확보[머스킷티어 전직]
似乎不太適合我	It doesn't seem to fit for me	나와는 잘 안맞는 것 같다고 한다
疾病探測器[瘟疫醫生轉職]	Disease Detector [Plague Doctor Advancement]	질병 탐지기[플레이그닥터 전직]
我很想學	I want to learn for sure	꼭 배우고 싶다고 한다
以數字組成的世界[卡巴拉轉職]	A World Composed of Numbers [Kabbalist Advancement]	숫자로 이루어진 세상[카발리스트 전직]
我想體驗	I want to experience it	경험해보고 싶다고 한다
我拒絕複雜的任務	I decline complicated things	복잡한 건 거절한다고 한다
攻擊首重時機[擊劍手轉職]	Timing Attacks [Fencer Advancement]	공격은 타이밍[펜서 전직]
別被察覺[忍者轉職]	In Secret [Shinobi Advancement]	눈치채지 못하게[시노비 전직]
我考慮一下	I will think about it for a moment	잠시 생각 좀 해보곘다고 한다
阿勒篾森林的研究	The Research at Alemeth Forest	알레멧 숲의 연구
偷偷請求協助(1)	Request for the Secret Rescue (1)	은밀한 구조 요청(1)
偷偷請求協助(2)	Request for the Secret Rescue (2)	은밀한 구조 요청(2)
說這點事叫你自己去處理	Go alone	그 정도는 직접 가라고 한다
研究背後的真相(1)	True Nature of the Research (1)	연구의 실체(1)
先假裝幫忙	Act as if you are helping	일단 돕는 척 한다
說討厭做危險的事	I don't want to engage in a dangerous task	위험한 일은 싫다고 한다
研究背後的真相(2)	True Nature of the Research (2)	연구의 실체(2)
詢問是什麼東西	Ask what it is	어떤 것인지 묻는다
說去尋找其他方法吧	We should look for another way	다른 방법을 찾아 보자고 한다
研究背後的真相(3)	True Nature of the Research (3)	연구의 실체(3)
研究背後的真相(4)	True Nature of the Research (4)	연구의 실체(4)
妨礙研究(1)	Sabotaging the Research (1)	연구 방해공작(1)
說去確認研究日誌吧	Let's check the research paper	연구 일지를 확인해 보자고 한다
說無可疑之處	There's nothing suspicious	의심스러운 점은 없다고 한다
正在訴說有關日誌的內容	Telling him what's written on the paper	일지의 내용에 대해 말하는 중
妨礙研究(2)	Sabotaging the Research (2)	연구 방해공작(2)
說好像被發現了，趕快停止吧	Let's quit since he's going to find out about it	눈치챌 것 같으니 그만두자고 한다
妨礙研究(3)	Sabotaging the Research (3)	연구 방해공작(3)
說會帶走	I'll take it	가져가겠다고 한다
說好像被發現了，趕快停止吧	Let's quit since we may get discovered	들킬 것 같으니 그만두자고 한다
薩勒瑪的研究真相(1)	True Nature of Sarma's Research (1)	사르마의 연구 실체(1)
詢問為什麼不親自做	Why can't you do it yourself	어째서 직접 하지않느냐고 묻는다
薩勒瑪的研究真相(2)	True Nature of Sarma's Research (2)	사르마의 연구 실체(2)
說似乎無此必要	That is not needed	그럴 필요까진 없을 것 같다고 한다
正在噴灑溶液	Sprinkling the liquid	용액 뿌리는 중
居民離去前留下的紙條	Departured Villager's Memo	떠난 주민의 쪽지
正在閱讀紙條	Reading the memo	쪽지 읽는 중
居民離去前留下的罈子	Departured Villager's Pot	떠난 주민의 항아리
正在查看罈子	Looking at the pot	항아리 살펴보는 중
啟示守護者札那斯(1)	Revelation Guardian Zanas(1)	계시 수호자 자나스(1)
啟示守護者札那斯(2)	Revelation Guardian Zanas(2)	계시 수호자 자나스(2)
接受保護魔法後再過來	Say that you will go and receive the Protection Magic	보호 마법을 받고 오겠다고 한다
無法相信	Say that you do not believe him	믿을 수 없다고 한다
啟示守護者札那斯(3)	Revelation Guardian Zanas(3)	계시 수호자 자나스(3)
要去取得微弱綠色魔石	Say that you will get the Teal Magic Stone	은은한 녹색 마석을 찾아오겠다고 한다
不需要	Say that you do not need such things	그런건 필요 없다고 한다
沾染血的魔石	Bloody Magic Stone	피로 물들인 마석
誓言要收集魔族的血	Say that you will gather Demon Blood	마족의 피를 모아오겠다고 한다
無法做那種令人厭惡的行為	Say that you cannot do such things	그런 기분 나쁜 일은 못한다고 한다
對抗強敵的方法(1)	How to beat stronger foes(1)	강적을 상대하는 법(1)
要取得魔力抑制卷軸	Say that you will retrieve the Magic Control Scrolls	마력 억제 주문서를 구해오겠다고 한다
沒有那樣東西也足夠了	Say that you do not need such things	그런 거 없어도 충분하다고 한다
對抗強敵的方法(2)	How to beat stronger foes(2)	강적을 상대하는 법(2)
要注入魔力	Say that you will inscribe their magi	마력을 새겨오겠다고 한다
馬上去找曼達拉	Argue that you can go to Mandara now	바로 만다라에게 가자고 한다
對抗強敵的方法(3)	How to beat stronger foes(3)	강적을 상대하는 법(3)
消滅曼達拉後再過來	Say that you will defeat Mandara	만다라를 처치하고 오겠다고 한다
請你再稍等看看	Say that you need some more time	조금 더 기다리라고 한다
領域支配魔法	Dominance Magic	영역 지배 마법
前往器材室的秘密裝置	Go to the Subsidiary Material Storage Room's Secret Device	자재실의 비밀 장치로 간다
沒有那樣東西也很夠	Say that you do not need such things	그런 거 없어도 된다고 한다
接見所的結界	Visiting Room Barrier	접견소의 결계
問問看是不是很危險的事情	Ask if it isn't dangerous	위험한 일이 아니냐고 묻는다
我不知道你在說甚麼	Say that you don't know what he's talking about	무슨 소리인지 모르겠다고 한다
札那斯的另一個靈魂(1)	Another Soul of Zanas(1)	또 다른 자나스의 영혼(1)
這個主意不錯	Say that you think it's a good idea	좋은 생각이라고 한다
札那斯的另一個靈魂(2)	Another Soul of Zanas(2)	또 다른 자나스의 영혼(2)
真是不像話	Say that it is nonsense	역시 말도 안 된다고 한다
緊急情況預備用	Preparing for the worst	만약을 대비한
秀出微弱綠色魔石	Show the Teal Magic Stone	은은한 녹색 마석을 보여준다
追究為何讓事情複雜化	Argue that this is merely complicating things	왜 일을 복잡하게 만드냐고 따진다
保管室的燈(1)	Storage Lamp(1)	보관실의 램프(1)
先去點亮燈再過來	Say that you will light the Lamp	램프를 켜고 오겠다고 한다
看了說明書也不懂	Say that you have no idea what the instructions mean	설명서를 봐도 모르겠다고 한다
保管室的燈(2)	Storage Lamp(2)	보관실의 램프(2)
觀察藍燈中	Examining Blue Lamp	푸른 램프 살펴보는 중
點亮藍燈中	Lighting Blue Lamp	푸른 램프 켜는 중
保管室的燈(3)	Storage Lamp(3)	보관실의 램프(3)
觀察紅燈中	Examining Red Lamp	붉은 램프 살펴보는 중
點亮紅燈中	Lighting Red Lamp	붉은 램프 켜는 중
保管室的燈(4)	Storage Lamp(4)	보관실의 램프(4)
點亮最後一盞燈之後再來	Say that you will light the last Lamp	마지막 램프를 켜고 오겠다고 한다
看起來太複雜了	Say that it is too complicated	너무 복잡해 보인다고 한다
點亮黃燈中	Lighting Yellow Lamp	노란 램프 켜는 중
保管室的燈(5)	Storage Lamp(5)	보관실의 램프(5)
要取得王的紅寶石	Say that you will retrieve the King's Red Jewel	왕의 붉은 보석을 가져오겠다고 한다
先喘口氣再出發吧	Ask for a moment before continuing	잠시 숨 좀 돌리고 가자고 한다
保管室的結界(1)	Storage Room Barrier(1)	보관실의 결계(1)
沒甚麼大問題	Say that you don't think there will be much of a problem	별문제 없을 것이라고 한다
保管室的結界(2)	Storage Room Barrier(2)	보관실의 결계(2)
我是誰(1)	Who am I(1)	내가 누구게(1)
覺得這主意不錯	Say that you think it is a good idea	괜찮은 생각이라고 한다
不可能會被騙	Say that they will never fall for that	속을 리 없다고 한다
我是誰(2)	Who am I(2)	내가 누구게(2)
裝置啟動中	Activating Device	장치 가동 중
魔族的身分證	Demon identification	마족의 신분증
要去取得克萊獰怪的印章	Say that you will obtain Grinende's Seal	그라이넨더의 인장을 구해오겠다고 한다
用力推就可以了	Say that you will force them to hand it over	힘으로 밀어붙이면 된다고 한다
移動至監獄(1)	Prison Movement(1)	감옥이동(1)
給他點顏色瞧瞧	Say that you want to deal a blow to the Demons	제대로 한 방 먹여주자고 한다
魔族才不會那麼笨	Say that the Demons can't be that stupid	마족이 그렇게 멍청하지 않을 것이라고 한다
移動至監獄(2)	Prison Movement(2)	감옥이동(2)
要去長期服刑收監所	Say that you will go to the Long Sentence Prison Cell	장기 복역 수감소로 가겠다고 한다
還有東西要準備	Say that you have more to prepare	아직 준비할 것이 있다고 한다
完美的謀殺	The perfect massacre	완벽한 학살
回到玄關門那裏去了	Through the front door	현관문으로 들어왔다
克萊獰怪的印章使用中	Using Grinende' Seal	그라이넨더의 인장 사용 중
掃蕩獨房區域的殘餘勢力	Deal with the stragglers in the Solitary Cells	독방구역 잔당소탕
做點簡單的溝通吧	Say that the you are starting to deal with the stragglers	잔당소탕을 시작하자고 한다
好累喔暫時休息一下吧	State that you are tired and need to rest	지쳤으니 잠시 쉬자고 한다
6個水晶	Six Crystals	여섯 개의 수정
現在馬上出發	Say that you should leave at once	지금 바로 출발하겠다고 한다
現在先休息一下	Say that you need to rest now	지금 바로 쉬겠다고 한다
獨房區域的結界	Solitary Cell Barrier	독방구역의 결계
回去的路上(1)	The Road Back(1)	돌아가는 길(1)
與札那斯的靈魂交談中	Talking to Zanas' Spirit	자나스의 영혼과 이야기하는 중
回去的路上(2)	The Road Back(2)	돌아가는 길(2)
詢問那特別的字句是甚麼意思	Ask what the special Crest is	특별한 문장이 무엇인지 묻는다
等待直到魔族魔法解除	Say that you should wait until the Demon Magic is undone	마족의 마법이 풀릴 때까지 기다리자고 한다
被束縛的札那斯的靈魂(1)	The Restrained Spirit of Zanas(1)	구속된 자나스의 영혼(1)
被束縛的札那斯的靈魂(2)	The Restrained Spirit of Zanas(2)	구속된 자나스의 영혼(2)
束縛魔法陣解除中	Disarming the Restrainment Magic Circle	속박 마법진 해제 중
收集碎片(1)	Shard Collection(1)	조각 모음(1)
我贊成	Say that you think it is a good idea	그게 좋겠다고 한다
馬上到內比爾拉斯那裏去	Say that you think it is better to head directly to Nebulas	당장 네뷸라스에게 가자고 한다
收集碎片(2)	Shard Collection(2)	조각 모음(2)
先去強化碎片再過來	Say that you will purify the Shards	조각을 정화하고 오겠다고 한다
收集碎片(3)	Shard Collection(3)	조각 모음(3)
請使用秘密裝置的前、後、兩側的碎片。	Use the Shards on all four sides of the Device	비밀 장치의 앞, 뒤, 양옆에 각각의 조각을 사용하세요
作業場爆炸	Destruction of the Workshop	작업장 폭발
這裡有說明書	Say that there are instructions	설명서가 있다고 한다
一起很煩惱	Ponder on how to proceed together	함께 고민에 빠진다
作業場的結界(1)	Workshop Barrier(1)	작업장의 결계(1)
我都會處理別擔心喔	Say that you will deal with it all	모두 처리할 테니 걱정 말라고 한다
先給我點時間喘口氣吧	Ask for some time to recover before carrying on	잠깐 숨 좀 돌릴 시간을 달라고 한다
作業場的結界(2)	Workshop Barrier(2)	작업장의 결계(2)
預料之外的狀況(2)	Unexpected Situation(2)	예상치 못한 상황(2)
要修理監視用探測器	Say that you will attempt to repair the Observational Detector	감시용 탐색기를 고쳐보겠다고 한다
這東西已經沒用了	Say that it is already useless	이미 쓸 수 없는 물건일 것이라고 한다
維修中	Repairing	수리 중
札那斯的決心(1)	Zanas' Resolve(1)	자나스의 결심(1)
正在聊有關收監室的結界	Talking about the Cell's Barrier	수감실의 결계에 대해 이야기하는 중
詢問是不是一定要那樣做	Ask if you must do so	꼭 그래야만 하는지 묻는다
會再考慮看看	Say that you should think about it some more	조금 더 생각을 해보자고 한다
札那斯的決心(2)	Zanas' Resolve(2)	자나스의 결심(2)
會再考慮看看	Say that he should rethink his options	다시 생각해보라고 한다
元氣結晶使用中	Using Energy Crystal	원기의 결정 사용 중
現在最要緊的事情(1)	What Must Be Done (1)	지금 해야 할 일은(1)
一定要盡力完成	Say that you will not fail	반드시 해내겠다고 한다
這是不可能的	Say that it is impossible	불가능하다고 한다
現在最要緊的事情(2)	What Must Be Done (2)	지금 해야 할 일은(2)
魔法裝置啟動後，審問室生成了幻影。	Illusions have been summoned in the Interrogation Room after the Magic Device was activated	마법 장치가 가동되어 심문실에 환영이 생성되었습니다
現在最要緊的事情(3)	What Must Be Done (3)	지금 해야 할 일은(3)
開啟裝置中	Activating the Device	장치를 작동하는 중
開啟裝置中	Opening the Device	장치를 여는 중
現在最要緊的事情(4)	What Must Be Done (4)	지금 해야 할 일은(4)
請對怪物使用那個老舊的重力磁場石吧！	Use the Worn Gravity Stone on monsters	몬스터에게 낡은 그라비티 스톤을 사용하세요
現在最要緊的事情(5)	What Must Be Done (5)	지금 해야 할 일은(5)
使用老舊的重力磁場石來去除魔族的召喚水晶吧。	Use the Worn Gravity Stone to remove the Demon Summoning Crystal	낡은 그라비티 스톤을 사용해서 마족 소환수정을 제거하세요
他的名字是札那斯	His Name is Zanas	그의 이름은 자나스
微弱綠色魔石使用中	Using the Teal Magic Stone	은은한 녹색 마석 사용 중
走私的囚犯	Prisoner Contraband	죄수의 밀반입
確認牆壁上的塗鴉中	Checking Writing on the Walls	벽의 낙서 확인 중
接見所的秘密裝置	Visiting Room's Secret Device	접견소의 비밀 장치
秘密裝置觀察中	Examining the Secret Device	비밀 장치 살펴보는 중
保管室的秘密裝置	Supply Room's Secret Device	보관실의 비밀 장치
成功開啟秘密裝置了。	You have succeeded in opening the Secret Device	비밀 장치를 여는데 성공했습니다
囚犯的收押品	Confiscated Prisoner Belongings	죄수의 압수품
讀取牆壁上寫著的字句	Reading the Writing on the Walls	벽에 쓰인 글 읽는 중
閱讀信件中	Reading the Letter	편지를 읽어보는 중
作業場的秘密裝置	Workshop's Secret Device	작업장의 비밀 장치
審問室的秘密裝置	Interrogation Room's Secret Device	심문실의 비밀 장치
不會忘記	Will Not Forget	잊지 않을게
觀察邪念體中	Examining Echo	사념체를 살피는 중
傳達能量至邪念中	Passing energy to the Echo	사념에 에너지 전달 중
巴勒哈森林的解毒劑(2)	Barha Forest's Antidote(2)	바르하 숲의 해독제(2)
要取得蘑菇精的滑溜汁液	Say that you will gather Griba Juice	그리바의 미끈한 즙을 구해오겠다고 한다
剩下的請他自己想辦法	Say that he is on his own now	나머지는 알아서 하라고 한다
巴勒哈森林的解毒劑(3)	Barha Forest's Antidote(3)	바르하 숲의 해독제(3)
要製作解毒劑後再過來	Say that you will craft the Antidote	해독제를 만들어오겠다고 한다
懷疑他根本就是裝病	Ask if he isn't faking it	사실 꾀병이 아니냐고 의심한다
解毒劑製作中	Crafting the Antidote	해독제 제작 중
巴勒哈森林的解毒劑(4)	Barha Forest's Antidote(4)	바르하 숲의 해독제(4)
解毒劑使用中	Using the Antidote	해독제 사용 중
經過樹木藤蔓(1)	Pass the Tree Vines(1)	나무 덩굴을 지나서(1)
詢問中和劑製作方法	Ask how you can craft the Neutralizer	중화제를 만드는 방법을 묻는다
盲目的等待	Simply wait here	무작정 기다린다
經過樹木藤蔓(2)	Pass the Tree Vines(2)	나무 덩굴을 지나서(2)
正在尋找中和劑的催化劑	Looking for the Neutralizer reagent	중화제의 촉매 찾는 중
過度成長溶液的中和劑製作中	Crafting Overgrowth Potion Neutralizer	과성장 용액의 중화제 제작 중
經過樹木藤蔓(3)	Pass the Tree Vines(3)	나무 덩굴을 지나서(3)
要強化解毒劑	Say that you will enhance the Antidote	해독제를 강화하겠다고 한다
靠毅力繼續撐下去	Say that you can endure	근성으로 버틸 수 있다고 한다
中和劑潑灑中	Spraying Neutralizer	중화제 뿌리는 중
更強的解毒劑(1)	A Stronger Antidote(1)	더 강력한 해독제(1)
更強的解毒劑(2)	A Stronger Antidote(2)	더 강력한 해독제(2)
更強的解毒劑(3)	A Stronger Antidote(3)	더 강력한 해독제(3)
正在委託解毒劑製作	Requesting the crafting of the Antidote	해독제 제조를 부탁하는 중
拿出解毒劑與材料	Give the Antidote and ingredients	해독제와 재료를 건넨다
分開吃也沒差	Say that you think it will be fine to eat seperately	따로 먹어도 괜찮을 것 같다고 한다
莎勒瑪的白日夢	Sarma's Vain Dreams	사르마의 헛된 꿈
要趕走莎勒瑪	Say that you will follow Sarma	사르마를 쫓아가겠다고 한다
不知道到底在幹嘛要放棄了	Say that you do not wish to pursue Sarma since you do not know what he'll do	무슨 짓을 할지 모르니 그만둔다고 한다
防止擴散	Preventing the spread of poison	확산 방지
會消滅怪物別擔心	Say that you will deal with the monsters	몬스터들을 처치할테니 걱정말라고 한다
就放著吧沒關係	Say that you think it'll be okay even if they are left alone	그냥 둬도 괜찮을 것이라고 한다
不會讓這種事再發生	Never again	다시는 이런 일이 없도록
全都要破壞掉	Say that you will destroy everything	전부 파괴하겠다고 한다
好像不是喔	Say that you think that is overreacting	그건 좀 아니라고 한다
拉伊瑪女神與三重城牆	Laima and Triple-Layered Wall	라이마와 삼중성벽
問在這裡幹嘛	What are you doing here?	이런 곳에서 뭘 하고 있는지 묻는다
搜查內城壁第8區域(1)	Investigate Inner Wall District 8 (1)	내성벽 제 8구역 수사(1)
有關三重城牆	About the Triple Layered Wall	삼중성벽에 대해
搜查內城壁第8區域(2)	Investigate Inner Wall District 8 (2)	내성벽 제 8구역 수사(2)
搜查內城壁第8區域(3)	Investigate Inner Wall District 8 (3)	내성벽 제 8구역 수사(3)
搜查內城壁第8區域(4)	Investigate Inner Wall District 8 (4)	내성벽 제 8구역 수사(4)
保管箱確認中	Checking the chest	보관함 확인 중
資材保管盒破壞中	Destroying the Material Storage Chest	자재 보관함 파괴 중
搜查內城壁第8區域(5)	Investigate Inner Wall District 8 (5)	내성벽 제 8구역 수사(5)
讀取中	Reading	읽는 중
搜查內城壁第8區域(6)	Investigate Inner Wall District 8 (6)	내성벽 제 8구역 수사(6)
搜查內城壁第8區域(7)	Investigate Inner Wall District 8 (7)	내성벽 제 8구역 수사(7)
搜查內城壁第8區域(8)	Investigate Inner Wall District 8 (8)	내성벽 제 8구역 수사(8)
搜查內城壁第8區域(9)	Investigate Inner Wall District 8 (9)	내성벽 제 8구역 수사(9)
內城壁第8區域的意義	The Meaning of Inner Wall District 8	내성벽 제 8구역의 의미
拿出線索筆記，訴說有關這段時間調查的故事。	Explaining your findings	단서메모를 보여주며 조사해 온 것들에 대해 이야기하는 중
保管內城壁相關證據	Preserve the Evidence of the Inner Wall	내성벽의 증거 보존
調查內城壁第9區域(1)	Inspect Inner Wall District 9 (1)	내성벽 제 9구역 조사(1)
正在說跟奎波爾約雷一起推理的內容	Explaining Kupole Jore's deduction	큐폴 요레와 추리한 사실을 이야기하는 중
調查內城壁第9區域(2)	Inspect Inner Wall District 9 (2)	내성벽 제 9구역 조사(2)
調查內城壁第9區域(3)	Inspect Inner Wall District 9 (3)	내성벽 제 9구역 조사(3)
調查內城壁第9區域(4)	Inspect Inner Wall District 9 (4)	내성벽 제 9구역 조사(4)
調查內城壁第9區域(5)	Inspect Inner Wall District 9 (5)	내성벽 제 9구역 조사(5)
調查內城壁第9區域(6)	Inspect Inner Wall District 9 (6)	내성벽 제 9구역 조사(6)
調查內城壁第9區域(7)	Inspect Inner Wall District 9 (7)	내성벽 제 9구역 조사(7)
調查內城壁第9區域(8)	Inspect Inner Wall District 9 (8)	내성벽 제 9구역 조사(8)
火焰放射魔法石啟動中	Igniting Flamethrowing Magic Stone	화염 방사 마법석 시동 중
火焰放射魔法石重新啟動中	Re-igniting Flamethrowing Magic Stone	화염 방사 마법석 재시동 중
火焰放射魔法石運轉中	Operating Flamethrowing Magic Stone	화염 방사 마법석 작동 중
從火焰放射魔法石噴發出強烈的火焰。	The flame erupts from the Flamethrowing Magic Stone	화염 방사 마법석에서 강렬한 불길이 솟아오릅니다
調查內城壁第9區域(9)	Inspect Inner Wall District 9 (9)	내성벽 제 9구역 조사(9)
到兵營去找找線索吧！	Go to the Barrack for clues	병영으로 가서 단서를 찾아보세요
調查內城壁第9區域(10)	Inspect Inner Wall District 9 (10)	내성벽 제 9구역 조사(10)
秘密保管箱確認中	Checking the Secret Storage Chest	비밀 보관함 확인 중
對秘密保管箱使用透明魔法咒語吧。	Use the Scroll of Projection on the Secret Storage Chest	비밀 보관함에 투영의 마법 주문서를 사용하세요
秘密保管箱 開啟中	Opening the Secret Storage Chest	비밀 보관함 여는 중
掏出線索筆記本	Show the clue note	단서 노트를 보여준다
外城壁核心回收計畫(2)	Operation Outer Wall Core Retrieval (2)	외성벽 코어 회수 작전(2)
外城壁核心回收計畫(3)	Operation Outer Wall Core Retrieval (3)	외성벽 코어 회수 작전(3)
防禦壁管理機確認中	Checking the Defensive Wall Maintainer	방어벽 관리기 확인 중
外城壁核心回收計畫(4)	Operation Outer Wall Core Retrieval (4)	외성벽 코어 회수 작전(4)
外城壁核心回收計畫(5)	Operation Outer Wall Core Retrieval (5)	외성벽 코어 회수 작전(5)
紅色啟動魔石使用中	Using the Red Ignition Magic Stone	붉은 시동 마석 사용 중
外城壁核心回收計畫(6)	Operation Outer Wall Core Retrieval (6)	외성벽 코어 회수 작전(6)
第2核心保護裝置確認中	Checking the Secondary Core Protection Device	제 2차 코어 보호장치 확인 중
第2核心保護裝置解除中	Disarming the Secondary Core Protection Device	제 2차 코어 보호장치 해제 중
外城壁核心回收計畫(7)	Operation Outer Wall Core Retrieval (7)	외성벽 코어 회수 작전(7)
第3核心保護裝置確認中	Checking the Tertiary Core Protection Device	제 3차 코어 보호장치 확인 중
第3核心保護裝置解除中	Disarming the Tertiary Core Protection Device	제 3차 코어 방어장치 해제 중
外城壁核心回收計畫(8)	Operation Outter Wall Core Retrieval (8)	외성벽 코어 회수 작전(8)
外城壁核心確認中	Checking the Outer Wall Core	외성벽 코어 확인 중
外城壁核心回收中	Retrieving the Outer Wall Core	외성벽 코어 회수 중
三重城牆事件(1)	Incident on Triple-Layerd Castle Wall (1)	삼중성벽에 있던 일(1)
三重城牆事件(2)	Incident on Triple-Layerd Castle Wall (2)	삼중성벽에 있던 일(2)
談論有關外城壁核心中	Talking about the Outer Wall Core	외성벽 코어에 대해 이야기 중
補給兵最後一項任務(1)	The Supply Soldier's Last Mission (1)	보급병의 마지막 임무(1)
補給兵最後一項任務(2)	The Supply Soldier's Last Mission (2)	보급병의 마지막 임무(2)
那樣就該滿足了吧	Can't you just be content with that?	그 정도로 만족하라고 한다
城壁士兵心中的留戀(1)	Castle Wall Soldier's Unfinished Business (1)	성벽 병사의 미련(1)
城壁士兵心中的留戀(2)	Castle Wall Soldier's Unfinished Business (2)	성벽 병사의 미련(2)
城壁士兵心中的留戀(3)	Castle Wall Soldier's Unfinished Business (3)	성벽 병사의 미련(3)
放下遺物中	Laying the keepsakes down	유품 내려놓는 중
正在將晶球放於祭壇	Putting the orb on the altar	제단에 구슬 놓는 중
受歡迎的人(1)	Welcomed One (1)	환영받는 자(1)
受歡迎的人(2)	Welcomed One (2)	환영받는 자(2)
詢問是否能接受	Can I take some food?	받아도 되는지 물어본다
受歡迎的人(3)	Welcomed One (3)	환영받는 자(3)
戰鬥準備(1)	Preparing for Battle (1)	전투 준비(1)
戰鬥準備(2)	Preparing for Battle (2)	전투 준비(2)
戰鬥準備(3)	Preparing for Battle (3)	전투 준비(3)
戰鬥準備(4)	Preparing for Battle (4)	전투 준비(4)
我會等到作業完成	I'll wait until the job is finished	작업을 마칠 때까지 기다리겠다고 한다
戰鬥準備(5)	Preparing for Battle (5)	전투 준비(5)
一起去設置吧	Let's set it up together	같이 설치하러 가자고 한다
決戰	The Battle	결전
作足對戰魔族的準備	I'm ready to fight the demons	마족을 상대할 준비를 한다
還沒準備好	I'm not ready yet	아직 준비가 안됐다고 한다
聯絡	Contact	연락
殘存的魔族勢力	Remaining Demon Forces	잔존하는 마족 세력
要消滅談魔族殘黨	I'll defeat the demon remnants	마족 잔당을 차치하겠다고 한다
可以信任的人	Trustworthy	신뢰 할 수 있는 자
作業失誤(1)	Setbacks (1)	업무 차질(1)
作業失誤(3)	Setbacks (3)	업무 차질(3)
作業失誤(4)	Setbacks (4)	업무 차질(4)
法師突爾利斯的礦石調查(1)	Wizard Tulis' Ore Research (1)	위저드 튤리스의 광석 조사(1)
問問看在做什麼	What are you doing?	무슨 일을 하고 있는지 물어본다
法師突爾利斯的礦石調查(2)	Wizard Tulis' Ore Research (2)	위저드 튤리스의 광석 조사(2)
問問該幫什麼忙	I'll help you out	무슨 일을 도와줘야 하는지 묻는다
法師突爾利斯的礦石調查(3)	Wizard Tulis' Ore Research (3)	위저드 튤리스의 광석 조사(3)
問問是否有方法	Is there a way?	방법은 있는지 묻는다
淨化劑	Purification Agent	정화제
從雕像中流出的奇怪氣息	Strange Energy Emanating from the Statue	조각상에서 나오는 수상한 기운
村莊的詛咒(1)	Village Curse (1)	마을에 걸린 저주(1)
村莊的詛咒(2)	Village Curse (2)	마을에 걸린 저주(2)
村莊的詛咒(3)	Village Curse (3)	마을에 걸린 저주(3)
村莊的詛咒(4)	Village Curse (4)	마을에 걸린 저주(4)
村莊的詛咒(5)	Village Curse (5)	마을에 걸린 저주(5)
村莊的詛咒(6)	Village Curse (6)	마을에 걸린 저주(6)
村莊的詛咒(7)	Village Curse (7)	마을에 걸린 저주(7)
村莊的詛咒(8)	Village Curse (8)	마을에 걸린 저주(8)
疫病治療劑	Medicine	역병 치료제
村莊居民的不安	Anxiety in the Village	마을 주민의 불안함
被詛咒的雕像們(1)	Cursed Statues (1)	저주 받은 조각상들(1)
被詛咒的雕像們(2)	Cursed Statues (2)	저주 받은 조각상들(2)
被詛咒的雕像們(3)	Cursed Statues (3)	저주 받은 조각상들(3)
被詛咒的雕像們(4)	Cursed Statues (4)	저주 받은 조각상들(4)
被詛咒的雕像們(5)	Cursed Statues (5)	저주 받은 조각상들(5)
卡杜梅爾絕壁的祭壇(1)	The Altars of Kadumel Cliff (1)	카듀멜 절벽의 제단들(1)
卡杜梅爾絕壁的祭壇(2)	The Altars of Kadumel Cliff (2)	카듀멜 절벽의 제단들(2)
後退(1)	Retreat (1)	후퇴(1)
後退(2)	Retreat (2)	후퇴(2)
後退(3)	Retreat (3)	후퇴(3)
後退(4)	Retreat (4)	후퇴(4)
後退(5)	Retreat (5)	후퇴(5)
後退(6)	Retreat (6)	후퇴(6)
破壞魔族的裝置(1)	Destroy the Demons' Device (1)	마족의 장치 파괴(1)
破壞魔族的裝置(2)	Destroy the Demons' Device (2)	마족의 장치 파괴(2)
回到過去(1)	Back in time(1)	시간을 거슬러(1)
回到過去(2)	Back in time(2)	시간을 거슬러(2)
回到過去(3)	Back in time(3)	시간을 거슬러(3)
回到過去(4)	Back in time(4)	시간을 거슬러(4)
回到過去(5)	Back in time(5)	시간을 거슬러(5)
回到過去(6)	Back in time(6)	시간을 거슬러(6)
回到過去(7)	Back in time(7)	시간을 거슬러(7)
萬花筒製作中	Controlling the Kaleidoscope of Time	만화경 조작 중
快速移動(1)	Swift Movement(1)	빠른 이동(1)
收集	Collect	수집한다
不需要	It is useless	필요 없다
魔力供應中	Providing Magic	마력을 공급하는 중
迪比利斯制馭所的魔力源已啟動	The Devries Controller Spell Source has been activated	디브리스 제어소 마력원이 활성화 되었습니다
快速移動(2)	Swift Movement(2)	빠른 이동(2)
中斷	Stop	중단한다
中央研究室 魔力源已成功啟動	The Central Laboratory's Magic Source has been activated	중앙연구실 마력원이 활성화 되었습니다
快速移動(3)	Swift Movement(3)	빠른 이동(3)
已經啟動研究者聚會所的魔力源了。	The Researcher Auditorium's Magic Source has been activated	연구자 공회당 마력원이 활성화 되었습니다
收集莎爾比亞斯森林的魔力	Collect the Magic in Salvia Forest	살비야스 숲의 마력 수집
千里眼	Eyes That See Far	멀리 보는 눈
收集鐘乳洞的魔力	Collect Cave Magic	종유동의 마력 수집
老舊的工具	Old Tool	오래된 도구
某人的善意	Someone's Good Will	누군가의 선의
史巴賓嘉斯森林的不幸	Svalphinghas Forest in Trouble	스팔빈가스 숲의 불행
濃縮魔力的角	Magic Horn	마력이 농축된 뿔
這次一定要	This Time For Sure	이번에야 말로
地下生態界	Underground Ecosystem	지하 생태계
預知眼	Seeing For The First Time	먼저 보는 눈
代為觀測	Surrogate Observer	대리 관측
在皮斯堤斯森林	At Pystis Forest	피스티스 숲에서
箱子的秘密	Secret of the Chest	상자의 비밀
追憶同伴	Honoring Allies	동료들을 기리며
沒根據的處方簽	A wild prescription	근거없는 처방
要收集提尼的發光的角	Say that you will gather the Shining Horns from the Tinis	티니의 빛나는 뿔을 모아주겠다고 한다
有急事所以拒絕	Say that you have something better to do	급한 일이 있다며 거절한다
小心別受傷	Beware of small wounds	작은 상처에도 주의
詢問該怎麼幫忙	Ask how you can help	어떻게 도우면 될지 묻는다
先確保安全最重要	Say that you think remaining calm would be better	일단 안정을 취하는 게 좋겠다고 한다
老弱者優先(1)	Being Considerate to Elders(1)	노약자 배려(1)
路上事情還很多只能拒絕	Decline since you are busy and go on your way	갈 길이 바쁘니 거절한다
老弱者優先(2)	Being Considerate to Elders(2)	노약자 배려(2)
再找找其他適合的方法	Say that you will find something suitable	적절한 것을 찾아보겠다고 한다
我沒時間能幫忙你	Say that you do not have enough time to help	거기까지 도와줄 시간은 없다고 한다
老弱者優先(3)	Being Considerate to Elders(3)	노약자 배려(3)
爽快答應	Happily agree	흔쾌히 수락한다
有急事先走啦	Say that you have more important things to do	급하니 먼저 가보겠다고 한다
準備營養食品	Prepare a solid meal	영양식 준비하기
詢問要找甚麼肉製品過來呢	Ask what type of meat you should gather	어떤 고기를 구해오면 좋을지 묻는다
這裡沒辦法烤肉只好拒絕	Say that there is no way to get meat here	여기서 고기를 구할 방법은 없다며 거절한다
有乾淨飲用水的地方	Where there is clean water	깨끗한 물이 있는 곳
好像很累人所以拒絕	Decline since it is hard work	힘든 일 같으니 거절한다고 말한다
先取暖吧好冷喔	Find a way to stay warm first	추위부터 해결하자
詢問木材在哪	Ask where the tree is	나무가 어디 있는지 묻는다
去附近找找看有沒有樹枝來生火	Light a fire with some twigs and branches	근처 잔가지라도 모아 불을 피우라고 한다
離開的人和留下的人	Those that leave and those that stay	떠나는 자와 남는 자
回去路上的安全	The safety of the way back	돌아가는 길의 안전
得先走囉	Say that you think you have to go	이만 가봐야 할 것 같다고 한다
藏有許多悲痛的記憶	Cold and pain	아픔과 함께 온 추위
會去取得皮革過來	Say that you will get the hides	가죽을 구해다 주겠다고 한다
沒辦法幫你	Say that there is no way to help	도울 방법이 없다고 한다
痛我可以忍但是肌餓就無法	Nothing worse than hunger	아픈 건 참아도 배고픈 건
幫我找點吃的好嗎	Say that you'll find something for him to eat	무언가 먹을 것을 구해주겠다고 한다
身上甚麼都沒有	Say that you don't have anything	가진 것이 아무것도 없다고 한다
身體很痛但事先去安全的地方吧	Pain can wait	아프더라도 안전한 곳에서
回答說知道了	Say that you understand	알았다고 대답한다
自己也很怕怪物所以拒絕了	Say that you are afraid of monsters as well	자신도 몬스터가 두렵다며 거절한다
新手運啦！	It is the blessing of the Divine Tree	신수의 은총입니다
剛好見到了生病的朝聖者	Say that you have seem plagued Pilgrims	마침 병에 걸린 순례자들을 봤다고 한다
有其他事情	Say that you have better things to do	다른 일이 있다고 한다
公布藥的真正內容物	Reveal the medicine's identity	약의 정체 밝히기
從旁觀察看不出有甚麼問題	Say that there doesn't seem to be anything wrong	옆에서 보기엔 아무런 문제가 없어보였다고 한다
越來越可疑	Mounting Suspicions	쌓여가는 의심
露出馬腳(1)	Showing True Colors(1)	마각이 드러나다(1)
當然會那樣做	Say that you will do that	물론 그러겠다고 한다
不想干涉教團內部的事情	Say that you do not wish to interfere with the Order's business	교단 내부의 일에 간섭하고 싶지 않다고 한다
露出馬腳(2)	Showing True Colors(2)	마각이 드러나다(2)
向上層警告	Warning to the Upper Echelon	상층부에 경고를
會充分收集	Say that you will gather enough	넉넉히 모아다 주겠다고 한다
似乎很簡單自己解決吧	Say that they should do it since it is a simple task	간단한 듯 하니 직접 하라고 한다
時間還是不夠	There is still not enough time	아직 시간이 부족해
會自己來解決	Say that you will solve the problem	자신이 대신 해결해주겠다고 한다
很不好意思得先離開了	Say that you do not have time for this	미안하지만 가봐야한다고 한다
憂鬱的殺人犯	Falsely Accused Murderer	억울한 살인범
別退縮快去詢問事情的來龍去脈	Ask about what is happening	물러서지 말고 자초지종을 묻는다
盡量避開這些令人頭痛的事情	Back off and stay out of trouble	골치아픈 일에 엮이지 않도록 물러선다
化解疑心	Lifting Suspicions	의심 풀어주기
是無辜的話就會將事實全盤抖出	Say that you will prove his innocence	그가 결백하다면 진실을 밝히겠다고 한다
會尊重朝聖者們的判斷	Say that you respect the judgement of the Pilgrims	순례자들의 판단을 존중하겠다고 한다
梅伊班修道院的聖珠	Maven Abbey Rosary	메이번 수도원의 묵주
應該有甚麼物品可以證明的	Say that there must be something to prove	뭔가 증명할 것이 있을 것이라고 한다
怎麼想都想不通那樣的東西到底是否存在	Say that you don't know if there is anything that can help	그런게 있을지 자신은 짐작도 안간다고 한다
那不是我的	Not mine	제 것이 아닙니다
用持有物來證明	Prove by using his belongings	소지품으로 증명하기
詢問方法	Ask how you can do so	그 방법을 묻는다
這方法好像太複雜了不需要	Decline since you think it will be complicated	복잡한 방법일 것 같으니 피한다
聖水的確認方法	Checking with Divine Water	성수의 확인 방법
要馬上測試看看	Say that you will test it at once	바로 시험해 보겠다고 한다
詢問能不能先潑灑看看	Ask whether you can't simply spray it first	일단 뿌려보면 안되겠냐고 묻는다
犯人就是魔族嗎？	Are the demons the real culprits?	범인은 마족인가?
那時他的所作所為	What he did then	그때 그가 한 일
垃圾都還有用多了	Even trash has it's uses	쓰레기도 쓸모가 있다
他要自己去找	Say that you will retrieve them	자신이 그것들을 찾아오겠다고 한다
看到骯髒的東西就想吐	Say that you hate dirty things	지저분한 것은 질색이라고 한다
解開誤會	Resolving conflicts	오해가 풀리다
引誘犯人	Luring the culprit	범인 유도하기
沒那種實力	Say that you are not up to the task	그 정도 실력은 되지 않는다고 한다
出現的真正的犯人	The true culprit	나타난 진범
朝聖中斷	Stopping the Pilgrimage	순례 중단
開鑿回去的路	Opening the road back	돌아갈 길 뚫기
請告知那是甚麼	Ask them what it is about	무엇인지 말해 달라고 한다
太艱困的路程必須拒絕	Say that you dislike hard work	힘든 일은 사절한다고 말한다
準備旅行用物資	Gathering goods for the journey	여행 물자 비축
雷普斯兔子的話不算甚麼	Say that Lepusbunnies are nothing to fear	레푸스버니 정도는 별 것 아니라고 한다
害怕那些不簡單的傢伙們	Say that you don't want to help since they are tough	만만치 않은 녀석들이라며 꺼린다
魔族就該從世上消失	Demons must disappear	마족은 사라져야 합니다
要好好消滅魔族	Say that you will deal with the Demons	마족들을 처리하겠다고 한다
最後的希望	The Last Hope	마지막 희망
我就是啟示者	Say that you are a Revelator	자신이 바로 계시자임을 밝힌다
為了找回昔日的修道院	Retaking the Abbey	수도원을 되찾기 위해
借用老舊的道具	Borrowing Old Equipment	오래된 도구 빌리기
詢問是不是感覺有問題	Ask if she isn't mistaken	잘못 느낀게 아닌지 되묻는다
道具使用事前準備	Preparation for using the equipment	도구를 사용하기 위한 준비
詢問補充力氣的方法	Ask if there is a way to charge the power	힘을 충전할 방법을 묻는다
就幫你到這裡了	Say that this is as far as you will help	자신의 도움은 여기까지라고 한다
前往朝聖者營地	To the Pilgrim Camp	순례자 캠프로
來建立更具體的計畫吧	Say that you should have more detailed plans	보다 구체적인 계획을 세워놓자고 한다
黑色水晶的真面目	The Black Crystal's identity	검은 수정의 정체
稍微等一下	Tell her to wait here a while	잠시 기다리고 있으라고 한다
直接去跟他搭話吧	Say that she should do the talking herself	얘기 정도는 직접 걸어보라고 한다
毀謗傳道	Interferance	전도 훼방놓기
詢問是否需要甚麼方法	Ask if there is another way	뭔가 방법이 필요한지 묻는다
教團所建立的物品總覺得好像有點粗糙	Say that you do not wish to do so because it is from the Order	교단이 세운 물건이라 왠지 껄끄럽다고 한다
無法原諒魔族	Demons cannot be forgiven	마족은 용서할 수 없다
抑制神聖力的主體	What Suppresses the Divine Power	신성력을 억누르는 주체
詢問該去哪裡	Ask where you need to go	어디로 가면 되는지 묻는다
拒絕不重要的事	Decline the small tasks	자질구레한 일은 거절한다
解放神聖力	Releasing the Divine Power	신성력 해방시키기
詢問破壞裝置的方法	Ask if there is a way to destroy the Device	장치를 파괴할 방법을 묻는다
看起來不像碎掉的樣子	Say that it does not look destructable	부서질 것처럼 보이지 않았다고 한다
走錯路了	Those that take the wrong path	잘못된 길로 들어선 자
不確定是不是真的在那裏	Say that it is suspicious if it will be there	확실히 그곳에 있을지 미심쩍다고 한다
果然是受了修道士史黛拉的委託沒錯	Say that you are also helping Monk Stella	자신 역시 수도사 스텔라의 부탁을 받았다고 한다
教團的秘密設計	The Order's Scheme	교단의 꿍꿍이
沒辦法只好一起去了	Say that it cannot be helped	어쩔 수 없으니 같이 가자고 한다
無法相信這些教團的人所以拒絕了	Decline stating that you cannot trust those from the Order	교단 사람은 믿을 수 없다며 거절한다
第二次破壞裝置	Destroy the Second Device	두 번째 장치 파괴하기
使喚馬達斯就好了	Tell them to call Mattas to help	마타스를 불러 시키라고 한다
準備可能發生的危險	To prepare for the unknown	혹시 모를 위험에 대비해서
覺得可疑不過還是先幫忙	Help despite having a nagging feeling	뭔가 이상하지만 일단 돕는다
有不詳的預感所以拒絕	Say that you have a bad feeling about this and decline	안좋은 예감이 든다며 거절한다
這不詳的預感不會錯的	Bad Feelings Are Never Wrong	안좋은 예감은 빗나가지 않는다
教團幹部護送計畫	Escorting a high officer of the Order	교단 간부 호송작전
要先將監視對象帶走	Say that you will go to a person that can watch over the high officer	우선 감시할 사람에게 데려가겠다고 한다
無法相信你所說的化	Say that you cannot beleive what they are saying	당신의 말을 믿을 수 없다고 한다
救出被抓走的史黛拉	Rescuing The Captured Stella	붙잡힌 스텔라 구하기
因為事人質目前為止都是安全的	Say that it won't be a problem because she's a hostage	인질이니 별 일은 없을 거라고 한다
監禁囚犯	Restraining the Criminal	죄인 구금
去尋找碎片再過來	Say that you will retrieve the Fragments	파편들을 찾아 오겠다고 한다
碎片應該剩不多了	Say that you do not think the Fragments will be in usable shape	파편들이 제대로 남았을 것 같지 않다고 한다
亡者的遺志	The Wishes of the Deceased	죽은 자의 유지
發事要消滅這裡的魔族	Swear that you will deal with the Demons in the surrounding area	이 근방의 마족을 처치할 것을 맹세한다
只是累了	Keep on going	그냥 지나친다
整理家門口	Clearing up	집 앞 정리
拜託趕快跟上來吧	Ask them to follow you as soon as possible	바로 뒤따라와 주길 부탁한다
說要一起去卻又不動	Argue that you should move together and don't move	같이 가자며 움직이지 않는다
敵方也在準備了	The enemy is also preparing	적도 대비하고 있다
先親眼確認	See for yourself	우선 눈으로 확인하기
當然會那樣說	Say that you will do that	물론 그렇게 한다고 말한다
不想再進去	Say that you do not wish to go any further	더 이상 깊이 들어가기 싫다고 한다
知識的寶庫	Treasure Trove of Knowledge	지식의 보고
趕快進去書庫	Say that you will hurry to the library	서둘러 서고로 가자고 한다
沒辦法一個人找書嗎	Ask if she can't look for the book on her own	책 찾는 일은 혼자 할 수 없겠냐고 한다
閱讀時間	Reading Time	책 읽을 시간
麻煩趕快找	Ask that she hurry	어서 찾아볼 것을 부탁한다
詢問能否躲在別地方閱讀	Ask if she can't hide somewhere while she reads	다른 곳에 숨어서 읽으면 안될지 묻는다
各自的角色	To each his own	각자의 역할
並不困難	Say that it isn't too difficult	어렵지 않다고 한다
要不要一起去呢	Say that going together really seems like the better idea	역시 같이 가는 것이 어떻겠냐고 한다
收集神聖力	Gathering Divine Power	신성력 모으기
怪物就交給我吧	Say that you'll handle the monsters	몬스터는 자신에게 맡기라고 한다
神聖力能把怪物給驅趕走嗎	Ask if the Divine Power won't defeat the monsters	신성력이 몬스터를 물리지 않겠냐고 한다
壓制最後的幹部	Taking Down The Last Executive	마지막 간부 제압
去做個了結	Say that you it's time to finish this	마무리를 지으러 가자고 한다
慢慢復原	Slow Recovery	회복은 천천히
取得沒有腐爛掉的東西	Say that you'll try to find things that aren't spoiled	상하지 않은 것으로 찾아보겠다고 한다
對於有沒有能吃的食物感到懷疑	Say that you are doubtful if there will be anything worthy of consumption	먹을만한게 남아있을지 의문을 표한다
預防這種情況發生	For Times Like These	이럴 때를 대비해서
會趕快帶來	Say that you will hurry and bring the needed goods	서둘러 가져 오겠다고 한다
先觀察看看再行動	Say that you think you should monitor the situation a while	일단 상태를 지켜보자고 한다
敵方還有殘存勢力	The Enemies That Remain	아직 적들이 남아있다
會趕快做個了斷	Say that you'll finish the job	깔끔하게 마무리 짓겠다고 한다
不瞭解自己的靈魂	The Amnesiac Soul	자신을 모르는 영혼
自我覺醒	Find Out Yourself	스스로를 자각하기
從束縛中解脫	Unchained	속박에서 풀려나다
設置慰靈碑	Set up a memorial monument	위령비 세워주기
正在訴說有關夏亞汀的事情	Passing the words of Hayatin	하야틴의 이야기를 전하는 중
詢問該做些甚麼	What needs to be done?	무엇을 해결해야 되는지 묻는다
戰死者的靈魂	The Souls of the Fallens	전사자들의 영혼
公開遺物內容	Dig up the relics	유물 파헤치기
詢問在蕨葉堆尋找的方法	How do I check the bracken pile?	고사리 더미 속을 확인할 방법을 묻는다
有關你發生的事情	About what happpened	당시의 사연에 대해
鑰匙的蹤跡	The Whereabouts of the Key	열쇠의 행방
清白的證明(1)	Proof of Innocence (1)	결백의 증거(1)
詢問鎖定正確位置的方法	How can I know the exact location?	정확한 위치를 알 방법을 묻는다
清白的證明(2)	Proof of Innocence (2)	결백의 증거(2)
交出文件說明中	Explaining the document	문서를 보여주며 이야기 하는 중
為了恢復英雄的名聲	To Restore the Honor of the Hero	영웅의 명예 회복을 위해
劍士的安息	The Rest for Warriors	전사들의 안식
被破壞的平衡	Broken Balance	무너진 균형
問問該幫忙些甚麼	What can I do to help?	무엇을 도와주면 좋을지 묻는다
生態調查	Examine the ecosystem	생태 조사
揠苗助長	Stomp on the Sprouts	싹부터 밟기
詢問該幫忙哪些事情	How can I help you?	어떤 일을 도우면 되는지 묻는다
把摩格蘭強化怎麼樣	How about we enhance the moglan?	모글란을 강화시키면 어떨지 제안한다
能幫你甚麼	What can I do for you?	도와 줄 일이 무엇인지 묻는다
敵方互相利用的方法	An Enemy of Your Enemy Is Your Friend	적의 적을 이용하는 방법
所有事物的淵源	The Cause of All This	모든 것의 원인
詢問最後的方法	What is the final thing to do?	마지막 방법을 묻는다
效果驚人(1)	Effect Too Strong (1)	효과가 지나쳤다(1)
效果驚人(2)	Effect Too Strong (2)	효과가 지나쳤다(2)
食物鏈般的關係	Dog Eat Dog	먹고 먹히는 관계
使用有效手段	Use the Sure Method	확실한 수단 사용
長遠的對策	A Long-Term Plan	보다 장기적인 대책
總算度過危機了	Close Shave	우선 위기는 넘겼다
遠古的遺產	The Relics of the Ancient	먼 옛날의 유산들
詢問該幫忙哪些事情	What needs to be done?	어떤 것을 도와주면 되는지 묻는다
有關她的任務	About her mission	그녀의 임무에 대해
被奪走的羊皮紙	Stolen Parchment	빼앗긴 양피지
策劃騙術	Prepare to Trick	속임수를 위한 준비
詢問收集樹根汁液的方法	How do I extract the juice from tree root?	나무뿌리 즙을 수집할 방법을 묻는다
為了安全進行調查	To Make the Investigation Safe	안전한 조사활동을 위해
羊皮紙愛好者	Parchment Enthusiast	양피지 애호가
正在告訴大家消滅廢都石化蜥蜴的事情	Telling the story of how Fallen City Vasilisk has fallen	폐도 바실리스크를 처치한 이야기를 하는 중
不要玷汙遺物	Do Not Sully The Keepsakes	유품은 더럽히지 말라
最後任務的痕跡	The trace of the final mission	마지막 임무의 흔적
詢問取得的方法	How do I find them?	찾아낼 방법을 묻는다
表示感謝	Token of Gratitude	감사의 표시
越堅固越好	Durability Is Vital	튼튼할 수록 좋다
詢問該怎麼幫忙呢	How can I help you?	어떻게 도와주면 좋을지 묻는다
揭開黑暗的一道光芒	The Light through Darkness	어둠을 밝혀줄 빛
調查中整理周邊環境	Clean up while investigating	조사 중 주변 정리
符合期待的結果	Expected Result	기대한 만큼의 성과
暗影適應訓練	Shadow Adaptation Training	그림자 적응 훈련
表示要自己進行訓練。	I will train myself	스스로 훈련하겠다고 한다.
確保治安	Secure the safety	치안 확보
佳言 (2)	Great Words (2)	좋은 말씀 (2)
偏離的信仰(1)	Wrong Faith (1)	어긋난 신앙 (1)
說無法相信	I can't believe it	못 믿겠다고 한다
偏離的信仰(2)	Wrong Faith (2)	어긋난 신앙 (2)
詢問是否真的沒關係	Is it really okay?	정말 그래도 괜찮은건지 묻는다
偏離的信仰(3)	Wrong Faith (3)	어긋난 신앙 (3)
說會先去幫忙取得	I will save you first	일단 구해다주겠다고 한다
魔族鮮紅的血	The red blood of the demons	마족의 붉은 피
卑劣的伎倆 (1)	Dirty Tricks (1)	비열한 술수 (1)
卑劣的伎倆 (2)	Dirty Tricks (2)	비열한 술수 (2)
卑劣的伎倆 (3)	Dirty Tricks (3)	비열한 술수 (3)
假經典	False Scriptures	거짓된 경전
搜索生存者	Search for the survivors	생존자 수색
飢渴的信仰 (1)	Hungry Faith (1)	굶주린 신앙 (1)
說自己不屬於真理之樹教團	I'm not a member of the Order of the Tree of Truth	자신은 진리의 나무 교단이 아니라고 한다
先不管它	Leave it for now	일단 내버려 둔다
正在尋找糧食	Looking for the edible food	먹을 만한 식량을 찾는 중
正在遞糧食	Passing the food	식량을 건네 주는 중
飢渴的信仰 (2)	Hungry Faith (2)	굶주린 신앙 (2)
詢問發生了什麼事	Ask what happened	무슨 일이 있었던 거냐고 묻는다
說別再去了	I will go now	이제 그만 가보겠다고 한다
魔族的墮落靈魂(1)	The Corrupted Spirit of the Demons (1)	마족의 타락한 영혼 (1)
說會試著讓他吸收	I will try absorbing it	흡수시켜보겠다고 한다
魔族的墮落靈魂(2)	The Corrupted Spirit of the Demons (2)	마족의 타락한 영혼 (2)
魔族的墮落靈魂(3)	The Corrupted Spirit of the Demons (3)	마족의 타락한 영혼 (3)
說現在還沒準備好	I am not completely ready yet	아직 준비가 덜 됐다고 한다
為了全然的自由 (1)	For Total Freedom (1)	완전한 자유를 위해 (1)
要你再等一會	Please wait little more	조금만 기다려 달라고 한다
修道院的影子	The shadow of the monastery	수도원의 그림자
已除掉艾高斯修道院總院的魔族	You've defeated the demons at the Elgos Monastery	엘고스 수도원 본원의 마족들을 처치했습니다
預備未來的力量	The power that was prepared for the future	미래를 대비한 힘
邪惡的魔法陣? (1)	Evil Magic Circles? (1)	사악한 마법진? (1)
邪惡的魔法陣? (2)	Evil Magic Circles? (2)	사악한 마법진? (2)
邪惡的魔法陣? (3)	Evil Magic Circles? (3)	사악한 마법진? (3)
邪惡的魔法陣? (4)	Evil Magic Circles? (4)	사악한 마법진? (4)
大地魔法陣	Earth Magic Circle	대지의 마법진
大地氣息	Earth Energy	대지의 기운
據實以告中	Talking about what happened	사실대로 말하는 중
調和氣息	Balancing Energy	조화의 기운
海洋氣息	Sea Energy	바다의 기운
海洋魔法陣	Sea Magic Circle	바다의 마법진
調和魔法陣 (1)	Balancing Magic Circle (1)	조화의 마법진 (1)
調和魔法陣 (2)	Balancing Magic Circle (2)	조화의 마법진 (2)
再一點大地氣息	More Earth Energy	대지의 기운을 더
為了保護的束縛 (1)	Restrain to Protect (1)	보호를 위한 속박 (1)
為了保護的束縛 (2)	Restrain to Protect (2)	보호를 위한 속박 (2)
莎勒斯修女院的消息	Have You Heard of the Saalus Convent?	살러스 수녀원의 소식
虛弱無力的難民	Lethargic Refugees	무기력한 난민들
說會聽到的	I'm listening	듣겠다고 한다
打掃開採區 	Cleaning the Pit	채취장 청소
開採區發生什麼事了？	What happened at the Pit?	채취장에는 무슨 일이?
要你稍等一下	Please wait a bit	잠깐 기다려 달라고 한다
循著味道而去	Smelly Pursuit	냄새를 쫓아서
可疑的開採區	Suspicious Pit	수상한 채취장
說要去將其消滅	I will find it and eliminate it	찾아서 없애겠다고 한다
潛伏搜查	Undercover Operation	잠복 수사
收尾	Settlement	뒷수습
說會把剩下的袋子也一併除掉	Tell him that you will get rid of the rest of the pockets	나머지 주머니도 없애주겠다고 한다
說不會有那樣的問題的	That won't be a problem	그 정돈 문제 없을 거라고 한다
引誘至深處	Lure it deeper	깊은 곳으로 유인하기
正在挖掘袋子	Burying the pocket	주머니 묻는 중
新商品	New Product	신상품
說會為了居民盡全力幫忙	I will definitely help for the villagers	주민들을 위해서라면 기꺼이 돕겠다고 한다
救急良方	Emergency Treatment	응급처방
說自己很累	It's hard	힘들다고 한다
遇難船的殘骸	The Remains of the Wrecked Ship	난파선의 잔해
老雕刻師的委託	Favor for an Old Dievdirbys	늙은 딥디르비의 부탁
貓頭鷹雕像發生了什麼事?	What Happened to the Owl Sculptures?	부엉이 조각상에 무슨 일이?
尊敬老人	Respect Your Elders	노인공경
雕刻的狀態(1)	Checking the Statues (1)	조각의 상태(1)
雕刻的狀態(2)	Checking the Statues (2)	조각의 상태(2)
都是因為腰	Injured Back	허리 때문에
其他地方也稍微看看	Need to Look in Other Places	다른 곳도 살펴봐야
犯人是誰？	Who Did It?	범인은 누구?
能睡得香甜(1)	Sweet Dreams (1)	곤히 잘 수 있도록(1)
能睡得香甜(2)	Sweet Dreams (2)	곤히 잘 수 있도록(2)
誰背走都不知道	Fast Asleep	누가 업어가도 몰라
訓練場的貓頭鷹(1)	Training Camp Owl (1)	수련장의 부엉이(1)
訓練場的貓頭鷹(2)	Training Camp Owl (2)	수련장의 부엉이(2)
訓練場的貓頭鷹(3)	Training Camp Owl (3)	수련장의 부엉이(3)
是昏倒了還是睡著了(1)	Fainted or Asleep? (1)	쓰러진건지 잠든건지(1)
是昏倒了還是睡著了(2)	Fainted or Asleep? (2)	쓰러진건지 잠든건지(2)
為了怪物碎片	For the Monster Statue	몬스터 조각을 위해
開玩笑的利迪梅得(1)	Troublemaker Ridimeds (1)	장난치는 리디메드(1)
開玩笑的利迪梅得(2)	Troublemaker Ridimeds (2)	장난치는 리디메드(2)
貴重的雕刻刀	Precious Carving Knife	소중한 조각칼
為了安全(1)	For Safety (1)	안전을 위해서(1)
為了安全(2)	For Safety (2)	안전을 위해서(2)
察看貓頭鷹(2)	Observing the Owl (2)	부엉이 살펴보기(2)
充滿邪惡的氣息	Full of Evil Energy	사악한 기운으로 가득 찬
危險的短劍	Dangerous Dagger	위험한 단검
抑制的雕像	Suppressing Sculpture	억제의 조각
淨化的儀式(1)	Purification Ceremony (1)	정화의 의식(1)
淨化的儀式(2)	Purification Ceremony (2)	정화의 의식(2)
尋找最後一個證人(1)	Finding the Last Witness (1)	마지막 증인 찾기(1)
尋找最後一個證人(2)	Finding the Last Witness (2)	마지막 증인 찾기(2)
問問是什麼方法	What do you have in mind?	어떤 방법인지 물어본다
尋找最後一個證人(3)	Finding the Last Witness (3)	마지막 증인 찾기(3)
雪上加霜	It Only Gets Worse	설상가상
徬徨的靈魂們(1)	Wandering Spirits (1)	방황하는 영혼들(1)
徬徨的靈魂們(2)	Wandering Spirits (2)	방황하는 영혼들(2)
尤拉泰女神的繼承者(2)	Loremasters of the Goddess (2)	유라테 여신의 전승자(2)
沒有確鑿的證據	There Is No Concrete Evidence	확증은 없다
詢問神聖力與怪物的核的關係	What is the link between the divine energy and monster core?	신성력과 몬스터핵의 관계에 대해 묻는다
祭壇的力量	The Power of Altar	제단의 힘
詢問遺物跟神聖力有甚麼關係	What's the relationship between the keepsake and the divine energy?	유품과 신성력이 무슨 상관인지 물어 본다
神聖或褻瀆(1)	Sacred or Secular (1)	성스럽거나, 불경하거나(1)
神聖或褻瀆(2)	Sacred or Secular (2)	성스럽거나, 불경하거나(2)
再確認(1)	Re-Confirm (1)	재차 확인(1)
再確認(2)	Re-Confirm (2)	재차 확인(2)
用不明的證據	From Suspicion to Affirmation	의심이 확증으로
異端審判(1)	Nobody Expects the Inquisition (1)	이단 심판(1)
拿出教理本，說了有關緹玫勒斯寺院的事情。	Telling what happened on Timeris Temple and showing the Doctrine you've obtained	교리본을 보여주며 티메리스 사원에 대해 이야기 중
異端審判(2)	Nobody Expects the Inquisition (2)	이단 심판(2)
拿出教理本，說了有關緹玫勒斯寺院工作的事情。	Telling what happened on Timeris Temple and showing the Doctrine you've obtained	교리본을 보여 주며 티메리스 사원의 일을 이야기 하는 중
異端審判(3)	Nobody Expects the Inquisition (3)	이단 심판(3)
製作植物營養劑(1)	Crafting Plant Supplement (1)	식물 영양제 만들기(1)
能幫你甚麼	What can I do for you?	도울 일이 있느냐고 묻는다
有關旁邊這個裝置	About the device nearby	옆에 있는 장치에 대해
製作植物營養劑(2)	Crafting Plant Supplement (2)	식물 영양제 만들기(2)
注入營養劑	Inject the supplement	영양제 주입
有關利那所進行的作業	About the work Lina has been doing	리나가 해 왔던 작업에 대해
依照自然調理法(1)	Naturally (1)	자연의 섭리에 따라(1)
依照自然調理法(2)	Naturally (2)	자연의 섭리에 따라(2)
開始仲裁(1)	Arbitration Initiation (1)	중재 시작(1)
秋天楓葉染紅時(1)	Autumn Leaves (1)	가을이 되면 단풍이 든다(1)
秋天楓葉染紅時(2)	Autumn Leaves (2)	가을이 되면 단풍이 든다(2)
藥草調查(1)	Inspect Herb (1)	약초 조사(1)
藥草調查(2)	Inspect Herb (2)	약초 조사(2)
換季準備(1)	Prepare for the Season (1)	계절을 준비 할 뿐(1)
換季準備(2)	Prepare for the Season (2)	계절을 준비 할 뿐(2)
時間停止的話季節也不會更迭(1)	Time Stops Along With the Season (1)	시간이 멈추면 계절도 고정된다(1)
時間停止的話季節也不會更迭(2)	Time Stops Along With the Season (2)	시간이 멈추면 계절도 고정된다(2)
詢問要確認甚麼跟怎麼確認呢	What should I check and how?	어떻게 무엇을 확인하는지 묻는다
時間停止的話季節也不會更迭(3)	Time Stops Along With the Season (3)	시간이 멈추면 계절도 고정된다(3)
時間停止的話季節也不會更迭(4)	Time Stops Along With the Season (4)	시간이 멈추면 계절도 고정된다(4)
遞出艾伊達的報告書，訴說有關調查內容的事。	Explaining Ida's report of the investigation	아이다의 보고서를 건네며 조사 내용을 말 하는 중
詢問調查可疑楓葉現象的原因	Why did you start investigating the autmumn leaves anomaly?	이상 단풍 현상을 조사한 이유를 묻는다
該做的都做了我要走了掰	My work is done so I'll be going now	할 일 다 했으니 가보겠다고 한다
說已經轉告給時空法師大師了	Assuring the Chronomancer Master that the words have reached clearly	크로노맨서 마스터에게 잘 전했다고 말하는 중
以卵擊石	Losing Battle	달걀로 바위 치기
消失的士兵們	The Disappearance of Soldiers	사라진 병사들
有關來到這裡的理由	About why here	이 곳에 있는 이유에 대해
綠色的楓葉	Green Autumn Leaves	녹색의 단풍잎
不會掉落的葉子	Leaves Refuse to Fall	떨어지지 않는 낙엽
被撕裂的碎布玩偶	Ripped Ragdolls	뜯겨진 헝겊 인형들
就要到了	On the Brink of Madness	미치기 일보 직전에
不明的攻擊	Mysterious Attack	의문의 공격
項鍊的主人	The Owner of Necklace	목걸이의 주인
不想做的事情	Things You Don't Want to Do	하기 싫은 일
正在轉達士兵的行蹤	Explaining the whereabouts of the soldiers	병사들의 행방을 전하는 중
等候父親(1)	Waiting for Daddy (1)	아빠를 기다리며(1)
等候父親(2)	Waiting for Daddy (2)	아빠를 기다리며(2)
魔族搜索行動(1)	Demon Search (1)	마족의 수색(1)
魔族搜索行動(2)	Demon Search (2)	마족의 수색(2)
搜索準備(1)	Inspection Preparation (1)	수색 준비(1)
詢問還需要甚麼	How can I help you?	무엇이 필요한지 묻는다
搜索準備(2)	Inspection Preparation (2)	수색 준비(2)
尋找痕跡(5)	Find the Trace (5)	흔적 찾기(5)
正在回收痕跡中	Retrieving the trace	흔적을 회수하는 중
尋找痕跡(1)	Find the Trace (1)	흔적 찾기(1)
尋找痕跡(2)	Find the Trace (2)	흔적 찾기(2)
正在尋找奧施莉奈女神的下落	Searching for traces of Ausrine	아우슈리네의 흔적을 찾는 중
遞出回收的物品，說出有關魔族攻擊的事。	Handing over what was retrieved and explaining that there was a demon attack	회수한 것을 건네며 마족들의 공격에 대해 이야기하는 중
尋找痕跡(3)	Find the Trace (3)	흔적 찾기(3)
尋找痕跡(4)	Find the Trace (4)	흔적 찾기(4)
整理魔族	Clean Up the Demons	마족 정리
尋找其他痕跡	To find another trace	다른 흔적을 찾아서
問甚麼時候要出發	When should we start?	언제 이동하는지 물어본다
偵查周圍(1)	Inspect the Perimeter (1)	주변 정찰(1)
偵查周圍(2)	Inspect the Perimeter (2)	주변 정찰(2)
痕跡爭奪戰(2)	Trace Race (2)	흔적 쟁탈전(2)
痕跡爭奪戰(3)	Trace Race (3)	흔적 쟁탈전(3)
痕跡爭奪戰(4)	Trace Race (4)	흔적 쟁탈전(4)
痕跡爭奪戰(6)	Trace Race (6)	흔적 쟁탈전(6)
正在跟迪耶那說有關雷克西波的事情	Explaining the story about Diena and Rexipher	디에나와 렉시퍼의 이야기를 하는 중
痕跡爭奪戰(7)	Trace Race (7)	흔적 쟁탈전(7)
痕跡的真面目(1)	The True Nature of the Trace (1)	흔적의 정체(1)
痕跡的真面目(2)	The True Nature of the Trace (1)	흔적의 정체(2)
詢問祭壇與痕跡相關的事情	What is the correlationship between the altar and the trace?	제단과 흔적의 연관성에 대해 묻는다
安裝警報器(1)	Alarm Installation (1)	경보기 설치(1)
安裝警報器(2)	Alarm Installation (2)	경보기 설치(2)
痕跡爭奪戰(1)	Trace Race (1)	흔적 쟁탈전(1)
正在訴說有關剛剛目睹的情況	Explaining what you have just seen	조금 전 본 장면에 대해 이야기하는 중
痕跡爭奪戰(5)	Trace Race (5)	흔적 쟁탈전(5)
詢問該準備些甚麼呢	What needs to be prepared?	무엇을 준비해야할지 묻는다
老傭兵的戰鬥[雙酬傭兵轉職]	Veteran Merceneary Combat [Doppelsoeldner Advancement]	숙련된 용병의 전투[도펠죌트너 전직]
證明實力[擊劍手轉職]	Prove Your Might [Fencer Advancement]	실력 증명[펜서 전직]
消失的傳令[龍騎士轉職]	Missing Order [Dragoon Advancement]	사라진 전령[드라군 전직]
領導者的證明[聖殿騎士轉職]	Leadership Training [Templar Advancement]	리더쉽 증명[템플러 전직]
去確認熄滅的火吧[槍騎兵轉職]	 Make It Doubly Sure [Lancer Advancement]	꺼진 불을 확인하라[랜서 전직]
劍鬥士的資格[角鬥士轉職]	The Glory of a Gladiator [Murmillo Advancement]	검투사의 자격[무르밀로 전직]
狩獵開始[馴鷹者轉職]	Let the Hunting Begin [Falconer Advancement]	사냥 개시[응사 전직]
執行委託[黑暗騎兵轉職]	Mission Initiated [Schwarzer Reiter Advancement]	의뢰 수행[슈바르츠라이터 전직]
破壞建築物[重砲手轉職]	De-Contruction  [Cannoneer Advancement]	구조물 파괴[캐노니어 전직]
快狠準！[火槍手轉職]	Fast ande Precise [Musketeer Advancement]	신속하고 정확하게[머스킷티어 전직]
森林深處[刀騎兵轉職]	In the Deep Forest [Hackapell Advancement]	깊고 깊은 숲속에는[하카펠 전직]
試探弓箭術實力[神射手轉職]	Archery Test [Mergen Advancement]	궁술 실력 알아보기[메르겐 전직]
取材報導- 德魯伊大師	Interview - Druid Master	취재 - 드루이드 마스터
我是來轉達賢者大師的委託的	I came here to deliver the request from the Sage Master	세이지 마스터의 부탁을 전하러 왔다고 한다
取材報導 - 擊劍手大師(1)	Interview - Fencer Master (1)	취재 - 펜서 마스터(1)
拿出賢者大師的信件	Hand the Letter from the Sage Master	세이지 마스터의 편지를 건넨다
調查書本中	Investigating the Book	책을 조사하는 중
取材報導 - 擊劍手大師(2)	Interview - Fencer Master (2)	취재 - 펜서 마스터(2)
取材報導 - 死靈法師大師	Interview - Necromancer Master	취재 - 네크로맨서 마스터
說明有關玩偶	Explaining about the Doll	인형에 대해 설명하는 중
行蹤可疑(1)	Suspicious Movement (1)	수상한 동향(1)
行蹤可疑(2)	Suspicious Movement (2)	수상한 동향(2)
正在安裝魔力水晶	Installing Spell Crystal	마력 수정 설치하는 중
行蹤可疑(4)	Suspicious Movement (3)	수상한 동향(4)
詢問如何取得	How can I acquire them?	어떻게 구해야하는지 묻는다
眼前的陷阱	It's A Trap	바로 앞의 함정
如何找到蹤跡	How do I follow the trail?	어떻게 흔적을 찾을지 묻는다
魔王之眼(1)	The Eye of Demon Lord (1)	마왕의 눈(1)
魔王之眼(2)	The Eye of Demon Lord (2)	마왕의 눈(2)
正在說親身經歷之事	Telling the Story So Far	겪은 일을 이야기하는 중
葛林家門的援助	Founder of the Green Family	그린가문의 원조
行蹤不明的採藥者(1)	Missing Herbalist (1)	사라진 약초꾼(1)
行蹤不明的採藥者(2)	Missing Herbalist (2)	사라진 약초꾼(2)
行蹤不明的採藥者(3)	Missing Herbalist (3)	사라진 약초꾼(3)
行蹤不明的採藥者(4)	Missing Herbalist (4)	사라진 약초꾼(4)
行蹤不明的採藥者(5)	Missing Herbalist (5)	사라진 약초꾼(5)
偉大的終結者(1)	The Great Problem-Solver (1)	위대한 해결사(1)
你到底在說甚麼	What do you mean?	무슨 소리인지 묻는다
假裝沒看到	La-la-la-la-la~	무시하고 지나간다
偉大的終結者(2)	The Great Problem-Solver (2)	위대한 해결사(2)
問問這是甚麼水晶	What crystal?	무슨 수정인지 묻는다
偉大的終結者(3)	The Great Problem-Solver (3)	위대한 해결사(3)
詢問是甚麼問題	What's the problem?	무슨 문제인지 묻는다
偉大的終結者(4)	The Great Problem-Solver (4)	위대한 해결사(4)
詢問有關閔希豪森男爵的事情	Who is Baron Munchausen?	뮌히하우젠 남작에 대해 물어본다
偉大的終結者(5)	The Great Problem-Solver (5)	위대한 해결사(5)
詢問該怎麼辦	What should I do?	무엇을 해야하는지 묻는다
狂熱者的考驗	Zealot's Trial	질럿의 시험
挑戰考驗。	I will challenge the trail	시험에 도전한다
表示會去進行準備	Let me prepare	준비하겠다고 한다
行蹤可疑(3)	Suspicious Movement (4)	수상한 동향(3)
作業失誤(2)	Setbacks (2)	업무 차질(2)
問問哪裡有竹島里草	Where can I find wild ginger plants?	죽두리 풀이 어디있는지 묻는다
女神之花(1)	The Goddess' Flower (1)	여신의 꽃(1)
浸泡於河水中	Immersing it under water	물가에 담그는 중
女神之花(2)	The Goddess' Flower (2)	여신의 꽃(2)
心力交瘁的理由	About why looking so tired	그렇게 지쳐 있었던 이유에 대해
女神之花(3)	The Goddess' Flower (3)	여신의 꽃(3)
詢問怎麼浸泡	How do I do that?	어떻게 담냐고 묻는다
女神之花(4)	The Goddess' Flower (4)	여신의 꽃(4)
女神之花(5)	The Goddess' Flower (5)	여신의 꽃(5)
女神之花(6)	The Goddess' Flower (6)	여신의 꽃(6)
女神之花(7)	The Goddess' Flower (7)	여신의 꽃(7)
燃燒花朵	Burn the flower	꽃 태우기
女神之花(8)	The Goddess' Flower (8)	여신의 꽃(8)
女神之花(9)	The Goddess' Flower (9)	여신의 꽃(9)
藏在森林中的危險(1)	Danger the Lurks in the Forest (1)	숲 속에 숨어있는 위험(1)
藏在森林中的危險(2)	Danger the Lurks in the Forest (2)	숲 속에 숨어있는 위험(2)
詢問該幫忙取得甚麼	What should I get?	어떤 것들을 구하면 되냐고 묻는다
藏在森林中的危險(3)	Danger the Lurks in the Forest (3)	숲 속에 숨어있는 위험(3)
藏在森林中的危險(4)	Danger the Lurks in the Forest (4)	숲 속에 숨어있는 위험(4)
快去瘟疫醫生大師那裡看看	Go to the Plague Doctor Master	플레이그 닥터 마스터에게 가보라고 한다
藏在森林中的危險(5)	Danger the Lurks in the Forest (5)	숲 속에 숨어있는 위험(5)
藏在森林中的危險(6)	Danger the Lurks in the Forest (6)	숲 속에 숨어있는 위험(6)
詢問要去哪才能找到閃爍花	Where can I obtain vink flowers?	빙크 꽃을 어디서 구해야하는지 묻는다
藏在森林中的危險(7)	Danger the Lurks in the Forest (7)	숲 속에 숨어있는 위험(7)
藏在森林中的危險(8)	Danger the Lurks in the Forest (8)	숲 속에 숨어있는 위험(8)
問藥劑製作方法	How do you make the cure?	약 제조법에 대해 묻는다
藏在森林中的危險(9)	Danger the Lurks in the Forest (1)	숲 속에 숨어있는 위험(9)
新研究需要的材料[死靈法師轉職]	Ah Fresh Sample [Necromancer Advancement]	새로운 연구에 필요한 재료[네크로맨서 전직]
考慮看看其他方法	Think of another solution	다른 방법을 생각해본다
香精材料[鍊金術士轉職]	The Materials for Incense [Alchemist Advancement]	향의 재료[알케미스트 전직]
瀰漫詛咒的遺物[妖術師轉職]	Cursed Keepsakes [Featherfoot Advancement]	저주가 서린 유품들[페더풋 전직]
被魔氣汙染的植物[德魯伊轉職]	Corrupted Plant [Druid Advancement]	마기에 오염된 식물[드루이드 전직]
不清晰的影像[神諭師轉職]	Faint Vision [Oracle Advancement]	희미한 영상[오라클 전직]
尋找病原菌[瘟疫醫生轉職]	Locate the Pahtogen [Plague Doctor Advancement]	병원균 찾기[플레이그닥터 전직]
數字的意義[卡巴拉轉職]	What the Numbers Signify [Kabbalist Advancement]	숫자가 의미하는 것[카발리스트 전직]
魔法學重建需要的東西[賢者轉職]	Rebuilding the  Study of Magic [Sage Advancement]	마법학 재건에 필요한 것들[세이지 전직]
魔力吸收[附魔師轉職]	Spell Absorption [Enchanter Advancement]	마력 흡수[인챈터 전직]
異端審判者[新審判者轉職]	Heretics Beware [Inquistor Advancement]	이단 심문자[인퀴지터 전직]
身為審判者，有能力承擔責任與權限。	I can fully take up the duties and authorities as an Inquisitor	심판자로서 책임과 권한을 감당할 수 있다고 한다
身為審判者，沒有能力承擔責任與權限。	I refuse to take the authorities nor the duties it entails	심판자로서 책임과 권한을 감당 할 수 없다고 한다
符咒使用法[道士轉職]	How to Charm [Taoist Advancement]	부적 사용법[도사 전직]
要求多一點考慮時間	Give me a moment to think about that	조금만 생각의 시간을 달라고 한다
忍者大師的請託	A Request from the Shinobi Master	시노비 마스터의 도움요청
拿出紙條中	Handing Over the Note	쪽지를 건내주는 중
沒關係沒關係	It's Alright	괜찮아요 괜찮아
村莊主人的財產(1)	Villagers' Valuables (1)	마을 주민의 재산(1)
村莊主人的財產(2)	Villagers' Valuables (2)	마을 주민의 재산(2)
一定想吃的東西	Just What I Was Craving	꼭 먹고 싶었던 것
鬥牛士的素養	Matador's Knowledge	마타도르의 소양
與槍彈者大師對話	Talk with the Bullet Marker Master	불릿 마커 마스터와 대화
前往槍彈者大師說的訓練場	Go to the training grounds the Bullet Marker Master mentioned	불릿 마커 마스터가 알려준 훈련장으로 이동
消滅怪物並收集勒肯家門的圖章碎片	Defeat monsters and obtain a piece of Legwyn's seal	몬스터를 처치해서 르귄가의 인장 조각 수집
消滅怪物並收集散發強烈眷戀的遺物	Defeat the monster to obtain the relic that possesses a strong grudge	몬스터를 처치하여 강한 미련이 느껴지는 유품 수집
收集中和劑材料	Collect the materials for the neutralizer	중화제 재료 수집
在怪物的背後用袋子來收集散發果香的碎片	Use the pocket behind the monsters and collect the pieces that possess a fruity fragrance	몬스터의 뒤에서 주머니를 사용하여 과일향이 나는 조각 수집
在限制時間內，依照預定目標的量消滅怪物	Defeat the number of monsters within the time limit	제한 시간 내에 몬스터 목표량만큼 처치
收集植物怪物的樣本	Collect the samples of Plant-type monsters	식물 몬스터의 샘플 수집
在卡勒埃原野設置淨化的那姆特	Set the Namott of Purification at Galeed Plateau	갈르엣 평야에 정화의 나모트 설치
與龍騎士大師對話	Talk with the Dragoon Master	드라군 마스터와 대화
向龍騎士大師報告	Report to the Dragoon Master	드라군 마스터에게 보고
請與柯拉佩達的騎士團長烏斯卡對話。	Talk to Knight Commander Uska in Klaipeda	클라페다에 있는 기사단장 우스카와 대화하세요.
以5人隊伍隊長的身分維持隊伍5分鐘	Maintain 5 people in a party for 5 minutes as a leader	5인 파티의 리더로 파티를 5분간 유지
與咒術師大師對話	Talk with the Warlock Master	워록 마스터와 대화
喚醒惡靈後消滅怪物	Defeat the monsters whose evil sprits have awakened	악령이 깨어난 몬스터 처치
向咒術師大師報告	Report to the Warlock Master	워록 마스터에게 보고
和妖術師大師對話	Talk with the Featherfoot Master	페더풋 마스터와 대화
請使用咒術道具賦予怪物詛咒	Cast a curse on the monsters using the Incantation Tools	주술도구를 사용해서 몬스터에게 저주 걸기
向妖術師大師報告	Report to the Featherfoot Master	페더풋 마스터에게 보고
與重砲手大師對話	Talk with the Canonneer Master	캐노니어 마스터와 대화
消滅飛行型與步行型怪物	Defeat Flying-type and Walking-type monsters	비행형과 보행형 몬스터 처치
向重砲手大師報告	Report to the Canonneer Master	캐노니어 마스터에게 보고
與火槍手大師對話	Talk with the Musketeer Master	머스킷티어 마스터와 대화
請與內城地區的火槍手大師對話。	Talk with the Musketeer Master at the Inner Fortress District	내성곽지구에 있는 머스킷티어 마스터와 대화하세요.
從對大射程距離攻擊怪物	Attack the monsters from the maximum distance	최대 사정거리에서 몬스터 공격
向火槍手大師報告	Report to the Musketeer Master	머스킷티어 마스터에게 보고
與瘟疫醫師大師對話	Talk with the Plague Doctor Master	플레이그 닥터 마스터와 대화
拿取結果報告	Retrieve the Reports	결과 보고서 가져오기
向瘟疫醫師大師報告	Report to the Plague Doctor Master	플레이그 닥터 마스터에게 보고
與卡巴拉大師對話	Talk with the Kabbalist Master	카발리스트 마스터와 대화
消滅出現在水星球上的數字所代表的怪物	Defeat the monster indicated by the number displayed on the crystal sphere	수성구에 나타난 숫자가 의미하는 몬스터 처치
向卡巴拉大師報告	Report to the Kabbalist Master	카발리스트 마스터에게 보고
抓準時機攻擊擊劍手的劍練習台	Hit the practice pole of Fencers at right times	펜서의 검 연습대에 타이밍 맞춰 공격
向忍者大師報告	Report to the Shinobi Master	시노비 마스터에게 보고
與卡特萊對話	Talk with Gatre	가트레와 대화
回收怪物手中的研究物品	Retrieve the research materials from the monsters	몬스터에게서 연구 물품 회수
將研究物品交給卡特萊	Hand over the research materials to Gatre	가트레에게 연구 물품 전달
偷偷請求協助	Request for the secretive rescue	은밀한 구조 요청
向卡特萊報告	Report to Gatre	가트레에게 보고
確認被丟棄在梅恩卡小丘的文件	Check the abandoned document at Menka Knoll	멘카 둔덕의 버려진 문서 확인
將研究資料交給卡特萊	Hand over the research materials to Gatre	가트레에게 연구 자료 전달
研究的真相	True Nature of the Research	연구의 실체
與薩勒瑪對話	Talk with Sarma	사르마와 대화
使用麻醉粉，並採集草綠艾迪戈的血液	Use the paralysis powder to extract Green Weldigo Blood	마취 가루를 사용해서 초록 엘디고의 혈액 채취
交給薩勒瑪	Hand them over to Sarma	사르마에게 전달
搜查遺失的研究日誌	Search the lost research paper	유실된 연구 일지 수색
擊退怪物，收集果汁結晶	Defeat the monsters to collect the fruit juice crystals	몬스터를 처치하여 과즙 결정 수집
收集過度生長的植物葉子	Collect the leaves of the plants that grew up strangely	과성장한 식물의 잎사귀 수집
將收集的材料交給薩勒瑪	Hand over the materials to Sarma	사르마에게 모은 재료 전달
妨礙研究	Sabotage the research	연구 방해공작
回去找卡特萊	Return to Gatre	가트레에게 돌아가기
確認遺失的研究日誌	Check the lost research paper	유실된 연구 일지 확인
在研究資料倉庫裏頭尋找與果樹發酵液類似的藥品	Look for the medicine that is similar to the ripen liquid from the research materials' storage	연구 자재 창고에서 과일 나무의 숙성액과 비슷한 약품 찾기
交給卡特萊	Hand them over to Gatre	가트레에게 전달
將假的果樹發酵液交給薩勒瑪	Hand over the ripen liquid of the fake fruit tree to Sarma	사르마에게 가짜 과일 나무의 숙성액 전달
薩勒瑪的研究真相	True Nature of Sarma's Research	사르마의 연구 실체
使用雙星魔法陣來提煉材料	Use the Transmutation Magic Circle to create ductile ingredients	연성 마법진을 이용해서 재료 연성
將完成的溶液交給薩勒瑪	Hand over the completed liquid to Sarma	사르마에게 완성된 용액 전달
在草堆上噴灑溶液	Sprinkle the liquid onto the pile of the grass	풀더미에 용액 뿌려보기
確認被丟棄的紙條	Check the abandoned memo	버려진 쪽지 확인
搜查樹箱	Search the wooden boxes	나무 상자 수색
確認罈子	Check the pot	항아리 확인
搜查下一個罈子	Search the next pot	다음 항아리 수색
啟示守護者札那斯	Revelation Guardian Zanas	계시 수호자 자나스
傾聽靈魂的聲音	Listen to the Soul's voice	영혼의 목소리 듣기
搜尋那聲音的主人	Search for the source of the voice	목소리의 주인 수색
與札那斯的靈魂對話	Talk to Zanas' Soul	자나스의 영혼과 대화
完成保護魔法	Complete the Protection Magic	보호 마법 완성
向札那斯的靈魂報告	Report back to Zanas' Soul	자나스의 영혼에게 보고
查看碑石的背面尋找微弱綠色魔石	Search for the Teal Magic Stone on the back of the Tombstone	비석의 뒷면을 조사하여 은은한 녹색 마석 수색
向札那斯報告	Report back to Zanas	자나스에게 보고
消滅魔族後可獲得卡雷伊瑪斯魔族的血	Obtain Kalejimas Demon Blood by defeating Demons	마족을 처치해 칼레이마스 마족의 피 획득
交給札那斯的靈魂	Give it to Zanas' Soul	자나스의 영혼에게 전달
對抗強敵的方法	How to beat stronger foes	강적을 상대하는 법
解除屏蔽區域的秘密裝置	Disarm the Isolated Area's Secret Device	차폐구역의 비밀 장치 해제
魔力抑制卷軸中的魔族的魔力紀錄	Regsiter Demon Magic on the Magic Control Scroll	마력 억제 주문서에 마족의 마력 기록
解除器材室的秘密裝置獲得領域支配魔法寶珠	Disarm the Secret Device to obtain the Dominance Magic Orb in the Subsidiary Material Storage Room	자재실의 비밀 장치를 해제하여 영역 지배 마법의 보주 획득
移動至魔族的結界	Move to the Demon Barrier	마족의 결계로 이동
札那斯的另一個靈魂	Another Soul of Zanas	또 다른 자나스의 영혼
跟卡雷伊瑪斯保管室的札那斯的靈魂對話	Talk to Zanas' Spirit in Storage	칼레이마스 보관실에 있는 자나스의 영혼과 대화
消滅怪物後收集蘊含邪惡魔力的核	Collect Evil Energy Cores by defeating monsters	몬스터를 처치해서 사악한 마력이 담긴 핵 수집
無法確認的札那斯的靈魂的行蹤	Free the hiding Soul of Zanas	숨어있는 자나스의 영혼 해방
與隱藏起來的札那斯的靈魂對話	Talk to Zanas' Soul	숨어있던 자나스의 영혼과 대화
尋找卡雷伊瑪斯的秘密裝置說明書	Search for Kalejimas Secret Device Instructions	칼레이마스의 비밀 장치 설명서 수색
保管室的燈	Storage Lamp	보관실의 램프
搜尋藍燈	Look for the Blue Lamp	푸른 램프 수색
確認藍燈	Check the Blue Lamp	푸른 램프 확인
收集附近油袋裡的藍燈的油	Retrieve Oil from the nearby Oil Pouch for the Blue Lamp	주변의 기름 주머니에서 푸른 램프의 기름 회수
將油注入藍燈	Give the Blue Lamp Oil	푸른 램프에 기름 주입
確認紅燈	Check the Red Lamp	붉은 램프 확인
請解決怪物回收紅燈的油	Retrieve Oil for the Red Lamp by defeating monsters	몬스터를 처치해서 붉은 램프의 기름 회수
將油注入紅燈	Give the Red Lamp Oil	붉은 램프에 기름 주입
啟動黃燈所有的魔法陣	Activate all of the Yellow Lamp's Magic Circles	노란 램프의 모든 마법진 활성화
點亮黃燈	Light the Yellow Lamp	노란 램프에 불 밝히기
從秘密裝置中獲得王的紅寶石	Obtain the King's Red Jewel from the Secret Device	비밀 장치에서 왕의 붉은 보석 획득
保管室的結界	Storage Room Barrier	보관실의 결계
我是誰	Who am I	내가 누구게
與獨房區域裡的札那斯的靈魂對話	Talk to Zanas' Spirit at the Solitary Cells	칼레이마스 독방구역에 있는 자나스의 영혼과 대화
請在懸吊之房裡的秘密裝置附近消滅魔族	Defeat the Demons near the Hanging Room's Secret Device	매달리는 방에 있는 비밀 장치 근처에서 마족 처치
啟動懸吊之房裡的秘密裝置	Activate the Secret Device in the Hanging Room	매달리는 방에 있는 비밀 장치 가동
向禁閉室的赤紅蘇凱博學者聽取情報	Listen to information from the Red Socket Mage in the Solitary Cell	징벌 독방의 붉은 소켓 메이지에게 정보 듣기
消滅魔族獲得克萊獰怪的印章	Obtain Grinende Seal's by defeating the Demons	마족을 처치해서 그라이넨더의 인장 획득
移動至監獄	Prison Movement	감옥이동
在囚犯休息室上方的秘密裝置中獲得卡雷伊瑪斯空間移動卷軸	Obtain Kalejimas Teleportation Scrolls from the Prisoner Waiting Room's Secret Device	죄수 대기실 위쪽에 있는 비밀 장치에서 칼레이마스 공간이동 주문서 획득
使用卡雷伊瑪斯空間移動卷軸	Use the Kalejimas Teleportation Scroll	칼레이마스 공간이동 주문서 사용
啟動長期服刑收監所的秘密裝置	Activate the Secret Device in the Long Sentence Prison Cell	장기 복역 수감소의 비밀 장치 가동
引誘怪物到秘密裝置周圍	Lure the monsters near the Secret Device	비밀 장치 주변으로 몬스터를 유인
解除克萊獰怪的魔法陣	Disarm Grinende's Magic Circle	그라이넨더의 마법진 해제
消滅消滅卡雷伊瑪斯 獨房區域札那斯的靈魂	Defeat the Demon Stragglers in the Solitary Cells	칼레이마스 독방구역의 마족 잔당 처치
解除普通監獄的秘密裝置	Disarm the Regular Prison Cell's Secret Device	일반 옥사의 비밀 장치 해제
從秘密裝置中獲得王之綠寶石	Obtain the King's Green Jewel from the Secret Device	비밀 장치에서 왕의 초록 보석 획득
跟卡雷伊瑪斯作業場的札那斯的靈魂對話	Talk to Zanas' Spirit at the Reintegration Workshop	칼레이마스 작업장에 있는 자나스의 영혼과 대화
在個別作業場搜索移動魔法	Search for Teleporation Magic in the Individual Workshop	개별 작업장에서 이동 마법 수색
被束縛的札那斯的靈魂	The Restrained Spirit of Zanas	구속된 자나스의 영혼
消滅怪物獲得束縛的靈魂石	Obtain the Spirit Stone of Restrainment by defeating monsters	몬스터를 처치해서 속박의 영혼석 획득
解除束縛魔法陣救出札那斯的靈魂	Rescue Zanas' Spirit by disarming the Magic Circle of Restrainment	속박 마법진을 해제하여 자나스의 영혼 구출
與被放開的札那斯的靈魂對話	Talk to the now free Zanas' Spirit	풀려난 자나스의 영혼과 대화
收集碎片	Shard Collection	조각 모음
消滅怪物獲得了4種碎片	Defeat the monsters and obatin four types of Shards	몬스터를 처치해서 네 종류의 조각 확득
利用光之結晶淨化碎片	Purify the Shards by using Light Crystal	빛의 결정을 이용해서 조각 정화
確認副器材室裡的秘密裝置	Check the Secret Device in the Supply Room	부자재실에 있는 비밀 장치 확인
使用秘密裝置前、後、左、右的各個碎片	Use the Shards on all four directions of the Secret Device	비밀 장치의 앞, 뒤, 양옆에 각각의 조각 사용
從秘密裝置中獲得王之黃寶石	Obtain the King's Yellow Jewel from the Secret Device	비밀 장치에서 왕의 노란 보석 획득
與來到副器材室的札那斯的靈魂對話	Talk to Zanas' Spirit in the Supply Room	부자재실로 온 자나스의 영혼과 대화
啟動體罰房的秘密裝置	Activate the Secret Device in the Punishment Room	체벌방의 비밀 장치 활성화
啟動體罰房的秘密裝置	Activate the Secret Device in the Punishment Room	체벌방의 비밀 장치 작동
作業場的結界	Workshop Barrier	작업장의 결계
消滅前往魔族的結界路上的怪物	Defeat the monsters on the way to the Demon Barrier	마족의 결계로 가는 길의 몬스터 처치
消滅周圍的怪物，回收監視用探測器零件。	Defeat nearby monsters to retrieve the Observational Detector parts	주변의 몬스터를 처치해서 감시용 탐색기 부품 회수
修理監視用探測器	Repair the Observational Detector	감시용 탐색기 수리
札那斯的決心	Zanas' Resolve	자나스의 결심
補充焚燒爐周圍的元氣結晶	Charge Energy Crystals around the Incinerator	소각로 주변의 원기의 결정 충전
啟動焚燒爐的秘密裝置	Activate the Incinerator's Secret Device	소각로의 비밀 장치 작동
現在最要緊的事情	What needs to be done	지금 해야 할 일은
消滅前往焚燒爐路上的怪物	Defeat the monsters on the way to the Incinerator	소각로로 향하는 길에 있는 몬스터 처치
啟動懲罰之塔裡的魔法裝置	Activate the Magical Device at the Tower of Discipline	징벌의 탑에 있는 마법 장치 작동
啟動卡杜梅爾的所有魔法陣	Activate all of Kadumel's Magic Circles	카듀멜의 마법진 전부 활성화
解除刑場的秘密裝置	Disarm the Secret Device at the Execution Grounds	처형장의 비밀 장치 해제
從秘密裝置中獲得老舊的重力磁場石	Obtained a Worn Gravity Stone from the Secret Device	비밀 장치에서 낡은 그라비티 스톤 획득
使用老舊的重力磁場石消滅魔族	Defeat the Demons by using the Worn Gravity Stone	낡은 그라비티 스톤을 사용해서 마족 처치
使用老舊的重力磁場石除去魔族召喚水晶	Remove the Demon Summoning Crystal by using the Worn Gravity Stone	낡은 그라비티 스톤을 사용해서 마족 소환수정 제거
在魔族的結界呼叫札那斯的靈魂	Call Zanas' Spirit from the Demon's Barrier	마족의 결계에서 자나스의 영혼 호출
消滅內比爾拉斯獲得王之藍寶石	Obtain the King's Blue Jewel after defeating Nebulas	네뷸라스를 처치하고 왕의 푸른 보석 획득
從懺悔室裡的秘密裝置中獲得啟示	Obtain the Revelation from the Confessional Secret Device	참회실에 있는 비밀 장치에서 계시 획득
確認牆壁的塗鴉	Check the Writings on the Wall	벽의 낙서 확인
確認牆上塗鴉所指引的地點	Check the location indicated by the writings on the wall	벽의 낙서가 가리키는 장소 확인
確認地膚子廣場的秘密裝置	Check the Secret Device at Jibuza Square	지부자 광장의 비밀 장치 확인
確認從接見所某地取出的補給箱子	Check the Supply Chest that is hidden somewhere in the Waiting Room	접견소 어딘가에 꺼내진 보급 상자 확인
確認中央集結地的秘密裝置	Check the Secret Device at the Central Assembly Area	중앙 집결지의 비밀 장치 확인
獲得秘密裝置裡的東西	Obtain the object from inside the Secret Device	비밀 장치안에 있는 물건 획득
確認長期服刑收監所的牆	Check the walls of the Long Sentence Prison Cell	장기 복역 수감소의 벽 확인
搜索囚犯的收押品	Search Confiscated Goods	죄수의 압수품 수색
確認囚犯休息室掉在地上的信	Check the letter on the ground at the Inmate's Lounge	죄수 휴게실 바닥에 떨어진 편지 확인
找尋知道信件主人的人	Search for a person that knows the letter's owner	편지의 주인을 아는 사람 수색
與佩迪米安的老人對話	Talk to the old man at Fedimian	페디미안의 노인과 대화
啟動卡雷伊瑪斯審問室入口的秘密裝置	Activate the Secret Device in the Interrogation Room Entrance	칼레이마스 심문실 입구에 있는 비밀 장치 작동
消滅秘密裝置的數字指向的怪物	Defeat as many monsters as the Secret Device is indicating	비밀 장치의 숫자가 가리키는 몬스터 처치
解除深淵之房的秘密裝置	Disarm the Secret Device in the Room of Abyss	심연의 방의 비밀 장치 해제
獲得秘密裝置獎勵	Obtain the Reward from the Secret Device	비밀 장치에서 보상 획득
確認札那斯的邪念	Check Zanas' Echo	자나스의 사념 확인
在焚燒爐周圍聚集元氣結晶	Gather Energy Crystals from near the Incinerator	소각로 주변에서 원기의 결정 모으기
往札那斯的邪念傳達元氣	Passing energy to Zanas' Echo	자나스의 사념에 원기 전달
消滅赤紅大蘑菇精獲得蘑菇精的滑溜汁液	Defeat Big Red Gribas to obtain Griba Juice	붉은 빅 그리바를 처치해서 그리바의 미끈한 즙 획득
解毒劑材料加工	Mix the Antidote Ingredients	해독제 재료 가공
在鍊金術桌子上製作解毒劑	Craft the Antidote at the Alchemy Table	연금술 탁자에서 해독제 제작
治療研究員艾達斯	Cure Researcher Adas	연구원 에이다스 치료
治療研究員彼特	Cure Researcher Veed	연구원 비드 치료
通過樹木藤蔓	Pass the Tree Vines	나무 덩굴을 지나서
與研究員彼特對話	Talk to Researcher Veed	연구원 비드와 대화
找尋寫著合成公式的紙張	Search for the paper with the combination	조합식이 적힌 종이 수색
尋找資材保管盒裡面的中和劑催化劑	Search the Chest of Materials for Neutralizer reagent	자재 보관함에서 중화제의 촉매 수색
將試劑合成魔法陣依周圍光的順序啟動	Activate the lights surrounding the Potion Mixing Magic Circle in the correct order	시약 조합 마법진 주위의 빛을 순서대로 활성화
用試劑合成魔法陣製作過度成長溶液的中和劑	Craft a Overgrowth Potion Neutralizer with the Potion Mixing Magic Circle	시약 조합 마법진으로 과성장 용액의 중화제 제작
除去擋路的樹木藤蔓	Remove the Tree Vines blocking the road	길을 막는 나무 덩굴 제거
更強的解毒劑	Enhanced Antidote	더 강력한 해독제
調查莎勒瑪的研究資料	Examine Sarma's Research Materials	사르마의 연구자료 조사
消滅綠色大花草獲得大花草的黏稠樹液	Defeat the Green Rafflesia to obtain Sticky Sap Rafflesia	초록 라플레시아를 처치해서 라플레시아의 끈적한 수액 획득
與研究員席蕾亞對話	Talk to Researcher Sireah	연구원 시레아와 대화
透過研究員席蕾亞製造強化的解毒劑	Craft an Enhanced Antidote with Researcher Sireah	연구원 시레아를 통해 강화된 해독제 제조
用強化的解毒劑解毒有毒區域	Purify the Poisoned Ground with the Enhanced Antidote	강화된 해독제로 독지대 해독
追蹤逃走的莎勒瑪	Tracking Sarma	도망간 사르마 추적
向研究員席蕾亞報告	Report back to Researcher Sireah	연구원 시레아에게 보고
消滅中了莎勒瑪的毒的怪物	Defeat monsters that have been poisoned by Sarma's Poison	사르마의 독에 중독된 몬스터 처치
消滅中了毒的怪物	Defeat the poisoned monsters	독에 걸린 몬스터 처치
破壞莎勒瑪主要實驗室的設備	Destroy research equipment at Sarma's main laboratory	사르마의 주 실험실의 설비 파괴
與奎波爾優雷對話	Talk to Kupole Jore	큐폴 요레와 대화
搜查內城壁第8區域	Investigate Inner Wall District 8	내성벽 제 8구역 수사
調查第8區域倉庫	Inspect District 8 Warehouse	제 8구역 창고 조사
向奎波爾優雷報告	Report to Kupole Jore	큐폴 요레에게 보고
到文件管理室調查痕跡	Find the trace in the Document Archive	문서 관리실에서 흔적 조사
確認中央統治室的魔法陣	Check the magic circle in the central control room	중앙 통제실의 마법진 확인
確認資材保管盒	Chest the material storage chest	자재 보관함 확인
製作破壞資材保管盒的道具	Craft something that can break the Material Storage Chest	자재 보관함을 부술 물건 제작
破壞資材保管盒	Destroy the Material Storage Chest	자재 보관함 파괴
確認魔法陣管理部	Check the magic circle maintenance department	마법진 관리부 확인
移動前往魔法陣	Move to the magic circle	마법진으로 이동
使用魔法陣四週的魔力之眼	Use the Magical Eye in four directions of the magic circle	마법진 주위 네 방향에서 마력의 눈 사용
調查第8區域研究室	Inspect the District 8 Laboratory	제 8구역 연구실 조사
確認魔法石燈	Check the lamp's magic stone	램프 마법석 확인
用燈的光確認帶有魔法的紙	Check the magical paper with the lamp light	램프의 빛으로 마법이 걸린 종이 확인
和奎波爾優雷一起推理	Deduce what happened with Kupole Jore	큐폴 요레와 함께 추리
消滅內城壁第8區域的怪物	Defeat monster in the inner wall district 8	내성벽 제 8구역의 몬스터 처치
調查內城壁第9區域	Inspect Inner Wall District 9	내성벽 제 9구역 조사
與奎波爾里耶帕對話	Talk to Kupole Liepa	큐폴 리에파와 대화
向奎波爾里耶帕說明	Explain to Kupole Liepa	큐폴 리에파에게 설명
消滅指揮室裡的怪物	Defeat the monster in the command room	사령실에 있는 몬스터 처치
在指揮室搜索內城壁第9區域管理文件	Search the Command Room for Maintanence documents for Inner Wall District 9	사령실에서 내성벽 제 9구역 관리문서 수색
轉交給奎波爾里耶帕	Deliver to Kupole Liepa	큐폴 리에파에게 전달
調查管理室	Inspect the Management Room	관리실 조사
確認衝擊吸收魔法陣	Check the Impact Absorption Magic Circle	충격 흡수 마법진 확인
確認油桶保管所	Check the Oil Barrel Storage Room	기름통 보관소 확인
在附近搜索油桶	Search for the oil barrel nearby	근처에서 기름통 수색
確認火焰放射魔法石	Check the Flamethrowing Magic Stone	화염 방사 마법석 확인
驅動火焰放射魔法石	Ignite Flamethrowing Magic Stone	화염 방사 마법석 시동
啟動火焰放射魔法石	Operate Flamethrowing Magic Stone	화염 방사 마법석 작동
在兵營搜索線索	Find the clue in the Barrack	병영에서 단서 수색
確認指揮官室的秘密保管箱	Check the secret storage chest in the command room	지휘관실의 비밀 보관함 확인
解鎖秘密保管箱	Unlock Secret Storage Chest	비밀 보관함 잠금 해제
確認秘密保管箱	Check the Secret Storage Chest	비밀 보관함 확인
和奎波爾優雷一起推理	Deduce what happened with Kupole Liepa	큐폴 리에파와 추리
在會議室消滅怪物獲得緊急命令書後確認其中的內容。	Check the conent of the emergency order after obtaining it from the monsters in the meeting room	회의실의 몬스터를 처치해서 긴급 명령서를 획득 후 내용 확인
修復緊急魔法陣	Repair the Emergency Magic Circle	비상 마법진 복구
解除第1核心保護裝置	Disarm the Primary Core Protection Device	제 1차 코어 보호장치 해제
確認防禦壁管理機	Check the Defensive Wall Maintainer	방어벽 관리기 확인
前往工作室	Move to the Office	집무실로 이동
在工作室搜索紅色驅動魔石	Search for Red Ignition Magic Stone in the Office	집무실에서 붉은 시동 마석 수색
解除防禦壁管理機	Disarm the Wall Maintainer	방어벽 관리기 해제
確認第2核心保護裝置	Check the Secondary Core Protection Device	제 2차 코어 보호장치 확인
清除所有魔力的源泉	Remove all magic sources	모든 마력의 원천 제거
解除第2核心保護裝置	Disarm the Secondary Core Protection Device	제 2차 코어 보호장치 해제
確認第3核心保護裝置	Check the Tertiary Core Protection Device	제 3차 코어 방어장치 확인
破壞魔力再生石	Destroy Magic Regeneration Stones	마력 재생석 파괴
解除第3核心保護裝置	Disarm the Tertiary Core Protection Device	제 3차 코어 방어장치 해제
確認外城壁核心	Check the Outer Wall Core	외성벽 코어 확인
消滅被引到外城壁核心的小魔怪	Defeat goblins lured in by the core	외성벽 코어에 이끌려 온 그렘린 처치
回收外城壁核心	Retrieve the  Outer Wall Core	외성벽 코어 회수
三重城牆發生的事	Incident on Triple-Layerd Castle Wall	삼중성벽에 있던 일
將外城壁核心轉交給奎波爾密爾達	Deliver the  Outer Wall Core to Kupole Milda	큐폴 밀다에게 외성벽 코어 전달
和奎波爾優雷一起推理	Deduce with Kupole Jore	큐폴 요레와 추리
補給兵的最後任務	The Supply Soldier's Last Mission	보급병의 마지막 임무
與補給兵的靈魂對話	Talk with the Soul of the Supply Officer	보급병의 영혼과 대화
請與補給兵的靈魂對話。	Talk to the Soul of the Supply Officer	보급병의 영혼과 대화하세요.
回收遺失的城牆補給品	Retrieve the lost supplies	유실된 성벽 보급품 회수
轉交給補給兵的靈魂	Deliever to the soul of supply officer	보급병의 영혼에게 전달
消滅怪物回收遺失的城牆補給品	Retrieve the lost supplies from the monsters	몬스터를 처치해서 유실된 성벽 보급품 회수
城牆士兵的迷戀	Castle Wall Soldier's Unfinished Business	성벽 병사의 미련
與城牆士兵的靈魂對話	Talk with the Soul of Castle Wall Soldier	성벽 병사의 영혼과 대화
收集城牆士兵的遺物	Gather the keepsake of soldiers	성벽 병사의 유품 모으기
尋找庫萊嶺的聖所	Find the Sanctuary of Kule Peak	쿨레 고개의 성소 찾기
在聖所中央放下遺物	Place the keepsakes in the middle of the sanctuary	성소의 가운데에 유품 내려두기
活化庫萊嶺的聖所	Activate the Sanctuary of Kule Peak	쿨레 고개의 성소 활성화
與偵察兵的靈魂對話	Talk with the Soul of the Scout	정찰병의 영혼과 대화
請與偵察兵的靈魂對話。	Talk to the Soul of the Scout	정찰병의 영혼과 대화하세요.
尋找城牆偵察兵的報告書	Find the Scout report from the wall	성벽 정찰병의 보고서 찾기
轉交給偵察兵的靈魂	Deliver to the soul of the scout	정찰병의 영혼에게 전달
收集感覺得到神聖力量的碎片	Gather the fragments with the divine energy	신성한 힘이 느껴지는 조각 모으기
受歡迎的人	Welcomed One	환영받는 자
和士兵加爾蘭斯對話	Talk to Soldier Guylens	병사 가일랜스와 대화
和士兵加爾連斯對話	Talk to Soldier Guylens	병사 가일렌스와 대화
和副隊長達爾倫對話	Talk to Assistant Commander Talon	부대장 탈른과 대화
與補給兵海倫塔斯對話	Talk to Supply Soldier Herntas	보급병 해른타스와 대화
與補給兵德林對話	Talk to Supply Soldier Delyn	보급병 델린과 대화
消滅攻擊過來的魔族及怪物	Defeat the incoming demons and monsters	공격해 오는 마족과 몬스터 처치하기
戰鬥準備	Preparing for Battle	전투 준비
與副隊長達爾倫對話	Talk to Assistant Commander Talon	부대장 탈른과 대화하기
打敗幽茲薩爾高原的怪物	Defeat the monsters in Uzsaldi Plateau	우즈살디 고원에 있는 몬스터 처치
消滅在作戰地區的怪物	Clear out monsters around Uzsaldi Plateau	작전지역에 있는 몬스터 처치
在作戰地區設置木製柵欄	Set Up Wooden Fences on the Operation Grounds	작전 지역에 목책 설치
與士兵凱蘭斯對話	Talk to Soldier Callans	병사 칼란스와 대화
在幽茲薩爾高原下方收集黑色石頭	Collect Black Stones at the Uzsaldi Plateau	우즈살디 고원 아래쪽에서 검은 돌 수집
轉交給士兵凱蘭斯	Deliver to Soldier Callans	병사 칼란스에게 전달
在作戰地區設置炸彈	Setup the bombs at the Operation Site	작전 지역에 폭탄 설치
消滅肯陶洛斯	Defeat Centaurus	켄타우로스 처치
消滅伊布雷高原的魔族殘黨	Defeat the demon remnants at Ibre Plateau	이브레 고원에 있는 마족 잔당 처치
消滅魔族殘黨	Defeat the demon remnants	마족 잔당 처치
與嘉魅爾蘭對話	Talk to Jamelhan	자멜란과 대화
消滅攻擊營地的雪人	Defeat the attacking Yeti	캠프를 공격하는 예티 처치
作業失誤	Setbacks	업무 차질
消滅營地附近的怪物	Defeat monsters near the camp	캠프 근처에 있는 몬스터 처치
解決營地周邊的怪物	Defeat Monsters Near the Camp	캠프 주변에 있는 몬스터 처치
治療受傷的礦夫	Nurse the Wounded Miners	다친 광부 치료
用探測器搜索次元石	Search for the Dimensional Stone	탐지기로 차원석 광석 수색
法師突爾利斯的礦石調查	Wizard Tulis' Ore Research	위저드 튤리스의 광석 조사
和法師突爾利斯對話	Talk to Wizard Tulis	위저드 튤리스와 대화
收集藍色克洛紐特毒針術士的魔力結晶	Collect Blue Cronewt Needler Crystals	푸른 크로뉴트 독침술사의 마력 결정 수집
轉交給法師突爾利斯	Deliver to Wizard Tulis	위저드 튤리스에게 전달
到階梯丘陵下方調查並收集蘊含魔力的石頭	Investigate the stones south of Stairway Knoll and collect the Magic Stones	계단 구릉 아래쪽의 바위를 조사해 마력이 깃든 돌 수집
收集變換的怪物精髓	Collect Monster Essence	변환된 몬스터의 정수 수집
和法師突爾利斯對話	Talk to Wizard Tulis	위저드 튵러스와 대화
收集提尼的唾液腺	Collect Tini Salivary Glands	티니의 침샘 수집
調查被詛咒的雕像	Investigate the Cursed Statue	저주 받은 조각상 조사
找到知情的人與他對話	Talk to Someone	알 만한 사람을 찾아서 대화
村莊的詛咒	Village Curse	마을에 걸린 저주
和村莊祭司凱拉依默斯對話	Talk to Village Priest Chaleims	마을 사제 칼레임스와 대화
和村莊居民阿勒基斯對話	Talk to Villager Argis	마을 주민 아르기스와 대화
在德貝尤堤絕壁收集黑色石頭	Collect Black Stones in Dvejoti Cliff	드베요티 절벽에서 검은 돌 수집
轉交給村莊居民阿勒基斯	Deliver to Villager Argis	마을 주민 아르기스에게 전달
在監視晶球上設置炸彈並破壞晶球	Use the Bomb to Destroy the Surveillance Sphere	감시의 구에 폭탄을 설치하여 파괴
收集雪白地鼠獸的精髓	Collect White Spion Essence	하얀 스피온의 정수 수집
轉交給村莊祭司凱拉依默斯	Deliver to Village Priest Chaleims	마을 사제 칼레임스에게 전달
請用探知水晶尋找神聖力	Find Divine Energy with the Detection Orb	탐지 구슬을 사용해 신성력 찾기
尋找村莊祭司亞倫塔斯	Search for Village Priest Arntas	마을 사제 아른타스 수색
保護村莊祭司凱拉依默斯	Protect Village Priest Chaleims	마을 사제 칼레임스 보호
破壞被詛咒的雕像	Destroy the Cursed Statue	저주 받은 조각상 파괴
與村莊居民德亞伊蘭對話	Talk to Villager Deailan	마을 주민 드아일란과 대화
收集席克里兒草	Collect Sikljien Herbs	시클리엔 풀 채집
轉交給村莊居民德亞伊蘭	Deliver to Villager Deailan	마을 주민 드아일란에게 전달
與村莊居民艾密斯對話	Talk to Villager Emils	마을 주민 에밀스와 대화
解決村莊周圍的怪物	Defeat Monsters Near the Village	마을 주변에 있는 몬스터 처치
被詛咒的雕像們	Cursed Statues	저주 받은 조각상들
以淨化之珠破壞被詛咒的雕像	Destroy the Cursed Statues with the Purification Sphere	정화의 구로 저주 받은 조각상 파괴
為淨化之珠填入神聖力	Charge the Purification Sphere with Divine Energy	정화의 구에 신성력 충전
關閉被詛咒的雕像周圍的魔法裝置	Disable the Magic Devices Around the Statue	저주 받은 조각상 주변의 마법장치 끄기
消滅茲巴卡石堆的魔族及怪物	Defeat the Demons and Monsters in Zvaghas Stone	즈바가스 돌무지의 마족과 몬스터 처치
消滅雷班札特	Defeat the Lavenzard	래밴자드 처치
卡杜梅爾絕壁的祭壇群	The Altars of Kadumel Cliff	카듀멜 절벽의 제단들
觀察祭壇	Investigate the Altar	제단 살펴보기
消滅祭壇周圍的怪物	Defeat Monsters Around the Altar	제단 주변에 있는 몬스터 처치
清除邪惡氣息	Clear Out the Concentrated Evil Energy	사악한 기운 덩어리 제거
後退	Retreat	후퇴
和士兵安德雷對話	Talk to Soldier Andre	병사 안드레와 대화
消滅攻過來的魔族	Defeat the Attacking Demons	공격해 오는 마족 처치하기
移動到副隊長必拉斯所在的席梅克菈基地	Go to Smekla Base and Find Assistant Commander Vilas	부대장 빌라스가 있는 스메클라 기지로 이동
消滅魔族及怪物	Defeat the Demons and Monsters	마족과 몬스터 처치
與副隊長必拉斯對話	Talk to Assistant Commander Vilas	부대장 빌라스와 대화
與勒姆迪緹作業場的偵查兵寶亞斯對話	Talk to Scout Boas at the Lamdyti Workshop	람디티 작업장의 정찰병 보아스와 대화
與偵查兵寶亞斯對話	Talk to Scout Boas	정찰병 보아스와 대화
收集黑色石頭	Collect Black Stones	검은 돌 수집
破壞可疑的魔法裝置	Destroy the Suspicious Magic Device	수상한 마법 장치 파괴
消滅攻過來的圖拉漢	Defeat the Dullahan	공격해오는 듀라한 처치
破壞魔族的裝置	Destroy the Demons' Device	마족의 장치 파괴
觀察魔族裝置	Investigate the Demons' Device	마족 장치 살펴 보기
在席梅克菈基地找找能拿來破壞裝置的東西	Search for Objects to Destroy the Device at Smekla Base	스메클라 기지에서 장치를 파괴할 만한 물건 수색
用炸彈破壞魔族裝置	Destroy the Demon Device with the Bomb	폭탄으로 마족 장치 파괴
回到過去	Back in time	시간을 거슬러
碑石路的時空操控者大師，似乎在等待他人的幫助。	The Chronomancer Master is waiting for someone's help at Stele Road	비석로의 크로노맨서 마스터가 누군가의 도움을 기다리고 있습니다
使用潔戈媞女神的水晶	Use Goddess Gegute's crystal	제거티 여신의 수정 사용
時空操控者大師說，利用潔戈堤女神的水晶，調查過去在周圍發生的事件。	The Chronomancer Master advised to use Goddess Gegute's crystal to see what happened in the surrounding area	크로노맨서 마스터는 제거티 여신의 수정을 사용하여 주변에서 일어난 과거의 사건을 살펴보라고 했습니다
進入地瑪蘇高特	Entering Zima Suecourt	지마 수코트 진입
清除魔力球碎片	Removing Orb fragments	마력구 파편 제거
收集時間的魔力	Collect Time magic	시간의 마력 수집
請破壞魔力觀測站周邊的魔力裝置並收集時間魔力。	Destroy the magic devices near the Magic Observatory and collect Time Magic	마력 관측소 주변의 마력 장치를 파괴하고 시간 마력을 수집하세요.
躲過怪物使用潔戈媞女神的水晶	Use Goddess Gegute's crystal while avoiding the monsters	몬스터를 피해 제거티 여신의 수정을 사용
消滅中了魔力毒的怪物	Deal with the monsters in the surrounding area	마력에 중독된 몬스터 처치
確認時間萬花筒	Check the Kaleidoscope of Time	시간의 만화경 확인
快速移動	Swift Movement	빠른 이동
確認迪比利斯制馭所魔力源	Check the Devries Controller Spell Source	디브리스 제어소 마력원 확인
請確認迪比利斯制馭所魔力源	Go and check the Devries Controller Spell Source	디브리스 제어소 마력원을 확인하세요
收集魔力的精髓	Collect Magic Essence	마력의 정수 수집
啟動迪比利斯制馭所魔力源	Activate the Devries Controller Spell Source	디브리스 제어소 마력원 가동
確認中央研究室魔力源	Check the Central Laboratory's Magic Source	중앙연구실 마력원 확인
請確認中央研究室魔力源	Go and check the Central Laboratory's Magic Source	중앙연구실 마력원을 확인하세요
收集稀微的魔力動力源	Collect faint magic sources	희미한 마력 동력원 수집
啟動中央研究室魔力源	Activate the Central Laboratory's Magic Source	중앙연구실 마력원 가동
確認研究者聚會所魔力源	Check the Researcher Auditorium's Magic Source	연구자 공회당 마력원 확인
請確認研究者聚會所魔力源	Go and check the Researcher Auditorium's Magic Source	연구자 공회당 마력원을 확인하세요
啟動研究者聚會所魔力源	Activate the Researcher Auditorium's Magic Source	연구자 공회당 마력원 가동
與貴金屬收集家對話	Talk to the Jewelry Collector	귀금속 수집가와 대화
收集動力	Collect Power	동력 수집
活化內城壁觀測器	Activate the Device at the Inner Wall	내성벽 관측기 활성화
泰芙林 鐘乳洞 1區域魔力收集	Collect Magic at the Tevhrin Stalactite Cave Section 1	테브린 종유동 1구역의 마력 수집
收集老舊的工具	Collect Old Tools	오래된 도구 수집
附魔師大師對話	Talk with the Enchanter Master	인챈터 마스터와 대화
開啟雷斯勃伊湖邊的寶物箱子	Open the Rasvoy Lake Treasure Chest	래스보이 호숫가의 보물상자 열기
破壞變形的樹根水晶	Destroy the Mutated Tree Root Crystals	변형된 나무뿌리 수정 파괴
收集濃縮魔力的角	Collect Magic Horns	마력이 농축된 뿔 수집
開啟帕馬勒森林的寶物箱子	Open the Phamer Forest Treasure Chest	파마르 숲의 보물상자 열기
收集洞窟膽汁	Collect Cave Sap	동굴 담즙 수집
地瑪蘇高特觀測器活化	Activate the Device at Zima Suecourt	지마 수코트 관측기 활성화
觀測馬勒托斯貯藏室的魔力	Investigate the Martuis Storage Room	마르튀스 저장실의 마력 관측
請破壞皮斯堤斯森林變形的樹根水晶	Destroy the Mutated Tree Root Crystals of Pystis Forest	피스티스 숲의 변형된 나무뿌리 수정 파괴하세요
開啟諾貝禮爾森林的寶物箱子	Open the Nobreer Forest Treasure Chest	노브리어 숲의 보물상자 열기
啟動指定的神壇	Activate only the designated shrines	지정된 신단만을 활성화
收集湛藍夏烏爾拉伯面具	Collect the masks of Blue Siaulavs	푸른 샤울라브 가면 수집
與異地居民馬克對話	Talk to Outsider Mark	타지 주민 마크와 대화
從提尼身上收集發光的提尼的角	Collect Shiny Tini Horns from the Tinis	티니에게서 빛나는 티니의 뿔 수집
與朝聖者伐利亞對話	Talk to Pilgrim Phylia	순례자 필리아와 대화
採摘塔奧瑪斯藥草	Gather Taumas Herbs	타우마스 약초 뜯기
老弱者優先	Being Considerate to Elders	노약자 배려
與朝聖者雅各對話	Talk to Pilgrim Jacob	순례자 제이콥과 대화
從里烏汀荒野的提尼身上找回雅各的遺失行李	Find Jacob's lost baggage from the Tinis at Rjudin Wilderness	리우딘 황야의 티니에게서 제이콥의 잃어버린 짐을 찾기
尋找堅固的樹枝	Find a Sturdy Branch	튼튼한 나뭇가지 구하기
與朝聖者雅各一同前往莎爾比亞斯森林	Go with Pilgrim Jacob towards Salvia Forest	순례자 제이콥과 함께 살비야스 숲 방면으로 이동
與朝聖者布列德對話	Talk to Pilgrim Brad	순례자 브래드와 대화
狩獵提尼收集肉	Collect Tini meat	티니를 사냥하여 고기를 수집
與朝聖者安潔拉對話	Talk to Pilgrim Angela	순례자 안젤라와 대화
與朝聖者布列德一起去打來井水	Get water from the well with Pilgrim Brad	순례자 브래드와 함께 우물물 길어오기
在巴巴爾拉斯空地收集燃料用樹木	Collect Firewood from Vabalas Vacant Lot	바발라스 공터에서 땔감용 나무 수집
與修道士艾丹對話	Talk to Monk Ethan	수도사 에단과 대화
消滅莎爾比亞斯森林方向周圍的怪物	Defeat monsters on the road to Salvia Forest	살비야스 숲 방면 주변의 몬스터 처치
消滅莎爾比亞斯森林方向的怪物	Defeat the monsters on the way to Salvia Forest	살비야스 숲 방면의 몬스터 처치
與朝聖者約旦對話	Talk to Pilgrim Jhodan	순례자 요단과 대화
獵捕赤紅地鼠獸收集皮革	Defeat the Red Spion and gather their hides	붉은 스피온을 사냥하고 가죽 모으기
與朝聖者黛安對話	Talk to Pilgrim Diane	순례자 다이앤과 대화
收集莎爾比亞斯樹叢的果實	Collect berries from Salvia Brambles	살비야스 덤불의 열매를 모으기
與朝聖者貝里對話	Talk to Pilgrim Barry	순례자 배리와 대화
消滅朝聖者貝里附近的怪物	Defeat monsters near Pilgrim Barry	순례자 배리 근처의 몬스터 처치
與信徒布魯特斯對話	Talk to Believer Brutus	신도 브루투스와 대화
帶信徒克拉克去找倒下的朝聖者	Lead Believer Clark to the fallen Pilgrim	신도 클라크를 쓰러진 순례자들에게 인도하기
與信徒克拉克對話	Talk to Believer Clark	신도 클라크와 대화
對黑色氣息的赤紅地鼠獸進行藥物測試	Test the medicine on the Red Spion emitting a black aura	검은 기운의 붉은 스피온에게 약을 시험하기
露出馬腳	Showing True Colors	마각이 드러나다
與信徒克拉克一起跟蹤布魯特斯	Follow Brutus with Believer Clark	신도 클라크와 함께 브루투스 미행
消滅變成魔族的布魯特斯	Defeat Brutus who has become a Demon	마족으로 변한 브루투스 처치
消滅被召喚的魔族	Defeat the summoned Demon	소환된 마족 처치
跟著前往布魯特斯去的地方	Retrace Brutus's path	브루투스가 향한 곳을 뒤따라가기
收集易燃樹葉	Collect flamable leaves	잘 타는 나뭇잎 모으기
消滅莎爾比亞斯森林的怪物	Defeat the monsters in Salvia Forest	살비야스 숲의 몬스터 처치
與朝聖者巴德斯對話	Talk to Pilgrim Vados	순례자 바도스와 대화
與修道士多勒馬對話	Talk to Monk Dorma	수도사 도르마와 대화
解開其他朝聖者們的疑心	Lift the suspicions from the other pilgrims	다른 순례자들의 의심을 풀기
與朝聖者大衛對話	Talk to Pilgrim David	순례자 데이비드와 대화
尋找證明多勒馬是修道士的方法	Find a way for Dorma to prove that she is a monk	도르마가 수도사임을 증명할 방법 찾기
與朝聖者依萊伊對話	Talk to Pilgrim Eli	순례자 일라이와 대화
找出修道士多勒馬的聖水	Find Monk Dorma's Holy Water	수도사 도르마의 성수 찾기
確認朝聖者多勒馬的聖水	Check Monk Dorma's Holy Water	순례다 도르마의 성수를 확인
與朝聖者喬治對話	Talk to Pilgrim George	순례자 조지와 대화
在金卡拉斯蘆葦田收集丟棄的植物球莖	Collect discarded Plant Roots from Gingkaras Reed Field	깅카라스 갈대밭에서 버려진 식물 구근 모으기
與修道士多勒馬一同前往莫巴荒野	Moving to Mova Wilderness with Monk Dorma	수도사 도르마와 함께 모바 황야로 이동
消滅魔族暗殺者	Defeat the Demon Assassin	마족 암살자 처치
在莫巴荒野與朝聖者巴德斯見面	Meet Pilgrim Vados at Mova Wilderness	모바 황야에서 순례자 바도스와 만남
消滅克里那斯森林小路方向的怪物	Defeat the monsters on the road to Grynas Trails	그라나스 숲길 방향 몬스터 처치
收集雷普斯兔子的肉	Collect Lepusbunny Meat	레푸스버니의 고기 수집
消滅黃色杜瑪洛	Defeat Yellow Dumaro	노란 듀마로 처치
救出被魔族追趕的修道士	Rescue the Monk being chased by Demons	마족에게 쫓기는 수도사 구출
與修道士史黛拉對話	Talk to Monk Stella	수도사 스텔라와 대화
消滅襲擊修道士的魔族	Defeat the Demon attacking the Monk	수도사를 습격한 마족 처치
從修道士的墓中尋找魔法道具	Find Magical Equipment from the Monk's grave	수도사에 무덤에서 마법 도구 찾기
在凱特拉墓地尋找修道士的遺物	Find the Monk's Keepsake at Ketra Cemetery	케트라 묘지에서 수도사의 유품 찾기
用怪物的生命力補充鏡子的魔力	Fill the Mirror with the life energy or monsters	몬스터의 생명력으로 거울의 마력을 채우기
與修道士史黛拉前往朝聖者營地	Go with Monk Stella to the Pilgrim Camp	수도사 스텔라와 순례자 캠프로 가기
向沒力氣的朝聖者收集情報	Collect information from the drained pilgrims	기운없는 순례자들에게서 정보 수집
破壞席尼克特空地的黑色水晶	Destroy the Black Crystal at Shinikti Vacant Lot	쉬니크티 공터의 검은 수정 파괴
消滅魔族利泰力斯	Defeat High Officer Domantas	마족 리테리스 처치
消滅幹部都曼塔斯	Defeat High Officer Domantas	간부 도만타스 처치
調查隱者之墓	Examing Hermit's Tomb	은자의 무덤 조사하기
在隱者之墓破壞神聖力抑制裝置	Destroy the Divine Power Suppression Device at the Hermit's Tomb	은자의 무덤에서 신성력 억제장치 파괴
收集歐阿瑟之樹的樹液	Retrieve Oasseu Tree's Sap	오아쓰 나무의 수액 뜨기
與修道士馬達斯對話	Talk to Monk Mattas	수도사 마타스와 대화
帶馬達斯去見史黛拉	Take Mattas to Stella	마타스를 스텔라에게 데려다주기
在里埃卡菲原野破壞神聖力抑制裝置	Destroy the Divine Power Suppression Device at Rijekavi Fields	리에카비 벌판에서 신성력 억제 장치 파괴
與修道士馬達斯對話後收集歐阿瑟之樹的樹液	Collect Oasseu Tree Sap after talking to Monk Mattas	수도사 마타스와 대화 후 오아쓰 나무의 수액 수집
對克拉夏丘陵的裝置使用卷軸	Use the scroll on the Device at Krasjia Hills	크라샤 언덕의 장치에 스크롤 사용
與修道士馬達斯商議過後準備歐阿瑟之樹的樹液並調查克拉夏丘陵的裝置	Prepare Oasseu Tree Sap after discussing with Monk Mattas before going to examine the Device at Krasjia Hill	수도사 마타스와 상의 후 오아쓰 나무의 수액을 준비하여 크라샤 언덕의 장치 조사
對神聖力抑制裝置使用卷軸	Use the scroll on the Divine Power Suppression Device	신성력 억제 장치에 스크롤 사용하기
請對克拉夏丘陵的裝置使用卷軸。	Use the scroll on the Device at Krasjia Hill	크라샤 언덕의 장치에 스크롤을 사용해 보세요.
消滅曼德亞喚來的魔族	Defeat the Demons summoned by Medea	메데야가 불러낸 마족들 처치
與幹部曼德亞對話	Talk to High Officer Medea	간부 메데야와 대화
消滅幹部曼德亞的部下	Defeat High Officer Medea's minions	간부 메데야의 부하 처치
拉曼德亞去見馬達斯	Take Medea to Mattas	메데야를 마타스에게 끌고 가기
救出修道士史黛拉	Rescue Monk Stella	수도사 스텔라 구출
收集神聖力抑制裝置的碎片	Collect Divine Power Suppression Device's Fragments	신성력 억제 장치의 파편 수집
調查無名修道士的墓碑	Examine the Unnamed Monk's Tombstone	무명수도사의 묘비를 조사
消滅誓約紀念地的魔族	Defeat the demons at Oasseu Memorial	오아쓰 기념지의 마족 처치
掃蕩修道院正門前的敵人	Defeat the enemies in front of the abbey	수도원 정문 앞의 적을 소탕
調查門口	Investigate the area in front of the door	문 앞을 조사
護衛史黛拉到光榮禮堂前	Guard Stella to the Hall of Honor	영광의 홀 앞까지 스텔라 호위
與史黛拉一同在書庫找書	Find a book in the Library with Stella	스텔라와 함께 서고에서 책 찾기
保護正在看書的史黛拉	Protect Stella while she is reading	책 읽는 스텔라를 지키기
消滅攻擊史黛拉的怪物	Defeat the monsters attacking Stella	스텔라를 공격하는 몬스터 처치
在聖水盤尋找寶珠	Find an orb near the stoup	성수반에서 보주 찾기
保護正在凝聚神聖力的史黛拉	Protect Stella while she is gathering divine power	신성력을 모으는 스텔라를 지키기
消滅幹部德伊曼塔斯	Defeat High Officer Deimantas	간부 데이만타스 처치
消滅變身成藍色利泰力斯的幹部德依曼塔斯 	Defeat High Officer Deymantas Transformed into a Blue Riteris	푸른 리테리스로 변신한 간부 데이만타스 처치
收集不錯的食材	Collect Edible Food	멀쩡한 식재료 모으기
收集祈禱室的藥草	Collect Herbs from the Prayer Room	기도실의 약초 수집
消滅修道院的魔族	Defeat the demons in the abbey	수도원의 마족 처치
消滅殘餘的赤紅努歐	Defeat the remaining Red Nuo	남아있는 붉은 누오 처치
與夏亞汀的靈魂對話	Talk to the Soul of Hayatin	하야틴의 영혼과 대화
消滅藍色提努和藍色圖約勒	Defeat blue tanus and doyors	푸른 타누와 푸른 도요르 처치
調查卡雷伊比納斯丘陵	Investigate Carejvnes Hill	카레이비네스 언덕을 조사
消滅黃色波利普	Defeating Yellow Polibu	노란 폴리부 처치하기
與維多拉斯的靈魂對話	Talk to the soul of Victoras	빅토라스의 영혼과 대화
收集廢墟殘骸設立簡易慰靈碑	Erect a makeshift memorial monument by collecting the rubbles of the ruins	폐허의 잔해를 모아 간이 위령비 세우기
帶領靈魂們到慰靈碑前	Lead the souls to the memorial monument	위령비 앞으로 영혼들을 인도
燃燒蕨葉堆尋找刻著標誌的石頭	Burn the bracken pile to find the rock with the insignia	고사리 더미를 태워 표식이 새겨진 돌을 찾기
打開文件盒	Open the document box	문서함을 열어보기
潔白的證據	Proof of Innocence	결백의 증거
使用結晶化的魔石尋找鑰匙	Use the crystalized magic stone to find the key	결정화된 마석을 사용해 열쇠를 찾기
在柯拉佩達與雷那對話	Talk to Lena in Klaipeda	클라페다에서 레나와 대화
與鍊金術士蘇菲亞	Talk with Alchemist Sophia	알케미스트 소피야와 대화
消滅紅色魔力鴨	Defeat red ducky	붉은 더키를 처치
破壞紅色魔力鴨的巢	Destroy the egg nest of red ducky	붉은 더키의 알둥지를 파괴
收集蕨葉孢子囊	Collect Yega Bracken Spores	예가 고사리의 포자낭 수집
弱化藍色摩格蘭後催眠牠	Weaken and make blue moglans asleep	푸른 모글란을 약화시킨 후 잠재우기
把藥混入藍色摩格蘭的飼料裡面	Mix the chemical in the food pile for blue moglans	푸른 모글란의 먹이에 약물 섞기
收集亞斯特羅斯藥草	Collect Astrus Herbs	아스트러스 약초 수집
效果驚人	Effect Too Strong	효과가 지나쳤다
在肯陶洛斯附近燃燒亞斯特羅斯藥草	Burn Astrus Herbs around Centaurus	켄타우로스 주위에서 아스트러스 약초 태우기
到肯陶洛斯那裡去	Go to Centaurus	켄타우로스에게 가기
消滅肯陶洛斯後收集水晶	Collect crystals from Centaurus	켄타우로스를 처치하고 수정을 수집
在塞恩特里尼斯原野的土中混和粉塵	Mix Centaurus dust into the dirt of Centrynis Field	센트리니스 벌판의 흙에 분진 뒤섞기
收集乾枯的蕨類葉子與藍色畢托爾的翅膀	Collect wings of blue beetows and dried out brackens	바싹 마른 고사리 잎과 푸른 비토우의 날개 수집
與調查隊長艾爾拉對話	Talk with Investigation Team Head Ella	조사대장 엘라와 대화
收集甕裡的羊皮紙	Retrieve the parchment from the pot	항아리에서 양피지 수집
消滅綠色哥布林回收羊皮紙	Retrieve the parchment from green goblins	초록 고블린을 처치하고 양피지 회수
收集被汙染的樹根汁液	Extract Juice from Contaminated Tree Root	오염된 나무뿌리 즙 수집
在顯眼的地方放置假的羊皮紙	Place false parchment on somewhere noticeable	눈에 띄는 곳에 가짜 양피지 놓기
消滅周圍的哥布林	Defeat nearby goblins	주변의 고블린 처치
消滅覬覦這羊皮紙的元凶	Eliminate the culprit seeking the parchment	양피지를 탐하는 원흉 처리
與調查員凱斯柏對話	Talk with Gasper	조사원 개스퍼와 대화
收集狀況完好的書本	Collect the relatively-undamaged books	아직 온전한 책 수집
從綠色哥布林劍士和突擊兵身上回收遺物	Retrieve keepsakes from green goblin warriors and chargers	초록 고블린 전사와 돌격병에게서 유품 회수
玄找調查隊隱藏在鐘擺內的遺物	Use the Investigation Team Pendulum to find the hidden artifact	조사대 펜듈럼으로 숨겨진 유물 찾기
在鐘擺反應處挖出隱藏的遺物	Dig up the relic from the area detected by the pendulum	펜듈럼이 반응하는 곳에서 숨겨진 유물 파내기
與調查員戶萊以修對話	Talk to Investigator Horatio	조사원 호레이쇼와 대화
去尋找夢魘洞窟	Get the strong vines	질긴 덩굴 구해오기
收集哥布林咒術師的寶石	Collect the Goblin Shaman's Jewels	고블린 주술사의 보석 모으기
消滅周圍的綠色哥布林	Defeat nearby green goblins	주변의 초록 고블린 처치
與暗影師大師對話	Talk with the Shadowmancer Master	섀도우맨서 마스터와 대화
進行暗影適應訓練	Starting Shadow Adaptation Training	그림자 적응 훈련을 진행
與村民奈拉對話	Talk with Villager Nella	마을 주민 넬라와 대화
擊退納漢斯森林的怪物 	Defeat the monsters at Nahash Forest	나하스 숲 몬스터 처치
聽祭司多米尼卡斯傳教	Listen to the sermon of Priest Dominikas	사제 도미니카스의 설교 듣기
祭司多米尼卡斯會訴說有關真理之樹教團的教理。請聽多米尼卡斯傳教。	Listen to the preach of Priest Dominikas	사제 도미니카스가 진리의 나무교단의 교리에 대해 설교하겠다고 합니다. 도미니카스의 설교를 들어보세요.
偏離的信仰	Wrong Faith	어긋난 신앙
用魔族的靈魂來填滿靈魂珠	Fill the soul beads with the spirits of the demons	마족의 영혼으로 영혼 구슬 채우기
與村民鄧肯對話	Talk with Villager Duncan	마을 주민 던컨과 대화
與村民鄧肯一起移動至貝伊拉斯大廳	Move to Veyrhas Hall with Villager Duncan	마을 주민 던컨과 함께 베이라스 홀로 이동
與村民詹姆斯對話	Talk to Villager James	마을 주민 제임스와 대화
收集魔族的紅血	Collect Demon's Red Blood	마족의 붉은 피 수집
交給村民詹姆斯	Deliver it to Villager James	마을 주민 제임스에게 전달
卑劣的伎倆	Dirty Tricks	비열한 술수
搜查黑牆那端的分館研究室	Inspect the Annex Laboratory beyond the Black Wall	검은 벽 너머 별관 연구실 수색
往總館通道移動	Move to the Principal Corridor	본원 통로로 이동
參觀多米尼卡斯的儀式	Attend Dominikas' ritual	도미니카스의 의식 참관
移動至艾高斯修道院總館	Go to the Elgos Abbey Main Building	엘고스 수도원 본원으로 이동
回收假經典	Retrieve the fake scripture	거짓된 경전 회수
飢渴的信仰	Hungry Faith	굶주린 신앙
搜索糧食	Find edible food	먹을 만한 식량 수색
將糧食交給修道士艾高斯	Give the food to the Elgos Monk	엘고스 수도사에게 식량 전달
去找艾高斯修道院院長	Move to the Elgos Abbot	엘고스 수도원장에게 이동
魔族的墮落靈魂	Demon's Fallen Soul	마족의 타락한 영혼
與艾高斯修道院院長對話	Talk to the Elgos Abbot	엘고스 수도원장과 대화
收集魔族的靈魂	Collect Demon Souls	마족의 영혼 수집
擊退魔族後吸收其靈魂	Defeat the demons and absorb their souls	마족 처치 후 영혼 흡수
向聖水祭司大師購買聖水	Purchase Holy Water from the Priest Master	프리스트 마스터에게 성수 구매
將聖水交給艾高斯修道院院長	Give the Holy Water to the abbot	엘고스 수도원장에게 성수 전달
破壞邪惡的神像	Destroy the Sinister Idol	사악한 우상 파괴
為了全然的自由	For Total Freedom	완전한 자유를 위해
移動至帕卡勒瑪禮拜堂	Move to the Pagarba Chapel	파가르마 예배소로 이동
擊退艾高斯修道院總館的魔族	Defeat the demons in the Elgos Abbey Main Building	엘고스 수도원 본원 마족 처치
擊退魔族並吸收其墮落的靈魂	Defeat the demons and absorb their fallen souls	마족을 처치하고 타락한 영혼 흡수
吸收魔族墮落的靈魂	Absorb the demons' fallen souls	마족의 타락한 영혼 흡수
邪惡的魔法陣?	Evil Magic Circles?	사악한 마법진?
貝拉沿岸搜索	Search Vera Coast	베라 연안 수색
搜索其它魔法陣	Search for other magic circles	다른 마법진 수색
尋找清除魔法陣的方法	Find a way to destroy the magic circles	마법진을 없앨 방법 찾기
尋找清除魔法陣的其它方法	Find another way to destroy the magic circles	마법진을 없앨 다른 방법 찾기
尋找破壞魔法陣的其它方法	Find another way to destroy the magic circles	마법진을 파괴할 다른 방법 찾기
試著拋擲珊瑚角碎片	Throw a piece of Coral Horn	산호 뿔 조각 던져보기
再搜索其它魔法陣	Search for more magic circles	또 다른 마법진 수색
和卡巴拉魯塔斯對話	Talk to Kabbalist Lutas	카발리스트 루타스와 대화
和卡巴拉魯塔斯一起往魔法陣移動	Go to the Magic Circle with Kabbalist Lutas	카발리스트 루타스와 마법진으로 이동
吸收大地氣息	Gather Earth Energy	대지의 기운 흡수
回去找卡巴拉魯塔斯	Return to Kabbalist Lutas	카발리스트 루타스에게 돌아가기
吸收調和氣息	Gather Balancing Energy	조화의 기운 흡수
吸收海洋氣息	Gather Sea Energy	바다의 기운 흡수
保護魯塔斯	Protect Lutas	루타스 보호
調和魔法陣	Balancing Magic Circle	조화의 마법진
前往最後魔法陣，移動至巴赫空地	Go to the Bachl Vacant Lot for the Last Magic Circle	마지막 마법진을 향해 바흘 공터로 이동
在魔法陣上灌入調和氣息	Add balancing energy to the magic circle	마법진에 조화의 기운 불어넣기
收集大地氣息	Gather Earth Energy	대지의 기운 모아오기
為保護而進行的束縛	Restrain to Protect	보호를 위한 속박
製作束縛魔法陣	Create a Binding Magic Circle	구속 마법진 만들기
探索危險的束縛魔法陣	Search for Dangerous Binding Magic Circles	위험한 구속 마법진 탐색
與莎勒斯修女院的修女雅伊斯特對話	Talk to Sister Aiste at the Saalus Convent	살러스 수녀원의 수녀 아이스테와 대화
與村長普雷傑對話	Talk to Mayor Frege	촌장 프레제와 대화
與商人西摩那斯對話	Talk to Merchant Simonas	상인 시모나스와 대화
掃蕩露烏比克珊瑚礁的怪物	Sweep the monsters of the Lhu'uvik Coral Reef	루우빅 산호초의 몬스터 소탕
向商人西摩那斯報告	Report to Merchant Simonas	상인 시모나스에게 보고
向難民們收集情報	Gather intel from the refugees	난민들에게 정보 수집
調查克蘭托沿岸散發奇怪氣味的地方	Inspect the spot with a strange smell on Cranto Coast	크란토 연안의 이상한 냄새가 나는 지점 조사
告知商人西摩那斯	Deliver it to Merchant Simonas	상인 시모나스에게 전달
在露烏比克珊瑚礁搜查可疑的袋子	Find the Suspicious Pouches from the Lhu'uvik Coral Reef	루우빅 산호초에서 수상한 주머니 수색
潛伏於露烏比克珊瑚礁，直到犯人出現	Stake out in the Lhu'uvik Coral Reef until the perpetrator shows up	범인이 나타날 때까지 루우빅 산호초에서 잠복
清除克蘭托沿岸剩下的袋子	Remove the remaining pouches on the Cranto Coast	크란토 연안에 남아있는 주머니 제거
將怪物引誘至可疑的袋子那兒	Lure the monsters to the suspicious pouch	수상한 주머니로 몬스터 유인
擊退被氣味引來的怪物	Defeat the lured monsters	냄새에 이끌려 몰려든 몬스터 처치
向商人佩里西亞詢問有關珊瑚的事	Ask Merchant Felicia about the corals	상인 펠리시아에게 산호에 대해 묻기
搜查阿勒琳珊瑚的棲息地	Inspect the habitat of Arnim Coral	아르님 산호의 서식지 수색
與商人佩里西亞對話	Talk to Merchant Felicia	상인 펠리시아와 대화
與難民艾爾尤斯對話	Talk to Refugee Elius	난민 앨리유스와 대화
交給難民艾爾尤斯	Deliver them to Refugee Elius	난민 앨리유스에게 전달
用魔力探測器搜索能打開箱子的工具	Use the Magic Searching Stone to find a tool to open the box	마력 탐지기로 상자를 열 수 있는 도구 수색
交給商人佩里西亞	Deliver it to Merchant Felicia	상인 펠리시아에게 전달
與雕刻師亞捷爾對話	Talk to Dievdirbys Asel	딥디르비 아젤과 대화
尋找查里亞賓溪谷的貓頭鷹雕像	Find the Zaliavin Valley Owl Sculpture	잘리아빈 계곡의 부엉이 조각상 찾기
雕像有什麼事?	What Happened to the Statues?	조각에 무슨 일이?
與沉睡的貓頭鷹雕像對話	Talk to the Sleeping Owl Sculpture	잠든 부엉이 조각상과 대화
保護雕刻師亞捷爾	Protect Dievdirbys Asel	딥디르비 아젤을 보호
收集雕刻師亞捷爾委託的材料	Collect Materials for Dievdirbys Asel	딥디르비 아젤이 부탁한 재료 수집
轉交給雕刻師亞捷爾	Deliver to Dievdirbys Asel	딥디르비 아젤에게 전달
採集黃色薩普斯	Collect Yellow Sapous	노란 사푸스 채집
掃蕩前往米葛蘭丘陵路上的怪物	Clear Out Monsters on the Way to Miglos Hill	미글랑 언덕으로 가는 길의 몬스터 소탕
移動到米葛蘭丘陵的貓頭鷹雕像	Go to the Owl Sculpture in Miglos Hill	미글랑 언덕의 부엉이 조각상으로 이동
掃蕩米葛蘭丘陵的怪物	Clear out Monsters in Miglos Hill	미글랑 언덕의 몬스터 소탕
和在庫波堤領的吵鬧的貓頭鷹雕像對話	Talk to the Raucous Owl Sculpture in Skardus Hill	쿠보티 고개에 있는 떠들썩한 부엉이 조각상과 대화
和吵鬧的貓頭鷹雕像對話	Talk to the Raucous Owl Sculpture	떠들썩한 부엉이상과 대화
收集保護的水晶的材料	Collect Materials for the Protective Crystals	보호의 수정 재료 수집
轉交給吵鬧的貓頭鷹雕像	Deliver to the Raucous Owl Sculpture	떠들썩한 부엉이 조각상에게 전달
與吵鬧的貓頭鷹雕像對話	Talk to the Raucous Owl Sculpture	떠들썩한 부엉이 조각상과 대화
在沉睡的貓頭鷹雕像附近放置保護的水晶	Place the Crystals by the Sleeping Statues	잠든 부엉이 주변에 수정 놓아두기
掃蕩沉睡的貓頭鷹雕像附近的怪物	Clear Out Monsters Around the Sleeping Owl Sculptures	잠든 부엉이 조각상 인근의 몬스터 소탕
消滅沉睡的貓頭鷹雕像附近的怪物	Defeat Monsters Around the Sleeping Owl Sculptures	잠든 부엉이 조각상 인근의 몬스터 처치
與貝勃堤交叉路的著急的貓頭鷹雕像對話	Talk to the Hasty Owl Sculpture at Bevertis Crossroads	베버티 교차로의 다급한 부엉이 조각상과 대화
與斷裂的道路的孤獨的貓頭鷹雕像對話	Talk to the Lonely Owl Sculpture on the Broken Path	끊어진 길에 있는 외로운 부엉이 조각상과 대화
和孤獨的貓頭鷹雕像對話	Talk to the Lonely Owl Sculpture	외로운 부엉이 조각상과 대화
尋找克魯布斯街道的貓頭鷹雕像	Find Owl Sculpture in Grubus Highway	그루부스 가도의 부엉이 조각상 찾기
收集淨化所需的材料	Collect the Materials for Purification	정화에 필요한 재료 수집
除去貓頭鷹雕像附近的邪惡氣息	Remove the Malicious Force Near Owl Sculpture	부엉이 조각상 인근의 사악한 기운 제거
在晶球中填入生命力	Charge the Orb with the Life Force	구슬에 생명력 충전하기
與修練生雷力德對話	Talk to Trainee Leryd	수련생 레리드와 대화
收集怪物露出特徵的部位	Collect the Part that Represts the Monster	몬스터의 특징을 나타내는 부위 수집
轉交給修練生雷力德	Deliever to Trainee Leryd	수련생 레리드에게 전달
與雕刻師魯托藍對話	Talk to Dievdirbys Ruthalen	딥디르비 루탈렌과 대화
在草堆中收集散發出特殊香味的果實	Gather Fruits with a Peculiar Scent from the Bush	풀더미에서 독특한 향이 나는 열매 수집
轉交給雕刻師魯托藍	Deliever to Dievdirbys Ruthalen	딥디르비 루탈렌에게 전달
消滅魯托藍引來的利迪梅得	Exterminate Ridimeds that Ruthalen lured	루탈렌이 유인한 리디메드 처치
找回遺失的雕刻刀	Find the Crafting Knife	잃어버린 조각칼 찾기
與雕刻師埃索爾對話	Talk to Dievdirbys Aisol	딥디르비 에솔과 대화
解決斷裂的道路附近的賽夸伊亞	Defeat Sequoia near the Broken Path	끊어진 길 근처의 세콰이아 처치
與雕刻師亞捷爾一同前往路瓦堤空地	Head down to Laukimo Vacant Lot with Dievdirbys Asel	딥디르비 아젤과 함께 로왁티 공터로 향하기
調查路瓦堤空地	Investigate Laukimo Vacant Lot	루왁티 공터 조사
調查散發邪惡氣息的可疑的草堆	Investigate the Suspicious Greenery for the Source of the Malicious Energy	사악한 기운이 뿜어져나오는 수상한 풀더미 조사
與夏奧雷伊西邊森林的雕刻家泰斯拉對話	Talk to Sculptor Tesla in the Siauliai West Woods	샤울레이 서쪽 숲에 있는 조각가 테슬라와 대화
淨化儀式的材料收集	Collect the Materials for Purification Ritual	정화 의식의 재료 수집
保護進行淨化儀式的亞捷爾遠離怪物	Protect Asel Who From the Monsters While Performing the Ritual	정화 의식 중인 아젤을 몬스터에게서 보호
與斯塔迪堤山麓上方的親切的貓頭鷹雕像對話	Talk to the Friendly Owl Sculpture on the upper side of Stabdymo Shore	스타디티 기슭 위쪽의 친절한 부엉이 조각상과 대화
填充微微光芒的晶球	Recharge the Faintly Glowing Orb	희미하게 빛나는 구슬 충전
驅趕親切的貓頭鷹雕像附近的怪物	Wipe Out the Monsters Around the Friendly Owl Sculpture	친절한 부엉이 조각상 인근의 몬스터 몰아내기
與安靜的貓頭鷹雕像對話	Talk to Quiet Owl Sculpture	조용한 부엉이 조각상과 대화
收集藍色南瓜精的葉子	Collect Blue Sakmoli Leaves	푸른 사크몰리의 잎사귀 수집
轉交給安靜的貓頭鷹雕像	Deliever to the Quiet Owl Sculpture	조용한 부엉이 조각상에게 전달
引導徬徨的靈魂	Guide the Lost Souls	방황하는 영혼 인도
向繼承者塔魯爾打聽關於繼承者的事	Listen to the tale of Loremasters from Loremaster Daroul	전승자 다룰에게 전승자에 관한 이야기 듣기
與信徒亞武努斯對話	Talk to Believer Jaonus	신도 야우뉴스와 대화
驅趕附近的怪物	Drive away nearby monsters	인근 몬스터 몰아내기
驅趕小豬克萊佛後收集克萊佛的核	Collect clamper cores by defeating pag clampers	페이그 클램퍼를 물리치고 클램퍼의 핵 수집
在棺內收集蘊含亡者之恨的遺物	Collect he dead's objects of resentment from the coffin	관에서 망자의 한이 서린 유품 수집
神聖或褻瀆	Sacred or Secular	성스럽거나, 불경하거나
與科斯塔斯對話	Talk to Costas	코스타스와 대화
收集被忘卻的教理本	Collect the scattered Doctrine	잃어버린 교리본 수집하기
取得藍色小豬多普的油後點燃營火	Light the campfire by obtaining oil from Green Pag Nurses	푸른 페이그 도퍼에게 기름을 얻어 모닥불에 불 붙이기
確認寫在牆上的內容	Check the inscription on the wall	벽에 적힌 내용 확인
柯拉佩達的聖水祭司大師對話	Talk with the Priest Master at Klaipeda	클라페다의 프리스트 마스터와 대화
到佩迪米安外圍去跟審判官拉爾瑪對話	Talk to Judge Rymis at the Fedimian Outskirts	페디미안 외곽의 심판관 라이미스와 대화
把緹玫勒斯寺院的邪教也驅趕走	Drive Away the Heretics At Tymeris Temple	티메리스 사원의 사교도 몰아내기
探索隱藏的房間	Inspect the Hidden Chamber	숨겨진 방 탐색
調查隱藏的房間	Inspect the Hidden Chamber	숨겨진 방 조사
與奎波爾麗娜對話	Talk to Kupole Lina	큐폴 리나와 대화
先從附近的怪物身上收集怪物液體	Extract and gather fluids from the nearby monsters	인근 몬스터로부터 몬스터의 액체 모으기
從織網上坡路的落葉堆中收集落葉	Gather the leaves from the piles on Netting Hills	그물 오름길에 있는 낙엽더미에서 낙엽 모으기
把波波特小溪邊的營養劑瓶裝滿營養劑	Fill up the bottles on Popot Stream with the supplements	포포트 개울가에 있는 영양제 병에 영양제 채우기
與奎波爾艾格雷對話	Talk to Kupole Aeglei	큐폴 에글레와 대화
消滅附近的怪物	Defeat nearby monsters	인근의 몬스터 퇴치
消滅周圍地區的怪物	Defeat nearby monsters	인근 지역의 몬스터 처치
與守墓人布魯納爾對話	Talk to Forest Keeper Brunonas	산지기 브루노나스와 대화
調查拉帕伊交叉路附近	Inspect the Raffye Crossroads	라파이 교차로 인근 조사
調查拉帕伊小路的苔蘚	Investigate Moss on Raffye Trail	라파이 오솔길의 이끼 조사
調查石頭採集苔蘚	Extract and examine moss from rock	돌을 조사해서 이끼 채취하기
與採藥者柴吉李斯對話	Talk to Herbalist Cesaris	약초꾼 채자리스와 대화
在皮亞瑪休憩地採集藥草	Gather Herbs from Pjama Resting Place	피아마 쉼터에서 약초 채집
採取艾蘭所給的貝爾里斯的根	Dig up the vhelis roots that Iyran finds	아이란이 찾아주는 벨리스 뿌리 채취
與樵夫道維達斯對話	Talk with Lumberjack Dowedas	나무꾼 도위다스와 대화
調查被放置在康恩克伐木場的木材堆	Investigate the wood piles on Kunck Logging Area	컨크 벌목장에 놓인 장작더미 조사
調查木材堆	Inspect the piles	장작더미 조사
調查伊巴斯丘陵的樹墩	Investigate the tree stump on Yvass Hill	이바스 언덕에 있는 그루터기 조사
與時空法師艾伊達對話	Talk to Chronomancer Ida	크로노맨서 아이다와 대화
收集血液樣本	Obtain the Blood Sample	혈액 샘플 수집
現在帶著血液樣本到內城壁第8區域去	Take the blood sample at get to Outer Wall District 8	혈액 샘플을 가지고 내성벽 제 8구역으로 이동
調查奇怪的石頭	Inspect the Suspicious Looking Rock	수상한 바위 조사
消滅貝洛查德	Defeat Velochard	벨로차드 처치
與難民代表摩爾庫斯對話	Talk to Refugee Representative Morkus	피난민 대표 모르쿠스와 대화
在綠色樹木上使用有機溶劑	Use the Orgain Solvent on the green tree	녹색 나무에 유기용제 사용
可疑的楓樹確認	Inspect the strange autumn leaved tree	이상한 단풍 나무 확인
在雷雷斯空地尋找碎布布偶的痕跡	Find the trace of rag doll at the Lereth Lot	레레스 공터에서 헝겊인형의 흔적 찾기
尋找陌生硬漢	Find the Mystery Man	의문의 사나이 찾기
擊退襲擊的怪物	Defeat the attacking monsters	습격한 몬스터 퇴치
硬漢艾維德斯對話	Talk with Ejuidas	에이위다스와 대화
與陌生硬漢艾維德斯對話	Talk to Ejuidas the Mystery Man	의문의 사나이 에이위다스와 대화
去跟硬漢艾維德斯對話吧！	Talk to Ejuidas	에이위다스와 대화하세요.
與小女孩赫莉塔對話	Talk with Little Willitte	꼬마 윌리타와 대화
救出小女孩赫莉塔	Rescue Little Willitte	꼬마 윌리타 구출
採集堅硬的根部	Extract Sturdy Roots	단단한 뿌리 채취
與奎波爾蕾妲對話	Talk with Kupole Leda	큐폴 레다와 대화
收集魔族命令書	Collect Demon orders	마족 명령서 수집
到杰洛梅爾廣場收集小石子碎片	Collect small stone fragment from Jeromel Square	제로멜 광장에서 작은 돌 파편 수집
收集魔族力量	Collect the Demon Power	마족의 힘 수집하기
調查痕跡	Investigate the trace	흔적 조사
在公園內居住地尋找奧施莉奈的痕跡	Find the trace of Ausrine at Park Residential Area	공원내 거주지에서 아우슈리네의 흔적 찾기
回收奧施莉奈女神的痕跡	Retrieve the Trace of Ausrine	아우슈리네의 흔적 회수
杰洛梅爾公園管理所尋找第2個痕跡	Find the second trace at Jeromel Park Management Office	제로멜 공원 관리소에서 두 번째 흔적 찾기
搜尋商圈入口的痕跡	Search for the Trace at the Shopping Street Entrance	상가터 입구의 흔적 수색
收集魔族力量	Collect the Demon Power	마족의 힘 수집
掃蕩附近的怪物	Mop up nearby monsters	인근 몬스터 소탕
觀察尤那耶爾紀念館	Look around the Jonael Memorial	요나엘 기념관 살펴보기
移動至尤那耶爾大禮堂	Move to Jonael Hall	요나엘 대회관으로 이동
確認魔君主迪耶那的狀況	Inspect Demon Lord Diena	마군주 디에나의 상황보기
調查尤那耶爾居住地	Investigate Jonael Residential Area	요나엘 주거지 조사
與魔君主迪耶那	Talk to Demon Lord Diena	마군주 디에나와 대화
再次尋找痕跡	Find the Clue to the Trace	흔적의 단서 찾기
調查殘骸堆	Inspect the Rubbles	잔해 더미 조사
收集魔族的精髓	Obtain Demon Essence	마족의 정수 수집
設置警報水晶	Install Alarm Crystal	경보수정 설치
清除惡意魔法陣	Destroy the interferance magic circle	방해 마법진 제거
收集神聖力探知晶球的強化材料	Gather the materials to enhance Orb of Divine Detection	신성력 탐지 구슬 강화 재료 모으기
消滅跟自己實力相當的怪物	Defeat monsters that are of the similar levels as you are	자신과 비슷한 수준의 몬스터 처치
尋找消失的傳令	Find the Missing Orders	사라진 전령 찾기
槍騎兵大師對話	Talk with the Lancer Master	랜서 마스터와 대화
在娜圖森林尋找真理之樹教團的痕跡	Find the traces of the Order of the Tree of Truth	네토 숲에서 진리의 나무 교단 흔적 찾기
向槍騎兵大師報告	Report to the Lancer Master	랜서 마스터에게 보고
角鬥士大師對話	Talk with the Murmillo Master	무르밀로 마스터와 대화
消滅銀色獅身鷹首獸	Defeat Silva Griffin	실바 그리핀 처치
向角鬥士大師報告	Report to the Murmillo Master	무르밀로 마스터에게 보고
驅趕科諾特樹林的高薩爾 	Defeat Gosals at Khonot Forest	코노트 숲의 고살 퇴치
收集老舊的鑄幣	Collect the old coins	오래된 주화 수집
破壞監視球	Destory Observation Orb	감시구 파괴
在火槍手的練習台算準時間攻擊	Hit the practice pole of Musketeer at right times	머스킷티어의 연습대에 타이밍 맞춰 공격
去見依斯托拉遺跡地的刀騎兵大師吧！	Go to the Hackapell Master at Istora Ruins	이스토라 유적지의 하카펠 마스터를 찾아가세요.
用治癒的水晶注入森林氣息中	Filling the crystal of restoration with the forest energy	치유의 수정에 숲의 기운 충전하기
向刀騎兵大師報告	Report to the Hackapell Master	하카펠 마스터에게 보고
神射手大師對話	Talk with the Mergen Master	메르겐 마스터와 대화
去見依斯托拉遺跡地的神射手大師吧！	Go to the Mergen Master at Istora Ruins	이스토라 유적지의 메르겐 마스터를 찾아가세요.
連續8秒內一個人消滅怪物	Defeat a monster within 8 seconds of defeating another monster	혼자서 몬스터를 8초안에 연속해서 처치
向神射手大師報告	Report to the Mergen Master	메르겐 마스터에게 보고
賢者大師對話	Talk with the Sage Master	세이지 마스터와 대화
轉交信件給各職業大師	Deliver the Letter to the Masters	각 마스터들에게 편지 전달하기
轉交信件給賢者大師	Deliver the Letter to the Sage Master	세이지 마스터에게 편지 전달
將信轉交給擊劍手大師	Deliver the Letter to the Fencer Master	펜서 마스터에게 편지 전달
賢者大師向擊劍手大師	From the Sage Master to the Fencer Master  	세이지 마스터는 펜서 마스터에게 
在看守者墓地找尋劍術教科書的蹤跡	Find the Swordsmanship Textbook in the Guards Graveyard	파수꾼의 묘역에서 검술 교본의 흔적 찾기
調查老舊的日記	Inspect the Old Diary	낡은 일기 조사
確認日記中所記載的場所	Check the  Location Stated in the Diary	일기에 쓰여있는 장소 확인하기
轉交教科書給擊劍手大師	Deliver the Textbook to the Fencer Master	펜서 마스터에게 교본 전달
將信件轉交給死靈法師大師	Deliver the Letter to the Necromancer Master	네크로맨서 마스터에게 편지 전달
啟動可疑的裝置	Activate the Mysterious Device	수상한 장치 가동
向死靈法師大師報告	Report to the Necromancer Master	네크로맨서 마스터에게 보고
搜尋克里那斯丘陵地	Inspect Grynas Hills 	그리나스 구릉지 수색
鎖鏈法師大師最近在克里那斯丘陵地	The Linker Master said that on Grynas Hills recently 	링커 마스터는 최근 그리나스 구릉지에서 
到克里那斯丘陵地依照鎖鏈法師大師所說的去做	Just like the Linker Master said about Grynas Hills 	그리나스 구릉지에서 링커 마스터의 말대로 
在魔族收監所第1區安裝魔力水晶	Install the Spell Crystal at Demon Prison District 1	마족수감소 1구역에 마력 수정 설치
到克尼多斯森林去凱吉青苔泥人的碎片	Collect the Fragments of Gazing Golem on Grynas Hills	크니도스 숲에서 게이징 골렘의 파편 수집
收集凱吉青苔泥人 的核	Collect Gazing Golem's Magic Core	게이징 골렘의 핵 수집
避開凱吉青苔泥人的視線安裝鏈接追蹤裝置	Install the Link Tracking Device and Avoid Getting Detected by Gazing Golem	게이징 골렘을 피해 링크 추적장치 설치
跟鎖鏈法師大師連繫	Contact with Linker Master	링커 마스터와 연락
前往鏈接追蹤裝置	Go to the Link Tracking Device	링크 추적장치로 가기
確認派出凱吉青苔泥人的魔族身分	Check the Demon Sent by Gazing Golem	게이징 골렘을 보낸 마족 확인
收集採藥者凱爾希斯相關情報	Collect Information About Herbalist Calsis	약초꾼 칼시스에 대한 정보 수집
消滅出現在奈奈巴庭院的怪物	Defeat the Monsters at Neneva Yard	네네바 뜨락에 나타난 몬스터 퇴치
翻找老舊的箱子堆	Search the Old Pile of Boxes	낡은 상자더미 수색
調查老舊箱子堆	Investigate the Old Pile of Boxes	낡은 상자더미 조사
去見艾潔爾利打聽凱爾希斯下落相關線索	Find the Arzeli to Obtain Clues About Calsis' Whereabouts	아젤리를 찾아 칼시스의 행방에 대한 단서 얻기
採集艾潔爾利的同時也找找看有沒有線索吧!	Collect the Arzeli and Look for Clues	아젤리를 채집해서 단서가 있는지 확인하기
將日記還有艾潔爾利轉交給謝爾妃	Deliver the Diary and Arzeli to Selphie	셀피에게 일기와 아젤리 전달
與閔希豪森男爵對話	Talk to Baron Munchausen	뮌히하우젠 남작과 대화
自己 	The man who calls himself 	자신을 
偉大的終結者	the Great Problem-Solver	위대한 해결사
去跟那位自稱是 閔希豪森男爵的人對話吧!	Talk to Baron Munchausen	라고 자칭하는 뮌히하우젠 남작과 대화하세요.
靈驗的粉末	Holy Powder	영험한 가루
將可疑水晶埋藏在移居民居住地	Bury the Strange Crystals Under the Village	이주민 거주지에 수상한 수정 묻기
到娜圖森林採集乾枯的落葉	Gather Dried Leaves of Nheto Forest	네토 숲에서 마른 낙엽 채집
與礦山村莊村長對話	Talk to the Miners' Village Mayor	광산 마을  촌장과 대화
閔希豪森男爵向礦山村莊村長	Baron Munchausen asked you to deliver  	뮌히하우젠 남작은 광산 마을 촌장에게 
閔希豪森的軟膏	Munchausen's Reagent	뮌히하우젠의 연고
驅趕看守者墓地的幽靈	Exorcise the Guards Graveyard	파수꾼의 묘역의 유령 퇴치
與狂熱者大師對話	Talk with the Zealot Master	질럿 마스터와 대화
啟用沒有邪惡氣息的所有圓盤	Activate the discs that do not contain evil energy	사악한 기운이 없는 모든 원판 활성화 시키기
轉交給嘉魅爾蘭	Deliever to Jamelhan	자멜란에게 전달
女神之花	The Goddess' Flower	여신의 꽃
祭司凱勒堤對話	Talk with Priest Gherriti	사제 개러티와 대화
去跟祭司凱勒堤對話	Talk to Priest Gherriti	사제 개러티와 대화하세요
把種子泡進河裡	Immerse the Seeds under water	씨앗을 물가에 담그기
請跟祭司凱勒堤對話。	Talk with Priest Gherriti	사제 개러티와 대화하세요.
跟祭司凱勒堤一起移動到還遺留有神聖力的場所	Move to the place where the divine energy still remains along with Priest Gherriti	사제 개러티와 신성력이 남아있는 장소로 이동
請和祭司凱勒堤一同移動至殘留神聖力的地點。	Get to the place where the divine energy still remains along with Priest Gherriti	사제 개러티와 신성력이 남아있는 장소로 이동하세요.
取得拉昆的精髓	Obtain Lyecon essence	라콘의 정수 구하기
去跟 祭司凱勒堤對話看看。	Talk to Priest Gherriti	사제 개러티와 대화 하세요
取得阿爾寇蕨葉	Get the arcus bracken	아르커스 고사리 구해오기
將神聖力注入兩根柱子中間	Fill it up with the divine energy from the pillar	돌 기둥에 있는 신성력 담아오기
填滿神聖力的精髓放置在祭壇附近	Place the essence on the altar after filling it with the divine energy	신성력으로 채운 정수를 제단 근처에 놓기
燃燒祭壇旁的花朵	Burn the flower near the altar	제단 옆에 있는 꽃 태우기
協助祭司凱勒堤集中精神	Help Priest Gherriti Concentrate	사제 개러티의 집중이 방해되지 않게 돕기
詢問女神的下落	Ask whereabouts of Goddess	여신의 행방에 대해 물어보기
請向祭司凱勒堤詢問關於女神的行蹤。	Ask Priest Gherriti on whereabouts of Goddess	사제 개러티에게서 여신의 행방에 대해서 물어보세요
隱藏在森林深處的威脅	Danger the Lurks in the Forest	숲 속에 숨어있는 위협
奧斯卡拉斯對話	Talk with Oscaras	오스카라스와 대화
取得實驗所需的材料	Obtain the Materials needed for the experiment	실험에 필요한 재료 구하기
取得實驗所需的對照組	Obtain Experiment Subjects	실험에 필요한 실험군을 구하기
讓把捕捉來的怪物接觸實驗物質	Contact the experimental substance on the captured monster	포획한 몬스터에게 실험 물질을 접촉시키기
請跟奧斯卡拉斯看看	Talk to Oscaras	오스카라스와 대호하세요
採集各種帕馬勒蕨葉	Gathering different types of phamer brackens	다양한 형태의 파마르 고사리 채집하기
尋找圖隆伊的精髓	Obtain Bunkeyto essence	도룡이의 정수 구하기
用圖隆伊的精髓尋找閃爍花	Use Bunkeyto essence to Obtain Vink Flowers	도룡이의 정수를 사용해 빙크 꽃 구하기
尋找奧斯卡拉斯	Find Oscaras	오스카라스 찾기
去見奧斯卡拉斯吧！	Find Oscaras	오스카라스를 찾으세요
製做治療劑	Make the cure	치료제 만들기
保管好實驗台的治療劑	Grab the cure on the experiment table	실험대에서 치료제 챙기기
麻煩保管好在實驗台上製作好的治療劑。	Grab the completed cure from the experiment table	실험대에서 완성된 치료제를 챙기세요
把 治療劑轉交給奧斯卡拉斯	Deliver the cure to Oscaras	오스카라스에게 치료제를 전달하기
利用魔法晶球取得籠罩著魔力的血液	Use the magic orb to obtain Magic Infused Blood	마법 구슬을 사용해 마력이 서린 혈액 구하기
收集香精需要的材料	Collect the materials to make the incense	향에 필요한 재료 모으기
將瀰漫詛咒的遺物回收	Retrieve the Cursed Keepsakes	저주가 서린 유품을 회수해오기
用淨化過的寶珠淨化被魔力感染的植物	Purify the plants with the orb of purification	마기에 물든 식물을 정화의 보주로 정화하기
去跟柯拉佩達的神諭師大師對話	Talk to the Oracle Master at Klaipeda	클라페다에 있는 오라클 마스터와 대화하세요
把作業場的魔族給消滅掉	Defeat demons at Workshop	작업장에 있는 마족 처치하기
與瘟疫醫生大師對話	Talk to the Plague Doctor Master	플레이그닥터 마스터와 대화
尋找野獸型怪物的血液、植物型怪物的體液	Obtain the fluids of wild animal and plant monsters	야수형 몬스터의 혈액, 식물형 몬스터의 체액을 구하기
卡巴拉對話	Talk with the Kabbalist Master	카발리스트와 대화
去跟依斯托拉遺跡地的卡巴拉對話	Talk to the Kabbalist Master at Istora Ruins	이스토라 유적지에 있는 카발리스트와 대화하세요
消滅水晶球中出現的數字所指的怪物	Defeat the monster indicated by the number displayed on the crystal sphere	수정구에 나타난 숫자가 의미하는 몬스터 처치
去跟賢者大師對話吧！	Talk to the Sage Master	세이지 마스터와 대화하세요
尋找魔法學相關書籍	Find the Books On the Study of Magic	마법학과 관련된 서적 찾기
請跟附魔師大師對話。	Talk to the Enchanter Master	인챈터 마스터와 대화하세요
使用魔力吸收晶球吸收魔力	Use the absorption orb to absorb the spell	마력 흡수 구슬을 사용해 마력 흡수하기
新審判者大師對話	Talk with the Inquisitor Master	인퀴지터 마스터와 대화
去跟瑪那哈斯村莊的 新審判者大師對話吧。	Talk to the Inquisitor Master in Manahas	마나하스에 있는 인퀴지터 마스터와 대화하세요
道士大師對話	Talk with the Taoist Master	도사 마스터와 대화
去跟蓮帕拉沙池塘的道士大師對話吧！	Talk to the Taoist Master at Lemprasa Pond	렘파라사 연못에 있는 도사 마스터와 대화하세요
對娜圖森林出現的怪物使用符咒	Use charms on monsters at Nheto Forest	네토 숲의 몬스터에게 부적 사용하기
詢問奎波爾梅伊雷是否有辦法引渡丁格巴希地區被石化的人們	Ask Kupole Meile to Guide the Souls in Dingofasil District	딩고파실 지구에 있는 석화된 이들을 인도해줄 수 있는지 큐폴 메일레에게 물어보세요
在丁格巴希地區設置水晶	Install the Sphere at Dingofasil District	딩고파실 지구에 구슬 설치하기
丁格巴希	Dingofasil	딩고파실
村莊居民的財產	Villagers' Valuables	마을 주민의 재산
解開箱子的鎖	Unlock the Box	상자의 잠금 장치 풀기
將箱子交給村莊居民	Deliver the Box to the Villagers	마을 주민에게 상자를 전달하기
與士兵哈爾倫對話	Talk to Soldier Heulen	병사 하일른과 대화
尋找草莓	Obtain Strawberries	딸기 구하기
與鬥牛士大師對話	Talk to the Matador Master	마타도르 마스터와 대화
通過鬥牛士大師的考驗	Complete the Matador Master's test	마타도르 마스터의 시험에 통과하기
請通過鬥牛士大師給的考驗	Complete the Matador Master's test	마타도르 마스터가 내준 시험에 통과하세요
已經汲取完成實驗所需的水了！	You have raised enough water for the experiment	실험에 필요한 물을 길렀습니다
網鬥士和織網	Retiarius and the Net	레티아리이와 그물
古老大海的名譽	Honor of the Old Sea	옛 바다의 명예
永生不朽的安基納斯	Eternal Amjinas	불로불사의 암지나스
鍊金術士的情由	The Alchemist's Inspection	연금술사의 사정
神不知鬼不覺	Without a Trace	쥐도 새도 모르게
利迪亞夏班與造箭者的弓箭	Lydia Schaffen and the Fletcher's Arrow	리디아 샤펜과 플레쳐의 화살
消失的傳令	The Missing Orders	사라진 전령
去確認熄滅的火吧	Make it Certain	꺼진 불을 확인하라
重建魔法學所需要的物品	Rebuilding the Study of Magic	마법학 재건에 필요한 것들
集中力提升訓練	Focus Training	집중력 향상 훈련
和網鬥士大師對話	Talk with the Retiarius Master	레티아리이 마스터와 대화
熟知網鬥士大師所告知的訓練規則	Retiarius Master's Training Rules	레티아리이 마스터가 알려주는 훈련 규칙 숙지
轉交箭矢給造箭者大師	Give the Arrow to the Fletcher Master	플레쳐 마스터에게 화살 전달
消滅防礙搜查線索的神殿射手	Defeat the Templeshooter Blocking Your Way	단서 수색을 방해하는 템플슈터 처치
和陰陽師大師對話	Talk with the Onmyoji Master	음양사 마스터와 대화
精神力訓練	Focus Training	정신력 훈련
使用笛子的方法	How To Use The Flute	피리를 다루는 방법
驅魔師的驅魔儀式	The Rituals of an Exorcist	엑소시스트의 구마의식
與吹笛手大師對話	Talk to the Pied Piper Master	파이드 파이퍼 마스터와 대화
練習笛子	Flute Practice	피리 연습
隱藏在森林裡的危險	Dangers Hidden Within The Forest	숲 속에 숨어있는 위험
與驅魔師大師對話	Talk to the Exorcist Master	엑소시스트 마스터와 대화
為解除禁錮的邪惡靈體進行驅魔	Exorcise the Evil Spirits	구속이 풀린 사악한 령들을 구마하기
