警戒兵	Sentinel	경계병
藏匿中的男子	Man in Hiding	숨어있는 남자
無法戰鬥時可以在原地復活的	To revive on the same spot you'll need the 	전투 불능 시 제자리 부활이 가능한 
購買方法是將想要的道具	Click the 	구매 방법은 원하시는 아이템을 
裝填	Add	담기
傳達員杜奈斯	Receptionist Donnes	접수원 도네스
秘密守護者	Secret Guardian	비밀의 수호자
聯絡官 尼爾斯	Liaison Officer Niels	연락관 닐스
記錄官 尤那斯	Archivist Jonas	기록관 요나스
史學家 菲歐德	Historian Viode	사학자 비어드
史學者凱佩克	Historian Kepeck	사학자 케펙
亞希拉斯尤那斯	Ahylas Jonas	아힐라스 요나스
庫斯塔斯的弟子	Disciple of Gustas	구스타스의 제자
庫斯塔斯尤那斯	Gustas Jonas	구스타스 요나스
考古學家 戴志克	Archaeologist Dezic	고고학자 데지크
技術員 哈伊奈恩	Technician Heinen	기술자 하이넨
可以拜託你去稍微清理一下怪物嗎？	Could you take care of them? 	좀 정리를 부탁해도 될까?
羅藍塔斯尤那斯	Rolandas Jonas	롤란다스 요나스
助手 艾伊里奈	Assistant Airine	조수 아이리네
傭兵 葛雷恩	Mercenary Glen	용병 글렌
新王陵研究員	New Researcher	신입 왕릉 연구원
但是峽谷中沒什麼植物，怎麼會有這麼多怪物呢？	Why are there so many monsters in the canyon when there is so little plant life around?	그런데 협곡에는 식물들도 별로 없는데 어째서 몬스터가 이렇게나 많은 걸까요?
我拜託你的事進展如何？ 還沒完成嗎？	What happened to my request? Is it not done yet?	제가 부탁한 것은 어떻게 되었나요? 아직인가요?
藥材商	Medicine Dealer	약재상
商人 達比歐	Merchant Davio	상인 다비오
傭兵 米勒塔	Mercenary Mirta	용병 미르타
拜杜塔斯	Vaidotas	바이도타스
村莊大嬸	Village Aunt	마을 아주머니
你是來救我們的吧？ 對吧？	You've come to save us? Right?	우릴 구하러 온 거지? 그렇지?
村莊少女	Village Girl	마을 소녀
藥師小姐	Pharmacist Lady	약사 아가씨
士兵 傑伊司	Soldier Jace	병사 제이스
士兵 艾德卡	Soldier Edgar	병사 에드가
柯拉佩達區警備兵隊長	Klaipeda Guard Captain	클라페다 방면 경비병 대장
柯拉佩達 警備兵	Klaipeda Guard	클라페다 경비병
補給負責官	Supply Officer	보급 담당관
拉伊摩那斯	Laimonas	라이모나스
戰鬥組長	Battle Commander	전투 조장
搜查兵	Search Scout	수색병
啟示者該來的地方不是這裡而是柯拉佩達吧？	Shouldn't a Revelator be heading to Klaipeda instead of hanging around here?	계시자들은 여기가 아니라 클라페다로 가야 하는 것 아닙니까?
柯拉佩達居民	Klaipeda Resident	클라페다 주민
戰鬥兵	Trooper	전투병
騎士 阿拉斯	Knight Aras	기사 아라스
前哨基地警戒兵	Outpost Sentinel	전초기지 경계병
作戰負責人	Operations Officer	작전 담당관
補給兵	Supply Soldier	보급병
東邊森林搜查兵	Eastern Woods Search Scout	동쪽 숲 수색병
礦夫	Miner	광부
傭兵利特	Mercenary Lindt	용병 린트
工兵大師	Sapper Master	새퍼 마스터
聖者大師	Sadhu Master	사두 마스터
雷克西波	Rexipher	렉시퍼
技術員歐萊昂	Technician Orion	기술자 오라이온
聯絡官尼安	Liaison Officer Nian	연락관 니안
史學家亞德 	Historian Adelle	사학자 아델
考古學家普利特卡	Archaeologist Friedka	고고학자 프리드카
圓盾劍士次級大師	Rodelero Submaster	로델레로 서브  마스터
礦山村莊村長	Miners' Village Mayor	광산마을 촌장
女神薩勒	Goddess Saule	여신 사울레
王陵奠基石	Royal Mausoleum Foundation Stone	왕릉 초석
王陵魔方使用法	Royal Mausoleum Cube Manual	왕릉 큐브 사용법
守護體系整頓法	Defense System Manual	수호체계 정비법
守護者的作用	Guardian's Role	수호자의 역할
守護者的石像	Guardian Stone Statue	수호자의 석상
王陵設計圖	Royal Mausoleum Blueprint	왕릉 설계도
王陵魔力抑制器說明書	Royal Mausoleum Regulatory Magic Manual	왕릉 마력 억제기 설명서
王陵記錄書	Royal Mausoleum Archives	왕릉 기록서
庫班	Coben	코벤
石匠凱諾林	Stonemason Canolyn	석공 캐놀린
塔拉瑪爾茲	Tara Miles	타라 마일즈
祕密場所說明書	Secret Location Manual	비밀장소 설명서
王室秘寶守護者	Guardian of the Royal Family's Secret Treasure	왕실 비보 수호자
看守者梅透	Watcher Matthew	파수꾼 매튜
看守者帕吉爾	Watcher Basil	파수꾼 바질
看守者艾倫	Watcher Allen	파수꾼 알렌
追隨者凱耶陀納斯	Follower Kayetonas	추종자 카예토나스
看守者凱奈司	Watcher Kenneth	파수꾼 케네스
看守者艾拉	Watcher Erra	파수꾼 에라
看守者里凱	Follower Rikke	파수꾼 리케
追隨者阿爾馮薩斯	Follower Alfonsas	추종자 알폰사스
追隨者帕伊達史	Follower Vaidas	추종사 바이다스
追隨者帕伊達史	Follower Vaidas	추종자 바이다스
追隨者托瑪斯	Follower Tomas	추종자 토마스
追隨者堤貝里尤斯	Follower Tiberius	추종자 티베리유스
追隨者多納塔史	Follower Donatas	추종자 도나타스
金石學者雷蒙德	Epigraphist Raymond	금석학자 레이몬드
會是誰紀念那種叛亂者呢？ 會不會是有其他理由呢？	I wonder who mourned that traitor? Don't you think there would be a different reason?	누가 그런 반란자를 추모했는지. 이유가 따로 있지 않을까요?
寶物獵人艾當	Treasure Hunter Eden	보물사냥꾼 에당
金石學者史密德	Epigraphist Schmid	금석학자 스미드
邪靈術師特拉修斯	Necromancer Drasius	사령술사 드라슈스
利迪亞夏班的碑石	Monument of Lydia Schaffen	리디아 샤펜의 비석
徘徊的靈魂	Wandering Spirit	배회하는 영혼
作戰命令書	Operation Order	작전 명령서
警備兵利波	Guard Leaper	경비병 리퍼
追隨者巴伊杜堤斯	Follower Vaidutis	추종자 바이두티스
看守者莫爾黎	Watcher Molly	파수꾼 몰리
看守者默利	Watcher Molly	파수꾼 모리
到底神聖之地發生什麼事了呢？	I really wonder what has become of this sacred land?	도대체 신성한 땅에 무슨 일이라도 생긴 걸까?
史學家 寇林	Historian Colin	사학자 콜린
王陵書桌	Royal Mausoleum Desk	왕릉 책상
未知的存在	Unknown being	알 수 없는 존재
治療師小姐	Healer Lady	치유사 아가씨
礦山所長 布林肯	Mine Manager Brinker	광산 소장 브링커
看守者 哈梅史	Watcher James	파수꾼 하메스
警備兵	Security Guard	경비병
哥拉斯	Gorath	고라쓰
巴拉特	Badat	바다트
石匠 皮波堤	Stonemason Pipoti	석공 피포티
凱賓	Kevin	케빈
雕刻家 喜爾達	Sculptor Hilda	조각가 힐다
補給隊隊長 皮歐	Supply Commander Vio	보급대 대장 비오
傭兵 埃塔	Mercenary Eta	용병 에타
考古學家 勞迪	Archaeologist Laudi	고고학자 라우디
莫勒庫斯‧尤那斯	Morkus Jonas	모르쿠스 요나스
探險家 巴奇斯	Adventurer Varkis	탐험가 바키스
史學家雷克西波	Historian Rexipher	사학자 렉시퍼
聯絡官 培爾	Liaison Officer Bale	연락관 베일
呼，這麼多資料要何時才能整理完呢？	How can I put all these materials in order?	어휴, 이 많은 자료를 언제 다 정리한담?
受傷的史學家 勞拉斯	Wounded Historian Laulas	부상당한 사학자 라우라스
露克立斯紀念碑拓本	Ruklys Memorial	루클리스 추모비 탁본
無名碑	Nameless Monument	무명비
還有事情嗎？	You still have business here?	아직 볼 일이 남았나?
無精打采的警備兵	Powerless Security Guard	기운 빠진 경비병
雷克西波到底想做什麼呢？	What will Rexipher do?	렉시퍼는 도대체 무엇을 하려는 걸까요?
信徒 奧比狄司	Believer Alvydas	신도 알비다스
信徒 拉敏塔	Believer Raminta	신도 라민타
信徒 埃帕爾達史	Believer Evaldas	신도 에발다스
信徒 查內塔	Believer Zaneta	신도 자네타
信徒 希瑪史	Believer Simas	신도 시마스
巴奇斯靈魂	Varkis' Soul	바키스 영혼
紀念碑	Monument	추모비
建築師勞迪	Architect Laudi	건축가 라우디
你在這裡做什麼呢？	What are you doing here?	자네 여기서 뭘 하고 있는 건가?
獵人	Hunter	사냥꾼
礦山所長	Mine Manager	광산 소장
信徒 亞德雷	Believer Adele	신도 아델레
竟然在頭上養香菇，真的很神奇吧？	Isn't it strange that mushrooms grow from their heads?	머리에 버섯을 키우다니 참 신기하죠?
信徒 皮勒基史	Believer Virgis	신도 비르기스
信徒 諾尤司	Believer Nojus	신도 노유스
維塞特	Vincent	빈센트
浮現的字句	Wispy Floating Words	떠오른 글귀
就算知道老人家我要用在什麼地方又能怎樣呢？	Why would an old man like me be trying to figure out what this does?	늙은이가 그걸 뭣에 쓰려는지 알아서 뭐하려고?
信徒托馬斯	Believer Domas	신도 도마스
信徒 普羅紐斯	Believer Bronius	신도 브로뉴스
信徒 猶勒卡	Believer Jurga	신도 유르가
安德伊村莊元老	Old Man of Andale Village	안데일 마을 원로
安德伊村莊神官	Andale Village Priest	안데일 마을 신관
安德伊村莊祭司	Andale Village Priest	안데일 마을 사제
安德伊村莊村長	Andale Village Headman	안데일 마을 촌장
信徒 奧奴泰	Believer Onute	신도 오누테
信徒 沙曼塔	Believer Samantha	신도 사만타
信徒卡基斯	Believer Kazis	신도 카지스
偏斜的王陵碑石	Broken Royal Mausoleum Tombstone	어그러진 왕릉 비석
王陵碑石	Royal Mausoleum Tombstone	왕릉 비석
王陵守護者	Royal Mausoleum Guardian	왕릉 수호자
被汙染的王陵守護者	Corrupted Royal Mausoleum Guardian	오염된 왕릉 수호자
安德伊村莊老人	Old Man of Andale Village	안데일 마을 노인
受傷的村民	Injured Villager	부상당한 마을 주민
王陵守護者的石像	Royal Mausoleum Guardian Stone Statue	왕릉 수호자의 석상
守護者的石像	Guardian Stone Statue	수호작의 석상
守護者石像	Guardian Stone Statue	수호자 석상
啟示的夢中是否有提到女神在什麼地方呢？	Did the goddess mention her whereabouts in a dream of revelation?	혹시 계시의 꿈에서 여신께서 어디 계시다고 말씀하시진 않던가요?
飾品商人猶勒斯	Accessory Merchant Jurus	악세서리 상인 유르스
巴奇斯的靈魂	Varkis' Spirit	바키스의 영혼
凱勒達	Gerda	게르다
賽拉彼納斯	Serapinas	세라피나스
馬勒傑利尤思	Margellius	마르젤리유스
你去特洛茲空地設置陷阱吧	Go to the Drose Empty Lot and set up the trap	드로즈 공터로가서 덫을 놓아봐
阿爾費納	Albinas	알비나스
怪物應該不會把全部的皮革都給吃掉吧？	What if the monsters have eaten it?	설마 몬스터들이 먹어치우거나 그런 건 아니겠지요?
奎波爾 特理亞	Kupole Trija	큐폴 트리아
奎波爾 賽力亞	Kupole Serija	큐폴 세리야
流動商人卡西亞斯	Traveling Merchant Cassius	행상인 카시야스
流動商人安德列斯	Traveling Merchant Andres	행상인 안드레스
流動商人高梅斯	Traveling Merchant Gomez	행상인 고메스
德斯	Tess	테스
採藥者塔拉斯	Herbalist Talas	약초꾼 탈라스
克洛亞村莊居民	Croa Village Resident	크로아 마을 주민
實驗被害人皮爾斯	Experiment Victim Fils	실험 피해자 필스
實驗被害人希爾貝斯	Experiment Victim Hilbeth	실험 피해자 힐베스
安妮	Anne	안네
亞倫阿斯	Allonas	알론아스
村長的孫女	Elder's Granddaughter	촌장의 손녀
修道士阿貝斯	Monk Abels	수도사 아벨스
魔法師次級大師	Wizard Submaster	위자드 서브 마스터
這些是在諾巴哈本院內發現的資料嗎？	Are these materials you found inside the Novaha Monastery?	이것들이 노바하 본원에서 발견하신 자료들입니까?
流動商人亞爾雷斯	Traveling Merchant Ales	행상인 알레스
流動商人柯倫斯	Traveling Merchant Krens	행상인 크렌스
克羅拉斯	Kornas	코느라스
羅娜	Rona	로나
你要親自製作給寵物的飼料嗎？	Do you wanna try and make some food for your companion?	컴패니언에게 줄 먹이를 직접 만들어 보겠나?
啟示者米歇爾	Revelator Mihail	계시자 미하일
迷失的靈魂	Lost Spirit	헤매는 영혼
微弱的貓頭鷹雕像	Frail Owl Sculpture	미약한 부엉이 조각상
貼在裝置上的紙條	Device Note	장치에 붙어 있는 메모지
金塔斯的靈魂	Gintas' Spirit	긴타스의 영혼
柯拉佩達市長的靈魂	Klaipeda Mayor's Spirit	클라페다 시장의 영혼
祭司拉美莉耶	Priest Ramelie	사제 라멜리에
冤魂	Innocent Spirit	억울한 영혼
跑腿者	Errand Man	심부름꾼
路克索那內戰1章	1st Page of the Roxona Conflict	록소나 내전 1장
現在要試試看嗎？	Why don't you try it out?	지금 한 번 해보시겠어요?
可以幫詢問那個人何時可以把我們安置在這裡呢？	Could you ask that person how much longer he's going to make us stand here?	우릴 언제까지 여기 세워둘 생각인지 저 사람에게 물어봐 주시겠소?
必須創造	Must be filled	작성해야함
緊急動力裝置	Emergency Power Source	비상 동력장치
金石學者 黛爾特蘭	Epigraphist Deltran	금석학자 델트란
採藥者 塔拉斯	Herbalist Talas	약초 탈라스
史學家 葛利努斯	Historian Grenus	사학자 그리누스
開墾民 羅德納斯	Settler Rodonas	개척민 로도나스
拉泰露斯	Laterous	라테루스
流浪信徒的靈魂	Wandering Believer's Soul	떠도는 신도의 영혼
朝聖者 賽羅尼亞	Pilgrim Seronia	순례자 세로니야
追隨者 內特爾諾斯	Follower Nedluss	추종자 네들러스
啟示者庫奈	Revelator Connor	계시자 코너
農民 戴爾琉瑪	Farmer Deluma	농민 델류마
祭司 蘿芙莉	Priest Rovli	사제 로블리
女信徒 德蕾卡	Believer Dreka	여신도 드레카
和這些膽小鬼是要怎麼去到歐勒夏啊？	How am I supposed to get to Orsha with these cowards?	이런 겁쟁이들이랑 어떻게 오르샤까지 가지?
這樣你還想挑戰嗎？	But does your pounding heart command you still?	그래도 도전해 보겠는가.
魔法師梅西歐拉斯	Mage Melchioras	마법사 멜히오라스
追隨者安德雷雅	Follower Andrea	추종자 안드레아
追隨者路歐達斯	Follower Nuodas	추종자 누오다스
追隨者約志	Follower Wedge	추종자 웨지
如果方便的話，能請你消滅小豬嗎？	Would you please help me and clear out a few Pags?	괜찮으시다면 페이그들을 퇴치해 주시지 않겠습니까?
不說出你的目的，卻跟我要東西，只會更為難我而已。	Why are you pestering me when you won't even tell me what it is for?	목적도 말하지 않으면서 무엇을 내놓으라고 나를 괴롭히는 것인가.
神秘的少女	Mysterious Girl	신비한 소녀
女神拉達	Goddess Lada	여신 라다
蛤？	What?	네?
奎波爾 艾雷那	Kupole Alena	큐폴 알레나
跟你一起來的這位就是救援者嗎？	Then the person with you right now is the Revelator?	그럼 옆에 함께 오신 분이 구원자이신가요?
達莉雅的靈魂	Dalia's Spirit	달리아의 영혼
到底是覬覦著什麼，這樣執著地一而再再而三來犯。	What are they searching that makes them so persistent?	대체 뭘 노리고 이렇게 끈질기게 덤벼오는 걸까요?
您正在進行地下城新手教學啊？	Are you doing the instanced dungeon tutorial?	인스턴스 던전에 대한 튜토리얼을 진행 중이시군요?
到底有沒有把我這個村長放在眼裡？	Where's the respect for the village chief?	도대체 촌장을 뭘로 알고 이러는거야?
那帕里斯	Napalis	나팔리스
雷那達斯	Lanaldas	래날다스
村莊青年	Town Youth	마을 청년
獵人莫吉斯	Hunter Modis	사냥꾼 모지스
多虧您的幫忙	Thanks to your help 	도와주신 덕에 
啟示者普丹	Revelator Pudhin 	계시자 푸덴
繼承者烏克奴思	Loremaster Ugnius	전승자 우그뉴스
繼承者奈里烏思	Loremaster Narius	전승자 내리우스
啟示者尼奇	Revelator Nichi	계시자 니치
破壞魔族的裝置了嗎？{nl}	Is the Demon Device destroyed?	마족의 장치가 파괴되었습니까?{nl}
嗯？	Hm?	흠?
繼承者埃莫艾利斯	Loremaster Emmanuelis	전승자 애마누엘리스
如果可以，能請您再幫忙一下嗎？	Would you be willing to help?	괜찮으시면 조금 더 도와주실 수 있으십니까?
希來尼亞‧歐德爾	Cyrenia Odell	시레니아 오델
奇怪的布袋	Strange Sack	이상한 자루
在布袋內發現了紙條。	Found a letter in the sack	자루 안에서 쪽지를 발견했다.
布袋內的紙條	The letter in the sack	자루 안의 쪽지
亞夏克地牢	Ashaq Underground Prison	아샤크 지하 감옥
水晶礦山的啟示	Revelation of Crystal Mine	수정광산의 계시
泰內聖堂的啟示	Revelation of Tenet Church	테넷 성당의 계시
荊棘林的啟示	Revelation of Kvailas Forest	가시숲의 계시
札卡里耶爾王陵的啟示	Revelation of Royal Mausoleum	자카리엘 왕릉의 계시
公會活動	Guild Event	길드 이벤트
奎波爾伺服器	Kupole Server	큐폴 서버
抽寶石商人	Gem Draw Merchant	젬 뽑기 상인
shutdown	Shutdown	셧다운
270_315_一般裝備販賣商人	270_315_Normal Equipment Merchant 	270_315_일반 장비 판매 상인
釣魚管理員	Fishing Manager	낚시 관리인
隊伍戰鬥聯賽 巴利斯	Team Battle League Valis	팀 배틀 리그 발리스
副本訊息	Dungeon Message 	인던 메시지
傭兵委託所的委託	Mercenary Post Receptionist	용병 의뢰소의 의뢰
接受委託	Accept the mission	의뢰를 수락한다
我很忙，沒辦法接受委託	I won't accept the mission since I'm busy	바빠서 의뢰를 받을 수 없다고 한다
去找騎士堤塔斯(1)	Talk to Knight Titas (1)	기사 티타스에게(1)
我要回去找堤塔斯	Return to Knight Titas	티타스에게 돌아가겠다고 한다
去找騎士堤塔斯(2)	Talk to Knight Titas (2)	기사 티타스에게(2)
拒絕	Decline	거절한다
尋找偵察兵(1)	Talk to the Scout (1)	정찰병에게(1)
我只是來轉達集合命令而已	I'm just here to tell the troops to assemble	집합 명령을 전달해 주러 왔을 뿐이라고 한다
立刻逃跑	Quickly run away	재빨리 도망간다
尋找偵察兵(2)	Talk to the Scout (2)	정찰병에게(2)
我會幫忙尋找行李	I'll find your missing belongings	짐 꾸러미를 대신 찾아 주겠다고 한다
在找到之前我會一直等下去	I'll wait until you find it	찾을 때 까지 기다리겠다고 한다
請點擊'M'鍵確認地圖。	Check the map by pressing the M key	'M' 키를 눌러 지도를 확인하세요
去找騎士堤塔斯(3)	Talk to Knight Titas (3)	기사 티타스에게(3)
我知道了	Alright	알겠다고 한다
結束	Cancel	종료
告訴搜查兵	Talk to the Search Scout	수색병에게
轉達集合命令的事情	There is an order to assemble	집합 명령이 있음을 알려준다
拉伊摩那斯的委託	Laimonas' Favor	라이모나스의 부탁
詢問發生什麼事情	What will happen next?	어떤 일이 생기는지 묻는다
我沒有任何興趣	I'm not interested	관심 없다고 한다
關於女神像	About the Goddess Statues	여신상에 대해
前往柯拉佩達的路(1)	The Road to Klaipeda (1)	클라페다로 가는 길(1)
前往柯拉佩達的路(2)	The Road to Klaipeda (2)	클라페다로 가는 길(2)
我願意幫忙	I'll lend my strength to you	힘을 보태 주겠다고 한다
進入柯拉佩達	Enter Klaipeda	클라페다로 들어간다
去找戰鬥組長(1)	Talk to the Battle Commander (1)	전투 조장에게(1)
我會幫忙任務	I'll help out with your missions	임무를 돕겠다고 한다
我會等待	I'll wait then	기다리겠다고 한다
關於怪物	About the monsters	몬스터에 대해
去找戰鬥組長(2)	Talk to the Battle Commander (2)	전투 조장에게(2)
同意	Accept	수락
紛爭的開端	The Beginning of Trouble	말썽의 시작
我會去找找看	I'll try to look for them	찾아 보겠다고 한다
我很快就會回來	They will be back soon	곧 돌아올 거라고 한다
可疑的徵兆	Something Fishy	수상한 낌새
我會幫忙去找	I'll take a look for you	대신 찾아 보겠다고 한다
營地的危機	Camp Crisis	캠프의 위기
我沒看到那種東西	I didn't see anything like that	그런 건 보지 못했다고 한다
完全不在乎	Not really my problem	신경쓰지 않는다
東邊森林的威脅	Threats of the Eastern Woods	동쪽 숲의 위협
會答應這個提議	I will accept your suggestion	제안에 응하겠다고 한다
等到解決為止	I will wait until the problem is solved	해결 될 때 까지 기다린다
警戒兵的委託(1)	Sentinel's Favor (1)	경계병의 부탁(1)
說會去消滅卓柏卡布拉	I'll defeat the Chupacabra	츄파카브라를 처치하겠다고 한다
那種事情自己看著辦吧	You should take care of it yourself	그런 건 알아서 하라고 한다
阿拉斯部隊的作用	The role of Aras' Troops	아라스 부대의 역할
警戒兵的委託(2)	Sentinel's Favor (2)	경계병의 부탁(2)
我會幫忙收復補給地	I'll get the Supplies Camp back	보급지를 되찾아 주겠다고 한다
無法稱心如意的(3)	Not as Intended (3)	뜻대로 되지 않는(3)
提議消滅巨大灰色卓柏卡布拉	I'll defeat the Large Gray Chupacabra	대형 회색 츄파카브라를 처치하겠다고 제안한다
無法稱心如意的(4)	Not as Intended (4)	뜻대로 되지 않는(4)
我會去消滅韋伯	I'll defeat the Weavers	위버를 처치하겠다고 한다
阿拉斯的委託(1)	Aras' Commission (1)	아라스의 의뢰(1)
我會從波波小獅王身上尋找線索	I'll find something that might be a clue from the Popolions	포포리온에게서 단서가 될 만한 것을 찾겠다고 한다
我會負責去進行	I'll do it later	나중에 하겠다고 한다
阿拉斯的委託(2)	Aras' Commission (2)	아라스의 의뢰(2)
我能幫忙進行確認	I'll take a look	확인해 줄 수 있다고 한다
那種事情自己看著辦吧	I think you should take care of it yourself	그 정도는 알아서 하라고 말한다
關於布貝	About the Vubbes	부베에 대해
補給兵的委託(1)	Supply Soldier's Favor (1)	보급병의 부탁(1)
提議收集韋伯的腳趾甲	I'll help you collect Weaver Claws	위버의 발톱을 모아주겠다고 제안한다
補給兵的委託(2)	Supply Soldier's Favor (2)	보급병의 부탁(2)
提議消滅波庫布	I'll deal with the Pokubus	포쿠부를 처치해 주겠다고 제안한다
不需要等，我會負責去消滅布貝鬥士	Let me defeat the Vubbe Fighter instead of waiting	기다릴 것 없이 부베 투사를 처치하겠다고 한다
我會等待新增兵力的到來	I am going to wait for backup	추가 병력을 기다리겠다고 한다
進入礦山村莊	Enter the Miners' Village	광산 마을 진입
會前往礦山村莊	I would like to go to the Miners' Village	광산 마을로 가겠다고 한다
利用時間進行準備	Give me some time to prepare	잠시 준비할 시간을 갖는다
拯救村民	Rescue the Villagers	마을 주민 구출
拯救村莊居民後，說打算去尋找救贖之光	Rescue the villagers and then search for the Light of Salvation	마을 주민을 구하고 나서 구원의 빛을 찾겠다고 한다
停止	Quit	그만둔다
尼多普巴伊的襲擊	Netherbovine's Attack	네더보바인의 습격
被封鎖的區域的魔族	Demons of the Closed Area	폐쇄된 구역의 마족
石匠皮波堤的朋友	Stonemason Pipoti's Friend	석공 피포티의 친구
我會去幫忙尋找同伴	I will find your colleague	동료를 찾아 주겠다고 한다
我很快就會回來	I will come back soon	금방 돌아올 것이라고 한다
石匠家族的寶物地圖(1)	Treasure Map of the Stonemason's Family (1)	석공가문의 보물지도(1)
石匠家族的寶物地圖(2)	Treasure Map of the Stonemason's Family (2)	석공가문의 보물지도(2)
石匠家族的寶物地圖(3)	Treasure Map of the Stonemason's Family (3)	석공가문의 보물지도(3)
石匠家族的寶物地圖(4)	Treasure Map of the Stonemason's Family (4)	석공가문의 보물지도(4)
探險家的委託(1)	Adventurer's Favor (1)	탐험가의 부탁(1)
能夠找到	I can find it	찾아줄 수 있다고 한다
探險家的委託(2)	Adventurer's Favor (2)	탐험가의 부탁(2)
永遠的探險(1)	The Eternal Adventure (1)	영원한 탐험(1)
就這樣離開吧	Leave	그만 떠난다
尋找巴奇斯的資料中	Looking for the documents of Varkis	바키스의 자료를 찾는 중
永遠的探險(2)	The Eternal Adventure (2)	영원한 탐험(2)
尋找巴奇斯藏起來的材料中	Looking for the documents Varkis hid	바키스가 숨겨둔 자료 찾는 중
上面寫著阿帕堤懸崖裡藏有下個材料	It is written that the next document is hidden at Apatinis Cliff	아파티 벼랑에 다음 자료를 숨겨 두었다고 적혀 있습니다
永遠的探險(3)	The Eternal Adventure (3)	영원한 탐험(3)
追思著他們(1)	In their Honor (1)	그들을 추모하며(1)
我願意幫忙	I'll accept your request	부탁을 들어 주겠다고 한다
我很忙	I'm busy	바쁘다고 한다
追思著他們(2)	In their Honor (2)	그들을 추모하며(2)
太貴了	Tell him that it's too expensive	너무 비싸다고 한다
追思著他們(3)	In their Honor (3)	그들을 추모하며(3)
我要去一趟	I'll go there	다녀오겠다고 한다
親自去做會比較好	I think you better do it yourself	직접 하는 게 더 좋을 것 같다고 한다
空間縫隙中的鑰匙	The Keys Within the Spatial Gap	공간의 틈새 속 열쇠
我會去找鑰匙	I'll find the keys	열쇠를 찾겠다고 한다
到此為止吧	I'd like to stop	그만 두겠다고 한다
邪靈祭司的符咒[邪靈祭司轉職]	Charm of a Bokor [Bokor Advancement]	보코르의 부적[보코르 전직]
去收集怪獸血液	Go and gather monster's blood	몬스터의 혈액을 모으러 간다
TP商店使用方法	How to Use the TP Shop	TP샵 이용법
嘗試釣魚	Try Fishing	낚시 해보기
傳說卡片片欄位封印解除	Unlock Legend Card Slot	레전드 카드 슬롯 봉인 해제
無法稱心如意的(1)	Not as Intended (1)	뜻대로 되지 않는(1)
我會幫忙回收補給品	I'll help you retrieve the supplies	보급품 회수를 돕겠다고 제안한다
封鎖區域的結界石	Crystal Wall of the Closed Area	폐쇄된 구역의 결계석
誠實的記錄官(1)	Crazy Archivist (1)	실성한 기록관(1)
如果遇見的話，就會帶回來	I will bring him back if I find him	만약 보게 된다면 데려다 주겠다고 한다
安慰說能夠找到	I will search for him	찾을 수 있을 거라고 위로한다
札卡里耶爾的眼睛(2)	Eyes of Zachariel (2)	자카리엘의 눈(2)
我要點火	I will light the signal	불을 피우겠다고 한다
這樣會有負擔	It feels like a burden	부담스럽다고 한다
史學家凱佩克(1)	Historian Kepeck (1)	사학자 케펙(1)
史學家的小技倆	Historian's Trick	사학자의 꼼수
觀察周圍	Look around	주위를 둘러본다
史學家凱佩克(3)	Historian Kepeck (3)	사학자 케펙(3)
雖然不清楚情況，但我會幫忙	I'll help even though you don't know what it is	뭔진 몰라도 일단 도와주겠다고 한다
我並不是來幫忙工作的	I didn't come here to help	일을 도와주러 온 것이 아니라고 한다
記錄中	Recording	기록 중
消失的研究員(1)	Missing Researcher (1)	사라진 연구원(1)
直接走吧	Just go	그냥 간다
妨礙營業(1)	Business Interference (1)	영업 방해(1)
回去吧	Just go back	그냥 돌아가자
妨礙營業(2)	Business Interference (2)	영업 방해(2)
接受提議	Accept the suggestion	제안을 받아 들인다
關於奇怪的結界	About the strange barrier	이상한 결계에 대해
消失的研究員(2)	Missing Researcher (2)	사라진 연구원(2)
我要去拯救艾伊里奈	I'll save Airine	아이리네를 구하러 가겠다고 한다
去找傭兵吧	Call the mercenary	용병을 부르라고 한다
消失的研究員(3)	Missing Researcher (3)	사라진 연구원(3)
我會盡快解除結界裝置，稍微忍耐一下吧	Inform her to hold on until the barrier devices are deactivated	결계장치를 빨리 풀 테니 조금만 참으라고 한다
戴志克說會幫忙	Inform her that Dezic will help	데지크가 구해 줄 것이라고 한다
我會去捕捉薩厄加收集線索	I'll gather some clues by defeating Sauga	사우가를 잡아 단서를 모아보겠다고 한다
關於失蹤	About the disappearances	실종에 대해
消失的研究員(4)	Missing Researcher (4)	사라진 연구원(4)
準備保護艾伊里奈	Prepare to protect Airine	아이리네를 지킬 준비를 한다
逃跑	Run away	도망간다
消失的研究員(5)	Missing Researcher (5)	사라진 연구원(5)
一路順風	Say goodbye	잘 돌아가라고 인사한다
我認為稍微休息一下會比較好	Tell her that it would be better to take some rest here	조금만 쉬었다 가는 게 좋을 것 같다고 한다
新王陵研究員的委託(1)	New Researcher's Favor (1)	신입 왕릉 연구원의 부탁(1)
我會幫忙找	I'll find it for you	대신 찾아 주겠다고 한다
鼓勵說好好加油	Cheer up	힘내라고 격려한다
關於大王關口	About the Gate of the Great King	대왕의 관문에 대해
新王陵研究員的委託(2)	New Researcher's Favor (2)	신입 왕릉 연구원의 부탁(2)
新王陵研究員的委託(3)	New Researcher's Favor (3)	신입 왕릉 연구원의 부탁(3)
誠實的記錄官(2)	Crazy Archivist (2)	실성한 기록관(2)
這裡太危險，還是快點回去吧	Persuade him to go back since this place is too dangerous	그래도 이 곳은 위험하니 돌아가자고 설득한다
誠實的記錄官(3)	Crazy Archivist (3)	실성한 기록관(3)
我要去找達比歐	I will go see Davio	다비오에게 가 본다고 한다
使用藥似乎沒有什麼效果	Tell him that the medicine won't be effective	약으로 될 것 같지 않다고 한다
關於記錄官尤那斯	About the Archivist Jonas	기록관 요나스에 대해
恢復的記憶	Returned Memories	돌아온 기억
我會跟上去的	I will follow you	따라가겠다고 한다
既然事情已經做完了，我要離開了	My work is done so I'll be going now	할 일을 했으니 가보겠다고 한다
哥拉斯的擔憂(3)	Gorath's Concern (3)	고라쓰의 걱정(3)
莫雷克不在那邊	Tell him that Molich wasn't there	몰렉은 없었다고 한다
因為太恐怖而刻意忽視	Ignore since you are scared	무서우니까 무시한다
札卡里耶爾的眼睛(1)	Eyes of Zachariel (1)	자카리엘의 눈(1)
我會證明自己符合資格的	I am qualified	자격을 증명하겠다고 한다
似乎不太需要的樣子	I won't need it	필요 없을 것 같다고 한다
關於大王的秘寶	About the secret treasures of the Great King	대왕의 비보에 대해
尤那斯的藥(2)	Jonas' Medicine (2)	요나스의 약(2)
取得峽谷梅圖斯	I'll bring you the Canyon Metos	협곡 메토스를 구해온다
我之後會帶回來	I will get it later	나중에 구해 오겠다고 한다
尤那斯的藥(1)	Jonas' Medicine (1)	요나스의 약(1)
我會把金飾品帶回來	I will bring the gold	금붙이를 가져 오겠다고 한다
我沒有理由給	I don't have a reason to give it to him	내가 낼 이유는 없다고 한다
關於尤那斯的狀態	About Jonas' Status	요나스의 상태에 대해
尤那斯的藥(3)	Jonas' Medicine (3)	요나스의 약(3)
我會去找尤那斯	I will go see Jonas	요나스에게 가 보겠다고 한다
我之後會帶來	I will bring it later	나중에 갖다 주겠다고 한다
史學家凱佩克(2)	Historian Kepeck (2)	사학자 케펙(2)
我會幫忙回收支援品	I will bring the supplies back	지원품을 되찾아 주겠다고 한다
休息一下在慢慢找吧	Tell her to take some rest and look for them slowly	쉬고 나서 천천히 찾으라고 한다
淨化1層有毒蒸氣	Purify the Toxic Fumes in 1F	1층 유독증기 정화
詢問修理淨化裝置的方法	Ask how to repair the purifier	정화 장치를 수리하는 방법에 대해 묻는다
應該不會太困難	That seems difficult	어려울 것 같다고 한다
缺少零件的入口淨化裝置	Incomplete Purifier	부품이 빠진 입구 정화장치
確認淨化裝置中	Checking the Purifier	정화장치 확인 중
修理淨化裝置中	Repairing the Purifier	정화장치 수리 중
淨化2樓有毒蒸氣	Purify the Toxic Fumes in 2F	2층 유독증기 정화
修理中央淨化裝置(1)	Fix the Central Purifier (1)	중앙 정화장치 수리(1)
開閥門中	Opening the Valve	밸브 여는 중
修理中央淨化裝置(2)	Fix the Central Purifier (2)	중앙 정화장치 수리(2)
替換零件中	Changing the Part	부품 교체 중
水晶礦山獨眼巨人的襲擊	Cyclops' Attack in the Crystal Mine	수정광산 사이클롭스의 습격
啟動通道淨化裝置(1)	Activate the Passage Purifier (1)	통로 정화장치 가동(1)
啟動通道淨化裝置(2)	Activate the Passage Purifier (2)	통로 정화장치 가동(2)
啟動通道淨化裝置(3)	Activate the Passage Purifier (3)	통로 정화장치 가동(3)
循環淨化裝置的問題(1)	Circulation Purifier Issues (1)	순환 정화장치의 문제(1)
確認淨化管中	Checking the Purifier Pipe	정화관 확인 중
啟動淨化裝置中	Activating the Purifier	정화장치 작동 중
循環淨化裝置的問題(2)	Circulation Purifier Issues (2)	순환 정화장치의 문제(2)
循環淨化裝置的問題(3)	Circulation Purifier Issues (3)	순환 정화장치의 문제(3)
啟動淨化裝置中	Activating the purifier	정화장치 가동 중
停止啟動的輔助淨化裝置(1)	Inoperable Auxiliary Purifier (1)	작동을 멈춘 보조 정화장치(1)
停止啟動的輔助淨化裝置(2)	Inoperable Auxiliary Purifier (2)	작동을 멈춘 보조 정화장치(2)
停止啟動的輔助淨化裝置(3)	Inoperable Auxiliary Purifier (3)	작동을 멈춘 보조 정화장치(3)
上油中	Applying the Oil	기름칠 하는 중
停止啟動的輔助淨化裝置(4)	Inoperable Auxiliary Purifier (4)	작동을 멈춘 보조 정화장치(4)
重新啟動輔助淨化裝置。	The Auxiliary Purifier is working again	보조 정화장치가 다시 작동합니다
破壞主淨化裝置的犯人(1)	Destroyer of the Main Purifier (1)	주 정화장치의 파괴범(1)
破壞主淨化裝置的犯人(2)	Destroyer of the Main Purifier (2)	주 정화장치의 파괴범(2)
回收零件中	Collecting the Parts	부품 회수 중
破壞主淨化裝置的犯人(3)	Destroyer of the Main Purifier (3)	주 정화장치의 파괴범(3)
已點亮營火	Bonfire lit up	모닥불이 켜졌습니다
王室的封印(1)	Seal of the Royal Family (1)	왕가의 봉인(1)
前往拉姆斯堤斯峽谷解除封印	I'll go to Ramstis Ridge and release the seals	람스티스 협곡으로 가서 봉인을 풀겠다고 한다
王室的封印(2)	Seal of the Royal Family (2)	왕가의 봉인(2)
我會解除封印	I will unleash the seal	봉인을 풀겠다고 한다
到此為止吧	I won't do it anymore	그만 하겠다고 한다
召募傭兵(1)	Recruiting Mercenaries (1)	용병 모집(1)
我很有興趣	I am interested	관심 있다고 한다
召募傭兵(2)	Recruiting Mercenaries (2)	용병 모집(2)
我會去拾取能當作證據的盜墓裝備	I'll pick up and bring the tools for excavation for evidence	증거가 될 만한 도굴 장비를 주워 오겠다고 한다
我不要做那種事情	I won't do such job	그런 일은 하지 않겠다고 한다
無止盡的委託(1)	Unfinished Commission (1)	끝나지 않은 의뢰(1)
我會去尋找遺物	I will find the artifacts	유물을 찾아 주겠다고 한다
去找更強的人	Tell him to look for more stronger person	더 강한 사람을 찾으라고 한다
關於吃石頭的怪物	About the monsters that eat stones	돌을 먹는 몬스터에 대해
觀察石材中	Looking at the stone	석재를 살펴 보는 중
無止盡的委託(2)	Unfinished Commission (2)	끝나지 않은 의뢰(2)
我會幫忙消滅怪物	I will help in defeating the monsters	몬스터 처치를 도와 주겠다고 한다
阿爾庫內階梯下方的石柱	The Stone Pillar Beneath Alkune Stairway	알쿠네 계단 아래쪽의 돌기둥
阿爾庫內階梯正下方的石柱	The Stone Pillar Above Alkune Stairway	알쿠네 계단 바로 위의 돌기둥
在柱子上採集石頭中	Collecting the stones from the pole	기둥에서 돌 채취 중
長橋溪谷角落的石柱	The Stone Pillar at Overlong Bridge Valley	긴다리 계곡 구석의 돌기둥
商人的傭兵	Merchant's Mercenary	상인의 용병
如果遇見的話，會轉告他快點回營區	Tell him that you will tell them to go back to the camp if you see them	보게 되면 캠프로 돌아가라는 말을 전해 주겠다고 한다
利特的苦衷	Lindt's Matters	린트의 사정
我會幫忙尋找補給品	I will help finding the supplies	보급품을 찾는 것을 도와 주겠다고 한다
我已經幫忙傳話，現在要離開了	Tell him you will go since you passed the words	말을 전했으니 가겠다고 한다
有效的鎮痛劑	Effective Painkillers	효과적인 진통제
那種程度我能夠幫忙	I will get them	그 정도는 구해줄 수 있다고 한다
我身上沒有任何東西	I don't have anything	가지고 있는 것이 없다고 한다
準備回家	Ready to Return Home	귀가 준비
為了利特消滅怪物吧	Defeat monsters for Lindt	린트를 위해 몬스터를 처치해 주자
適當休息後在離開吧	Take a rest before you go	적당히 쉬었다 가라고 한다
關於薩厄加斯的情報(1)	Information about Saugas (1)	사우가스에 대한 정보(1)
我會幫助埃塔	Then I'll help Eta	그럼 에타를 돕겠다고 한다
太逞強了	That is impossible	무리라고 말한다
關於薩厄加斯的情報(2)	Information about Saugas (2)	사우가스에 대한 정보(2)
關於薩厄加斯的情報(3)	Information about Saugas (3)	사우가스에 대한 정보(3)
我會試試看	I will try	해보겠다고 한다
自己看著辦吧	Tell him to do it himself	그냥 알아서 하라고 한다
放石頭中	Putting the stones	돌을 놓는 중
關於薩厄加斯的情報(4)	Information about Saugas (4)	사우가스에 대한 정보(4)
我會試著再設置看看	Tell him to install it again	다시 설치해 보겠다고 한다
親自去試試看吧	Tell him to do it himself	직접 하라고 한다
尋找補給隊隊長皮歐的部下	Find the Supply Commander's Junior	보급대 대장 비오의 부하 찾기
王室的封印(4)	Seal of the Royal Family (4)	왕가의 봉인(4)
我會解開聖所的封印	I will unleash the seal of the divine place	성소의 봉인을 풀겠다고 한다
關於札卡里耶爾王的封印	About King Zachariel's seal	자카리엘 왕의 봉인에 대해
解除封印中	Unleashing the seal	봉인 해제 중
探訪礦山村莊(1)	Investigating Miners' Village (1)	광산 마을 탐문(1)
回收救濟品	Aid Recovery	구호품 회수
我會去回收救濟品	I'll help retrieve the relief supplies	구호품 회수를 돕겠다고 한다
礦山所長布林肯的獻身(1)	Mine Manager Brinker's Dedication (1)	광산 소장 브링커의 헌신(1)
我會收集適當的石頭	I'll gather some stones for it	적당한 돌을 모아 오겠다고 한다
還是快點逃跑會比較好	Better run away quickly	그냥 빨리 도망가는 것이 좋겠다고 한다
礦山所長布林肯的獻身(2)	Mine Manager Brinker's Dedication (2)	광산 소장 브링커의 헌신(2)
我會去消滅周圍的怪物	I'll defeat the monsters around	주변의 몬스터를 처치해 주겠다고 한다
治療師小姐的煩惱(1)	Healer Lady's Worry (1)	치유사 아가씨의 고민(1)
我會去帶難民回來	I'll bring the refugees	피난민을 데려 오겠다고 한다
說明治療師小姐的位置中	Explaining the location of the Healer Lady	치유사 아가씨의 위치 설명 중
治療師小姐的煩惱(2)	Healer Lady's Worry (2)	치유사 아가씨의 고민(2)
我會去消滅具威脅性的怪物	I'll defeat the menacing monsters	위협적인 몬스터를 처치하겠다고 한다
布貝的侵略	Invasion of the Vubbes	부베의 침략
我要去布貝基地消滅布貝	I'll go to the Vubbe's base and defeat them	부베 기지로 가서 부베들을 처치하겠다고 한다
置之不理	Disregard	외면한다
被綁架的人們	Kidnapped Villagers	납치된 사람들
詢問進入水晶礦山的方法	Ask how to enter the Crystal Mine	수정광산으로 들어 갈 방법을 묻는다
為拜杜塔斯鬆綁中	Releasing Vaidotas	바이도타스를 풀어주는 중
可疑的寶箱	Suspicious Treasure Chest	수상한 보물 상자
前往礦山	To the Mines	광산으로
我要破壞推車	I'm ready to destroy the wagons	수레를 파괴하겠다고 한다
還沒準備好	I'm not yet prepared	아직 준비가 덜됐다고 한다
守護者淨化裝置	Guardian Purifying Device	수호자 정화 장치
前往淨化被汙染的守護者	Go to purify the corrupted Guardian	더럽혀진 수호자를 정화하러 간다
保留	I'll wait a little bit	보류한다
破壞水晶裝置	Destroying the Guardian Device	수호장치 파괴
破壞被汙染的守護裝置	Destroy the corrupted protecting device	더럽혀진 수호장치를 파괴한다
設置誘餌中	Setting the baits	미끼 설치 중
重新利用(1)	Recycling (1)	재활용(1)
讓忘記任務的守護者回歸王陵	Let's remove those Guardians from the Royal Mausoleum	임무를 잊은 수호자를 왕릉으로 되돌리자
重新利用(2)	Recycling (2)	재활용(2)
尋找艾哈特	Let's look for Achat	에하트를 찾아보자
保留	Let's postpone	보류하자
治療師小姐的煩惱(3)	Healer Lady's Worry (3)	치유사 아가씨의 고민(3)
學習技能吧	Learning Skills	스킬을 배워보자
讓技能變熟練	I'd like to learn some skills	스킬을 익혀본다
給我多一點時間考慮	Give me some time to think about it	잠시 고민할 시간을 달라고 한다
請點擊'F3'鍵確認技能。	You can check your skills by pressing the F3 key	'F3' 키를 눌러 스킬을 확인하세요
被染黑的名譽(1)	Black-colored Honor (1)	검게 물든 명예(1)
破壞被汙染的守護者	Destroy the corrupted Guardian	오염된 수호자를 파괴한다
被染黑的名譽(2)	Black-colored Honor (2)	검게 물든 명예(2)
收集濃縮的魔力源	Collect condensed magic power	응축된 마력원을 모아온다
被染黑的名譽(3)	Black-colored Honor (3)	검게 물든 명예(3)
消滅被汙染的守護者	Destroy the corrupted Guardian	오염된 수호자를 처치한다
契約到期	Expired Contract	계약만료
就這麼辦吧	Say that you will do it	그러겠다고 한다
自己親自去轉達吧	Tell him to give it to him directly	직접 전해 주라고 한다
崩潰的守護體系	Collapsed Protection System	무너진 수호체계
修理破碎的王陵守護者	Repair the broken Royal Mausoleum Guardian	부서진 왕릉 수호자를 수리한다
來自森林的不速之客	Unwelcome Guest from the Forest	숲에서 온 불청객
這件事很簡單	It's easy	쉬운 일이라고 한다
礙眼的傢伙們	Irritating Pricks	거슬리는 녀석들
永生的豬籠草(1)	The Immortal Nepenthes (1)	영생의 네펜더스(1)
永生的豬籠草(2)	The Immortal Nepenthes (2)	영생의 네펜더스(2)
我會快去快回	I'll be back quickly	빨리 다녀오겠다고 한다
看起來不太可能的樣子	Impossible	불가능해 보인다고 한다
看守者的潛力(1)	The Watcher's Potential (1)	파수꾼의 저력(1)
立刻同意	Accept immediately	당장 수락한다
看守者的潛力(2)	The Watcher's Potential (2)	파수꾼의 저력(2)
試著再相信一次	Trust him one more time	한 번만 더 믿어본다
我會幫忙消滅魔族	I'll defeat the demons	마족들을 없애 주겠다고 한다
反轉	Obversion	뒤집기
這個意見相當有道理	That's a reasonable opinion	일리 있는 의견이라고 한다
越來越渺茫的希望	Grown Apart From Hope	멀어지는 희망
立刻進行追蹤	I will chase it immediately	바로 추격하기로 한다
還沒準備好	I'm not ready yet	아직 준비가 덜 되었다고 한다
露克立斯的遺產	Ruklys' Inheritance	루클리스의 유산
我會負責修復	I'll restore it	복원하겠다고 한다
請等一下	Wait for a while	잠시 기다리라고 한다
復原紀念碑中	Restoring the Monument	추모비 복원 중
好奇心殺死了金石學者	Curiosity Killed the Epigraphist	호기심이 금석학자를 죽인다
我會陪伴到最後一刻	I'll stay with you till the end	마지막까지 함께 해주겠다고 한다
聖堂正門(3)	The Entrance of the Cathedral (3)	성당 정문(3)
星星的痕跡(6)	Astral Tracing (6)	별의 흔적(6)
變熱的箭頭	Heated Arrowhead	달궈진 화살촉
前往實驗場所	To the Laboratory	실험장소로
準備活祭品	Preparing a live sacrifice	산제물 준비 중
黑暗的存在	A Dark Entity	어두운 존재
最後的命令(4)	The Final Mission (4)	마지막 명령(4)
搭話中	Talking	말 거는 중
詢問為什麼繼續徘徊	Why are you roaming around?	왜 계속 배회하는 물어본다
黑手	Black Hands	검은 손
我會負責消滅巨眼丹提	Defeat Denoptic	덴옵틱을 처치하겠다고 한다
崩潰危險(1)	The Danger of Collapse (1)	붕괴위험(1)
尋找崩潰的地點	I'll find where it is collapsing	붕괴가 진행되고 있는 지점을 찾자
崩潰危險(2)	The Danger of Collapse (2)	붕괴위험(2)
崩潰危險(3)	The Danger of Collapse (3)	붕괴위험(3)
崩潰危險(4)	The Danger of Collapse (4)	붕괴위험(4)
最好阻止王陵被破壞	Better stop them from destroying the Royal Mausoleum	왕릉 파괴를 저지하는 것이 좋겠다
最後的守護者	The Last Guardian	마지막 수호자
消滅貝亞卡拉斯，阻止王陵崩潰	I'll stop Bearkaras and prevent the Royal Mausoleum from collapsing	베아카라스를 처치하여 왕릉의 붕괴를 막자
守護者的甕 (1)	The Guardian's Jar (1)	수호자의 항아리(1)
取得王陵魔力的源泉	I'll save the magic source of the Royal Mausoleum	왕릉 마력의 원천을 구해 온다
還沒準備好	I'm not ready yet	아직 준비가 되지 않았다고 한다
守護者的甕 (2)	The Guardian's Jar (2)	수호자의 항아리(2)
將魔力的源泉倒入甕中	It's time to pour the source of the evil power in the jars	마력의 원천을 항아리에 부으러 가자
還沒準備好	I'm not ready yet	아직 준비가 안되었다고 한다
守護者的甕 (3)	The Guardian's Jar (3)	수호자의 항아리(3)
設置甕中	Placing the pot	항아리 설치 중
守護者的甕 (4)	The Guardian's Jar (4)	수호자의 항아리(4)
向靈魂之甕傳達中	Placing the Soul Pot	영혼의 항아리 전달 중
偉大的人類的王	The King of the Great Humans	위대한 인간의 왕
點燈吧(1)	Light the Fire (1)	불을 밝혀라(1)
前往開啟石燈	Let's go light the stone lantern	석등을 키러 가자
注入動力中	Charging the power	동력 넣는 중
點燈吧(2)	Light the Fire (2)	불을 밝혀라(2)
魔力的解放(1)	Liberation of Magic (1)	마력의 해방(1)
收集活性石吧	Let's gather the active stones	활성석을 모아보자
傳達活性石	Handing over the Activation Stones	활성석 전달하기
魔力的解放(2)	Liberation of Magic (2)	마력의 해방(2)
前往破壞王陵魔力抑制器	Go to destroy the evil power suppressor of the Mausoleum	왕릉 마력 억제기를 파괴하러 간다
魔力的解放(3)	Liberation of Magic (3)	마력의 해방(3)
前往破壞剩下的抑制器	Go to destroy the last regulator	나머지 억제기를 파괴하러 간다
隱藏的地方(1)	Hidden Place (1)	숨겨진 곳(1)
收集守護者的力量，尋找隱藏寶物	Let's gather the force of the guardians and find the hidden treasure	수호자의 기운을 모아 숨겨진 보물을 찾자
完全不感興趣	Not interested	관심이 생기지 않는다
王室祕報守護者開口了。	The Guardian of the Royal Family Treasure opened its mouth	왕실 비보 수호자가 입을 열었습니다
隱藏的地方(2)	Hidden Place (2)	숨겨진 곳(2)
尋找秘寶	Find the treasure	비보를 찾으러 간다
放棄	Cancel	그만 둔다
緊急狀況(1)	Emergency (1)	긴급상황(1)
收集魔力源	I'll gather the magic	마력원을 모아 온다
緊急狀況(2)	Emergency (2)	긴급상황(2)
點燃王陵石燈吧	Let's light the stone lanterns of the Royal Mausoleum	왕릉 석등을 점화하자
緊急狀況(3)	Emergency (3)	긴급상황(3)
守護魔力容器	I'll guard the Magic Vessel	마력 용기를 지키러 간다
防止汙染	Prevent the Corruption	오염 방지
尋找被汙染的疙瘩，並且進行消滅	Find the corrupted cores and remove it	오염된 응어리를 찾아 제거한다
被汙染的石燈(1)	Corrupted Lantern (1)	오염된 석등(1)
破壞被汙染的石燈	Destroy the corrupted lanterns	오염된 석등을 파괴한다
確認石燈	Examining the lamp	석등 확인
被汙染的石燈(2)	Corrupted Lantern (2)	오염된 석등(2)
不光榮	Disgrace	불명예
前往破壞王陵魔力控制器	I'll destroy the Royal Magic Control Device	왕릉 마력 제어기를 파괴하러 간다
收集霍倫的信物吧	I'll gather Wheelen's Marks	휠렌의 증표를 모아 보자
不需要	I don't need it	필요없다
取得信物的力量中	Obtaining the marks' power	증표의 힘을 얻는 중
霍倫的強大氣息正逐漸包覆住整個身體。	Wheelen's powerful energy is surrounding your body	휠렌의 강력한 기운이 온 몸을 감싸고 있습니다
召喚守護者	Call the Guardian	수호자 호출
消滅敵對關係的貝奴凱洛斯吧	Let's defeat the hostile Venucelos	적대적인 베누켈로스를 처치하자
王陵的秘寶	Royal Mausoleum's Treasure	왕릉의 비보
試著挑戰王陵的秘寶	Challenge the spell of the Royal Mausoleum	왕릉의 비보에 도전해 본다
不要挑戰	Pass the challenge	도전하지 않는다
我要嘗試看看	I'll try to do it	해 보겠다고 한다
以前的故事(1)	Old Story (1)	옛날 이야기(1)
幫忙尋找哥哥吧	Help find his brother	형님을 찾는 것을 도와주자
以前的故事(2)	Old Story (2)	옛날 이야기(2)
看完碑石內容後我就會回來	I'll go and read the tombstone	비석 내용을 보고 와 주겠다고 한다
以前的故事(3)	Old Story (3)	옛날 이야기(3)
以前的故事(4)	Old Story (4)	옛날 이야기(4)
看完碑石內容後再回來	Read the tombstone and come back	비석의 내용을 보고 온다
確認碑石	Examining the monument	비석 확인
以前的故事(5)	Old Story (5)	옛날 이야기(5)
以前的故事(6)	Old Story (6)	옛날 이야기(6)
以前的故事(7)	Old Story (7)	옛날 이야기(7)
新市場(1)	New Market District (1)	새로운 시장(1)
新市場(2)	New Market District (2)	새로운 시장(2)
詢問是哪一個怪物的行為	Which monster's act is it?	어떤 몬스터의 소행인지 물어 보자
防疫作業(1)	Preventive Measures (1)	방역 작업(1)
防疫作業(2)	Preventive Measures (2)	방역 작업(2)
防疫作業(3)	Preventive Measures (3)	방역 작업(3)
聖堂正門(1)	Church Gate (1)	성당 정문(1)
聖堂正門(2)	Church Gate (2)	성당 정문(2)
我要開啟正門	I'll open the gate	정문을 열겠다고 한다
魔族姊妹	Demon Sisters	마족 자매
我沒時間	I don't have time	시간 없다고 한다
留存在歷史中的騙術(1)	The Legendary Trick (1)	역사에 남을 속임수(1)
看起來很有趣	That seems fun	재밌어 보인다고 한다
這樣太不恭敬了	That's blasphemous	불경스럽다고 한다
留存在歷史中的騙術(2)	The Legendary Trick (2)	역사에 남을 속임수(2)
應該會很有趣	Sounds fun	재밌겠다고 한다
雖然很困難，但我願意嘗試看看	It could be difficult but I'll try	어렵지만 해보겠다고 한다
看來得多加調查魔族才行了	I need to find out more about the demons	좀 더 마족들을 알아봐야 겠다고 한다
啟動中央祭壇	Activate the Central Altar	중앙 제단 작동
我要去確認一下	I'll check on it	확인 해 보겠다고 한다
關於聖堂的祭壇	About the Church's altar	성당의 제단에 대해
確認祭壇中	Examining the altar	제단 확인 중
卡滋卡滋	Nibble Nibble	갉작갉작
我會立刻去處理	I'll take care of it quickly	재빠르게 처리해 주겠다고 한다
等稍微更安全一點時我就會去	I'll go when it is safer	좀 더 안전해지면 가겠다고 한다
標示領域	Mark Territory	영역표시
前往聖堂地下	Church Underground Passage	성당 지하로
已經準備就緒了	I'm ready	준비 되었다고 한다
難以置信	I can't believe it	믿을 수 없다
光的襲擊(1)	Light Attack (1)	빛의 습격(1)
似乎不是什麼好主意	It doesn't seem like a good idea	별로 좋은 생각이 아닌 것 같다
光的襲擊(2)	Light Attack (2)	빛의 습격(2)
我還需要一些準備	I need more preparation	준비가 더 필요하다고 한다
最後一滴為止	Till the Last Drop 	마지막 한 방울까지
我可以幫忙	I can help you	도와 줄 수 있다고 한다
稍微再撐一下吧	Hold on a little longer	조금만 더 버티라고 한다
惡棍	Bully	불량배
這件事太吃力了	That's too much to handle	너무 벅찬 일이라고 한다
黑暗的另一端	Beyond the Darkness	어둠 너머에
我要去1層一趟	I will go to the 1st floor	1층으로 가겠다고 한다
試著尋找其他方法	Look for another way	다른 방법을 찾아본다
傑斯堤的計畫	Gesti's Plan	제스티의 계획
快點去找吧	Let's go and find	어서 찾으러 가자고 한다
先躲起來吧	Hide first	먼저 숨고 보자
佔領鐘塔	Recapture the Bell Tower	종탑 점령
現在立刻出發	Begin immediately	지금 바로 출발한다
說不定傑斯堤還在	Gesti might still be around	아직 제스티가 있을지도 모른다
被搶走的空間的紋章	Stolen Seal of Space	빼앗긴 공간의 문장
我會偷偷帶過來	I will bring it back secretly	몰래 가져오겠다고 한다
我會稍微再觀察一下情況	I'll observe the situation a little more	좀 더 상황을 지켜보겠다고 한다
關於空間的紋章	About the Seal of Space	공간의 문장에 대해
老鼠與貓	Cat and Mouse	쥐와 고양이
會安全回來的	I'll be cautious on my way	조심해서 다녀오겠다고 한다
先觀察傑斯堤的動線	Check Gesti's action and go	제스티의 동선을 살피고 간다
啟動瑪爾達祭壇	Activate the Malda Altar	말다 제단 작동
我會負責啟動祭壇	I'll activate the altar	제단을 작동시키겠다고 한다
不會有事的	It will be okay	괜찮을 거라고 한다
啟動阿霧卡祭壇	Activate the Auka Altar	아우카 제단 작동
沒有問題	No problem	문제 없다고 한다
我要稍微思考一下	I'll think about it for a while	잠시 고민해 보겠다고 한다
整理禮拜堂	Cleaning the Church	예배소 정리
掉進陷阱的傑斯堤	Trapped Gesti	함정에 빠진 제스티
我相信阿爾基斯	I trust you	알기스를 믿겠다고 한다
還沒準備好	I'm not yet ready	아직 준비가 안 됐다
關於聖具	About the Divine Sphere	성구에 대해
聖所潛藏的啟示(1)	The Hidden Sanctum's Revelation (1)	숨겨진 성소의 계시(1)
還有要做的事情	There is still more to do	아직 할 일이 남았다
確認中	Checking	확인하는 중
被破壞的結界	Destroyed Barrier	파괴된 결계
如果是簡單的事情願意幫忙	I'll help if it's simple	간단한 일이라면 도와주겠다고 한다
目前很忙碌	I'm busy on my way	갈 길이 바쁘다고 한다
關於奈普里塔斯懸崖的結界	About the barriers in Nefritas Cliff	네프리타스 벼랑의 결계에 대해
魔族召喚陣	Demon Summoning Circle	마족 소환진
我要破壞魔族召喚陣	I'll destroy the Demon Summoning Circles	마족 소환진을 파괴하겠다고 한다
應該不會有事	It will be fine	별 일 아닐 거라고 한다
一擊送往女神身邊	To the Goddess at Once	한 방에 여신 곁으로
太困難了	It's too difficult	너무 어렵다고 한다
凱奈司的守護者	Kenneth's Protector	케네스의 수호자
我會在休息的期間去消滅魔族	I'll defeat the demons while resting	쉬는 동안 마족들을 처치해 주겠다고 한다
好好撐下去吧	Cheer up and hold on	잘 버텨 보라고 응원해준다
狩獵黃牛	Bull Hunting	황소 사냥
我們一起去吧	I'll go with you	함께 가겠다고 한다
我需要做好心理準備	I need to prepare myself	마음의 준비가 필요하다고 한다
關於追隨者	About the Followers	추종자들에 대해
預見的危機(1)	Foreseen Crisis (1)	예견된 위기(1)
我會詢問看看	I'll ask	물어보겠다고 한다
還沒做好準備	I'm not ready to hear it yet	아직 들을 준비가 안 됐다
預見的危機(3)	Foreseen Crisis (3)	예견된 위기(3)
預見的危機(2)	Foreseen Crisis (2)	예견된 위기(2)
守護者石像的警告	Guardian Stone Statue's Warning	수호자 석상의 경고
消滅被汙染的守護者吧	I'll defeat the corrupted guardians	오염된 수호자를 처치하자
隱藏的寶箱	Hidden Treasure Chest	숨겨진 보물 상자
空石板	Empty Slate	빈 석판
忽視	Ignore it	무시하자
尋找寶物(1)	Treasure Hunting (1)	보물찾기(1)
我會去試著尋找地圖	I'll find the map	지도를 찾아 보겠다고 한다
尋找寶物(2)	Treasure Hunting (2)	보물찾기(2)
尋找寶物(3)	Treasure Hunting (3)	보물찾기(3)
尋找寶物(5)	Treasure Hunting (5)	보물찾기(5)
尋找寶物(4)	Treasure Hunting (4)	보물찾기(4)
解毒劑	Antidote 	해독제
我會去借解毒劑	I'll borrow the Antidote	해독제를 빌려오겠다고 한다
很快就會沒事的	It'll be okay soon	금방 괜찮아질 거라고 한다
啟動裝置	Activate the Device	장치 작동
王陵的秘密場所	Royal Mausoleum's Secret Location	왕릉의 비밀 장소
變得更接近的王的遺產	One Step Closer to the King's Legacy	한발 더 가까워진 왕의 유산
史學家雷克西波的研究(1)	Historian Rexipher's Research (1)	사학자 렉시퍼의 연구(1)
觀察碑文中	Looking at the epitaph	비문을 살펴 보는 중
史學家雷克西波的研究(2)	Historian Rexipher's Research (2)	사학자 렉시퍼의 연구(2)
尋找下一個碑文	Find the next epitaph	다음 비문을 찾으러 간다
移動到下一個碑文所在的場所	Move to where the next epitaph is located	다음 비문이 있는 장소로 이동한다
史學家雷克西波的研究(4)	Historian Rexipher's Research (4)	사학자 렉시퍼의 연구(4)
移動到最後一個碑文所在的場所	Move to a where the last epitaph is located	마지막 비문이 있는 장소로 이동한다
魔族的奸計(2)	Trick of the Demon (2)	마족의 간계(2)
追查雷克西波的行蹤	I follow the whereabouts of Rexipher	렉시퍼의 행방을 쫓는다
不要追	Don't chase	쫓지 않는다
敵我識別功能異常	Friend or Foe Error	피아식별 기능 오작동
最好能消滅一些守護者	Seems like it'd be better to defeat some guardians	수호자를 어느 정도 처지하는 게 좋을 것 같다
扭曲的守護者	Deviated Guardian	어그러진 수호자
消滅虛那印吧	Defeat Shnayim	쉬나임을 처치하자
掃盪偽造者(4)	Mop Up the Forger (4)	위조범 소탕(4)
史學家雷克西波的研究(5)	Historian Rexipher's Research (5)	사학자 렉시퍼의 연구(5)
我會負責去取得	I'll go find it	구하러 가겠다고 한다
我會詢問其他史學家	I'll ask another historian	다른 사학자에게 물어보겠다고 한다
停止尋找雷克西波	Stop looking for Rexipher	렉시퍼를 찾는 것을 그만둔다
史學家雷克西波的真面目	Historian Rexipher's Identity	사학자 렉시퍼의 정체
確實是那個名字沒錯	I'm sure that is the name	그 이름이 확실하다고 한다
放棄尋找雷克西波	Stop looking for Rexipher	렉시퍼를 찾는 것을 포기한다
雷克西波的本性(1)	Rexipher's True Colors (1)	렉시퍼의 본색(1)
好像不是吧	I don't think so	아닌 것 같다고 한다
雷克西波的本性(2)	Rexipher's True Colors (2)	렉시퍼의 본색(2)
雷克西波的本性(3)	Rexipher's True Colors (3)	렉시퍼의 본색(3)
向雷克西波說明有關信物的事	Explain about Rexipher and the symbols	렉시퍼와 증표에 대해 설명해 준다
還是安靜一點會比較好	Better keep quiet	말을 아끼는 게 좋을 것 같다
關於這個地方的祭壇	About the Altar here	이 곳의 제단에 대해
雷克西波的本性(4)	Rexipher's True Colors (4)	렉시퍼의 본색(4)
我要去一趟	I will go	가 보겠다고 한다
雷克西波的本性(5)	Rexipher's True Colors (5)	렉시퍼의 본색(5)
當地調度(1)	Self Sufficiency (1)	현지 조달(1)
關於露克立斯	About Ruklys	루클리스에 대해
當地調度(2)	Self Sufficiency (2)	현지 조달(2)
碎片追蹤者	Fragment Finder	조각 추적자
先去尋找其他物品	Find other things first	다른 것부터 찾는다
關於露克立斯的紀念碑	About Ruklys memorial	루클리스의 추모비에 대해
寶物遺跡(1)	Protect the Heritage (1)	유적보호(1)
我要去尋找紀念碑碎片	I'll find the piece of memorial	추모비 조각을 찾아보겠다고 한다
寶物遺跡(2)	Protect the Heritage (2)	유적보호(2)
這個想法太危險了	It's too dangerous	너무 위험한 생각이다
熟悉牧師的特性	Learn Cleric Attributes	클레릭 특성 익히기
聽取關於特性的說明	Listen to the explanation about Attributes	특성에 대해 설명을 듣는다
不想聽	Skip the explanation	듣지 않는다
協商(1)	Negotiation (1)	협상(1)
不是	No	아니라고 한다
塞希查走廊的監視者	Beholder of Sesija Entrance	세시자 도열주랑의 감시자
啟動裝置中	Activating the device	장치를 작동시키는 중
協商(2)	Negotiation (2)	협상(2)
欺瞞者雷克西波	Swindler Rexipher	기만자 렉시퍼
我要去王陵追捕雷克西波	I'll chase Rexipher at the Royal Mausoleum	렉시퍼를 쫓아 왕릉으로 가겠다고 한다
我還需要準備一下	I still need more preparation	아직 준비가 필요하다고 한다
在陸地上享受的釣魚(1)	Fishing on Land (1)	땅 위에서 즐기는 낚시(1)
最好不要刻意找麻煩	Better not touch it unless necessary	괜히 건들지 않는 게 좋겠다고 한다
在陸地上享受的釣魚(2)	Fishing on Land (2)	땅 위에서 즐기는 낚시(2)
學習熱情(2)	Ardor for Study (2)	학구열(2)
放置護身符中	Putting the amulet	호신부 놓는 중
學習熱情(3)	Ardor for Study (3)	학구열(3)
修理練習用木人(1)	Repair the Practice Wooden Seal (1)	연습용 목인 수리(1)
我要修理練習用木人	I will repair the practice wooden seal	연습용 목인을 수리하겠다고 한다
實力證明	Proving skills	실력증명
我接受這項賭注	I will accept that bet	그 내기 받아들이겠다고 한다
死亡體驗者	The One Who Experienced Death	죽음을 체험한 자
說要去消滅死靈查普利	I will find and defeat Chapparition	채퍼리션을 찾아 처치하겠다고 한다
我會負責將鑰匙	Not Able to Meet Again	다시는 만날 수 없는
交給再也無法見面的妹妹	I will find your sister and give her the necklace	동생을 찾아 목걸이를 전해 주겠다고 한다
跑腿者的可疑委託	Messenger's Suspicious Favor	심부름꾼의 수상한 부탁
我願意幫忙跑腿	I'll do the errand	심부름을 해 주겠다고 한다
傭兵利特的委託	Mercenary Lindt's Favor	용병 린트의 부탁
我會幫忙分配食物的	I'll share the food	음식을 나누어 주겠다고 한다
史學家寇林的委託	Historian Colin's Favor	사학자 콜린의 부탁
我會燒毀祭文，藉此撫慰靈魂	I will burn the oration and comfort the souls	제문을 태워 넋을 달래 주겠다고 한다
修理練習用木人(2)	Repair the Practice Wooden Seal (2)	연습용 목인 수리(2)
熟悉劍士的特性	Learn Swordsman Attributes	소드맨 특성 익히기
聽取關於特性的說明	Learn about the attributes	특성에 대해 설명 듣는다
熟悉法師的特性	Learn Wizard Attributes	위저드 특성 익히기
熟悉弓箭手的特性	Learn Archer Attributes	아처 특성 익히기
不怕死的傢伙們	The Fearless Ones	겁 없는 녀석들
我去教訓他一頓	I'll teach them a lesson	혼내주고 오겠다고 한다
那種事情自己去做吧	Leave if for him to do it himself	그런 건 직접하라고 놔둔다
關於看守者	About the Watchers	파수꾼들에 대해
零件竊賊	The Parts Thief	부품 도둑
我會幫忙帶過來	I'll get it to you	가져다 준다고 한다
關於纜車的修理	About repairing the cable car	케이블 카 수리에 대해
尋找控制桿	Finding the Lever Handle Latches	레버를 찾아라
我會負責帶回來	I'll bring it 	가져오겠다고 한다
看守者的夢想(1)	Fantasy of the Watcher (1)	파수꾼의 몽상(1)
關於潘圖族	About the Pantos	판토족에 대해
回收再生用品	Collecting Cable Car Parts	재활용품 수거
安慰後離開	That's too bad (leave)	위로하고 떠난다
關於神聖之地	About the Holy Land	신성한 땅에 대해
斯拉屋塔斯峽谷的暴君	Tyrant of the Srautas Gorge	스라우타스 협곡의 폭군
我要去狩獵波亞塔	I'll go and hunt the Poata	포아타를 사냥하러 가겠다고 한다
關於纜車	About the cable car	케이블 카에 대해
玷污中	Making it dirty	더럽히는 중
看守者的夢想(2)	Fantasy of the Watcher (2)	파수꾼의 몽상(2)
雖然有些不安，我會嘗試看看	I'm not sure but I'll give it a shot	불안하지만 해보겠다고 한다
計畫看起來有些危險	Seems like a dangerous plan	계획이 위험해 보인다고 한다
關於卡普里亞	About the Capri	카프리아에 대해
撫摸中	Petting	쓰다듬는 중
逼近的侵略	Imminent Invasion	임박한 침략
自然的種子	Natural Seeds	자연산 씨앗
關於盟約	About the Pledge	맹약에 대해
顛覆的圖騰(1)	Unsettled Totems (1)	속 뒤집어지는 토템(1)
顛覆的圖騰(2)	Unsettled Totems (2)	속 뒤집어지는 토템(2)
搜查中	Searching	수색 중
淨化人偶(1)	Purifying Doll (1)	정화 인형(1)
關於受魔氣汙染的大地	About the corrupted land with evil energy	마기에 오염된 땅에 대해
淨化人偶(2)	Purifying Doll (2)	정화 인형(2)
刺激(激活)中	Stimulating	자극 중
僅僅套牢	Tie Tightly	꽉 묶기
關於咒術人偶	About the Cursed Doll	주술인형에 대해
一石二鳥	Two Birds with One Stone	일석이조
解放薩勒女神(1)	Release Goddess Saule (1)	사울레 여신 해방(1)
我需要時間準備	I need more time to prepare	준비 할 시간이 필요하다고 한다
被束縛的女神	Entrapped Goddess	구속된 여신
特雷基斯後院的束縛魔法陣	Drugys Courtyard's Binding Magic Circle	드루기스 안뜰의 구속 마법진
勃斯巴空地的束縛魔法陣	Vapsva Vacant Lot's Binding Magic Circle	밥스바 공터의 구속 마법진
解放薩勒女神(2)	Release Goddess Saule (2)	사울레 여신 해방(2)
等待力量完全恢復	Wait until my strength is fully recovered	힘이 완전히 돌아오기를 기다린다
解放薩勒女神(3)	Release Goddess Saule (3)	사울레 여신 해방(3)
我會去消滅周圍的怪物	I'll defeat the monsters nearby	주변의 몬스터를 처치하고 오겠다고 한다
解放薩勒女神(4)	Release Goddess Saule (4)	사울레 여신 해방(4)
薩勒女神	Goddess Saule	사울레 여신
清除束縛球中	Removing the Restraining Sphere	구속구 제거 중
前往大王關口	To Gateway of the Great King	대왕의 관문으로
拿出啟示	Show the revelation	계시를 보여 준다
尋找薩勒女神	Searching for Goddess Saule	사울레 여신을 찾아서
我會去淨化池塘	I'll purify the pond	연못을 정화해주겠다고 한다
試著思考其他方法	Think of another way	다른 방법을 생각해 본다
關於薩勒女神	About Goddess Saule	사울레 여신에 대해
請利用纜車移動到對面的茲貝澤空地	Use the cable car to move to across Zvelgian Vacant Lot	케이블카를 이용하여 건너편의 즈벨쟌 공터로 이동하세요
請去淨化神聖的池塘	Purify the Holy Pond	신성한 연못을 정화하러 가세요
淨化神聖的池塘	Purify the Holy Pond	신성한 연못 정화
淨化中	Purifying	정화하는 중
搜索消失的村民	Search for the Missing Villager	사라진 마을 주민 수색
我要去尋找村民	I'll look for him	마을 주민을 찾아 보겠다고 한다
確認傳點的啟動狀態	Checking the Portal	포탈 작동 확인
我會幫忙去一趟聖所	I'll check the sanctum for you	대신 성소에 다녀 오겠다고 한다
擔心傷口	Worry about the wound	상처를 걱정한다
關於傳點	About the portal	포탈에 대해
傳點無法啟動	The portal is not working	포탈이 작동하지 않습니다
奴葛里亞聖所的莫亞班羅喀	Nugria Sanctum's Moyabruka	누그리아 성소의 모야브루카
清除貝伊特瑪上坡路的汙染源	Removing Pollutants in Veidma Uphill	베이드마 오름길의 오염원 제거
神聖的池塘的蒙雷幾那	Holy Pond's Merregina	신성한 연못의 머레지나
危機的少女	Girl in Danger	위기의 소녀
機會與準備	Oppotunity and Preparation	기회와 준비
我會去負責去取得物品	I'll find what you want	원하는 것을 구해 오겠다고 한다
蓋上書本	Close book	책을 덮는다
我會很感謝地收下	I appreciate it	감사히 받겠다고 한다
用鑰匙開箱子中	Opening the chest with the key	열쇠로 상자 여는 중
芝麻開門(1)	Open Sesame (1)	열려라 참깨(1)
我會去尋找線索，給我提示吧	I'll find the clue so give me a hint	단서를 찾아 올 테니 힌트를 달라고 한다
芝麻開門(2)	Open Sesame (2)	열려라 참깨(2)
我會解開謎題	I'll solve the riddle	수수께끼를 풀겠다고 한다
無止盡的委託(3)	Unfinished Commission (3)	끝나지 않은 의뢰(3)
我要去尋找遺物	I'll find the artifact	유물들을 찾아 오겠다고 한다
霍克瑪們的寶箱	Hogma's Treasure Chest	호그마들의 보물상자
警備兵的委託(1)	Security Guard's Favor (1)	경비병의 부탁(1)
我會去找箱子	I'll find that chest of yours	상자를 찾아 주겠다고 한다
視而不見繼續向前走	Just ignore it and go your way	그냥 무시하고 갈 길을 간다
警備兵的委託(2)	Security Guard's Favor (2)	경비병의 부탁(2)
我會去幫忙收集，不要太擔心	Do not worry I'll collect them	모아다 줄 테니 걱정말라고 한다
那種事情自己看著辦吧	Take care of such things by yourself	그런 일 쯤은 알아서 하라고 한다
來歷不明的石板(1)	Mysterious Slate (1)	정체불명의 석판(1)
請回到柯拉佩達並與騎士團長烏斯卡進行對話。	Talk to Knight Commander Uska after going back to Klaipeda	클라페다로 돌아가 기사단장 우스카와 대화해 보세요
來歷不明的石板(2)	Mysterious Slate (2)	정체불명의 석판(2)
我會去找邪靈祭司大師	I'll go visit the Bokor Master	보코르 마스터를 찾아가겠다고 한다
要再稍微考慮一下	I'll think about it little more	잠시 더 생각해보겠다고 한다
來歷不明的石板(3)	Mysterious Slate (3)	정체불명의 석판(3)
我會去找聖殿十字軍大師	I'll go and meet the Paladin Master	팔라딘 마스터를 찾아 가겠다고 한다
使用狀態	Using Status Points	스테이터스 사용
試著使用狀態	Try increasing a Status	스테이터스를 사용해본다
請點擊'F1'鍵確認狀態	Check your status by pressing the F1 key	'F1' 키를 눌러 스테이터스를 확인하세요
回去的路	The Road Back 	돌아가는 길
無法稱心如意的(2)	Not As Intended (2)	뜻대로 되지 않는(2)
王室的封印(3)	Seal of the Royal Family (3)	왕가의 봉인(3)
我會解除最後的封印	I'll release the final seal	마지막 봉인을 해제하겠다고 한다
我需要一點時間準備	I need a minute prepare	잠깐 준비할 시간이 필요하다고 한다
奇怪的石頭	Strange Stone	이상한 돌
仔細端詳石頭	Touch the stone to look closely	돌을 자세히 볼 수 있도록 만져본다
第一項任務	The First Mission	첫임무
我很好奇	I'm curious	궁금하다고 한다
我一點都不好奇	I don't want to know	별로 궁금하지 않는다고 한다
學習熱情(1)	Ardor for Study (1)	학구열(1)
學習熱情(4)	Ardor for Study (2)	학구열(4)
拓本中	Making a rubbing	탁본 중
遭受襲擊的史學家	Raided Historian	습격당한 사학자
和尼安的石頭產生相同的反應，快點躲開吧	It reacts the same just like Nian's stone	니안의 돌과 같은 반응이니 빨리 피하라고 한다
沒什麼好大驚小怪的	It's nothing serious	별 일 아닐거라고 한다
尋找其他史學家	Find the other historian	다른 사학자를 찾는다
哥拉斯的擔憂(1)	Gorath's Concern (1)	고라쓰의 걱정(1)
哥拉斯的擔憂(2)	Gorath's Concern (2)	고라쓰의 걱정(2)
我會幫忙尋找研究資料	I'll help you find the research data	연구자료를 찾는 것을 도와주겠다고 한다
快點找到後就回去吧	Find it and go back quickly	빨리 찾고 돌아가라고 한다
關於遺失的研究資料	About the loss of research data	연구자료 분실에 대해
掃盪偽造者(1)	Mop Up the Forger (1)	위조범 소탕(1)
就是那些鼎鼎大名的偽造天才	It's the famous genius of forgery	그 유명한 위조의 천재들이라고 한다
你找錯地方了	You came to the wrong place	잘못 찾아왔다고 한다
掃盪偽造者(2)	Mop Up the Forger (2)	위조범 소탕(2)
我會去取得石灰	I'll get you your lime	석회를 구해 오겠다고 한다
我沒辦法做那種骯髒的事情	I can't do such dirty job	그런 더러운 일은 못하겠다고 한다
掃盪偽造者(3)	Mop Up the Forger (3)	위조범 소탕(3)
雕刻家喜爾達的資料(1)	Sculptor Hilda's Data (1)	조각가 힐다의 자료(1)
如果看見的話，我會告訴你的	I'll let you know when I see it	보게 되거든 알려 주겠다고 한다
雕刻家喜爾達的資料(2)	Sculptor Hilda's Data (2)	조각가 힐다의 자료(2)
我可以保護你	I can protect you	보호해 줄 수 있다고 한다
雕刻家喜爾達的資料(3)	Sculptor Hilda's Data (3)	조각가 힐다의 자료(3)
到此為止了吧	Let's stop now	이제 그만 하자고 한다
王者之言	Words of the King	왕의 말씀
回收王陵石板碎片	Retrieve the Royal Tombstone Piece	왕릉 석판 조각을 회수한다
魔族的奸計(1)	Trick of the Demon (1)	마족의 간계(1)
我要去保護王陵石燈	I'll guard the stone lantern of the Royal Mausoleum	왕릉 석등을 지키러 간다
王室的遺產(1)	Legacy of the Royal Family (1)	왕가의 유산(1)
我會負責帶樹液回來	I'll get the sap	수액을 받아 오겠다고 한다
我的意願並不高	I don't feel like it	별로 내키지 않는다고 한다
關於取得大王秘寶的方法	About obtaining the secret of the Great King	대왕의 비보를 얻는 방법에 대해
王室的遺產(2)	Legacy of the Royal Family (2)	왕가의 유산(2)
我會去取得峽谷阿瑪拉斯	I will get the Canyon Amalas	협곡 아말라스를 구해 오겠다고 한다
奇怪的傢伙們	Weird Fellows	이상한 녀석들
我建議最好努力修練吧	I suggest you train hard	열심히 수련할 것을 권한다
寶物獵人的直覺	Instinct of the Treasure Hunter	보물사냥꾼의 감
我會確認艾當說的話的真實性	I'll check if what Eden says is true	에당의 말이 맞는지 확인해보겠다고 한다
那種事情親自去證明吧	Prove it yourself	그런 건 직접 증명하라고 한다
因為沒有而無法販售	Can't Sell Without It	없어서 못 판다
舉手之勞	I'll do it	겸사겸사 해준다
我先思考一下	Think more about it	좀 더 생각해 본다
空地的寶物	Treasure of the Site	공터의 보물
星星的痕跡(1)	Astral Tracing (1)	별의 흔적(1)
我有興趣	I am interested	관심이 있다고 한다
關於利迪亞夏班	About Lydia Schaffen	리디아 샤펜에 대해
星星的痕跡(2)	Astral Tracing (2)	별의 흔적(2)
星星的痕跡(3)	Astral Tracing (3)	별의 흔적(3)
星星的痕跡(4)	Astral Tracing (4)	별의 흔적(4)
到此為止吧	Stop it here	여기서 그만 둔다
星星的痕跡(5)	Astral Tracing (5)	별의 흔적(5)
弗羅里的碑文(1)	Flurry's Epitaphs (1)	플러리의 비문(1)
弗羅里的碑文(2)	Flurry's Epitaphs (2)	플러리의 비문(2)
我不清楚在哪裡，還是算了吧	Let's quit since you don't know where it is	어디에 있는지 모르니 그만 두자
剩下的部分毀損，無法閱讀	The remaining parts are unreadable	나머지 부분은 파손되어 읽을 수 없습니다
弗羅里的碑文(3)	Flurry's Epitaphs (3)	플러리의 비문(3)
答應委託	I'll do that for you	부탁을 들어 준다
弗羅里的碑文(4)	Flurry's Epitaphs (4)	플러리의 비문(4)
尋找碑文	Find the Epitaph	비문을 찾아간다
弗羅里的碑文(5)	Flurry's Epitaphs (5)	플러리의 비문(5)
弗羅里的碑文(6)	Flurry's Epitaphs (6)	플러리의 비문(6)
作業準備	Ready	작업 준비
整理完後我就會回來	I'll go and arrange it	정리하고 온다고 한다
請等一下	I'll wait for a while	잠시 기다리고 한다
遺失的物品(1)	Lost Material (1)	잃어버린 물건(1)
遺失的物品(2)	Lost Material (2)	잃어버린 물건(2)
我想要看召喚惡靈的情況	I want to watch the calling of evil spirits	악령을 소환하는 것을 구경하고 싶다고 한다
完全沒有意願	I don't really want to	내키지 않는다
關於隱情之地	About the Land with story	사연 깊은 땅에 대해
活祭品(蜥蜴人)	Sacrifice (Lizardman)	산제물(리자드맨)
我會帶蜥蜴人回來	I'll bring the Lizardmen	리자드맨을 데려오겠다고 한다
活祭品(因普洛博克)	Sacrifice (Infroburk)	산제물(인프로버크)
我會帶因普洛博克回來	I'll bring the Infroburk	인프로버크를 데려오겠다고 한다
主教的女神之夢(1)	Bishop's Dream of the Goddess (1)	주교가 꾼 여신의 꿈(1)
我要去東邊的森林	I'll go to the Eastern Woods	동쪽 숲으로 가겠다고 한다
我不要去	I don't want to go	가지 않겠다고 한다
膜拜女神像中　	Praying to the Goddess Statue	여신상에 경배 중
最後的命令(1)	The Final Mission (1)	마지막 명령(1)
試著交談	Start conversation	말을 걸어본다
經過	Just pass by	지나친다
調查口袋	Looking through the pocket	주머니 조사하기
最後的命令(2)	The Final Mission (2)	마지막 명령(2)
代替執行作戰	Carry out the plan for him	작전을 대신 수행한다
陳年往事	It's all in the past	지난 일이다
請消滅喬雷並收集喬雷魔石	Defeat Zolem and collect Zolem Magic Stones	졸렘을 처치하고 졸렘 마석을 수집하세요
最後的命令(3)	The Final Mission (3)	마지막 명령(3)
完成樹木山溝作戰	Carry out the Tree Dale plan	나뭇골 작전을 완수한다
繼續準備	Need more preparations	좀 더 준비한다
姆杰老人的真心(1)	Moses' True Feelings (1)	모제 영감의 진심(1)
代替轉達村子青年的想法	Tell Moses about the feelings of the Villager	마을청년의 속마음을 대신 전한다
自己去說吧	Better do that yourself	직접 전하라고 한다
關於亞佳伊拉弗羅里	About Agailla Flurry	아가일라 플러리에 대해
正在傳達凱伊希的內心想法	Conveying Cahill's Feelings	케이힐의 속마음 전달 중
姆杰老人的真心(2)	Moses' True Feelings (2)	모제 영감의 진심(2)
幫忙取得木材吧	Bring the woods	목재를 가져다 주자
態度太奇怪了，還是忽略吧	Not an appealing attitude so just ignore	태도가 이상하니 그냥 무시하자
撿木材	Pick up the firewood	목재 줍기
姆杰老人的真心(3)	Moses' True Feelings (3)	모제 영감의 진심(3)
取得皮革吧	Get the leather	가죽을 구해오자
拜託人的態度讓人不滿意，拒絕吧	Not an appealing attitude so just ignore	부탁하는 태도가 맘에 안 드니 거절하자
姆杰老人的真心(4)	Moses' True Feelings (4)	모제 영감의 진심(4)
繼續向前走	Just continue my journey	내 갈길 간다
關於荊棘林	About the Thorn Forest	가시숲에 대해
我會去收集樹液	I'll collect the sap	수액을 모으러 가겠다고 한다
我覺得不太能點燃的樣子	I don't think it will burn	잘 안탈 것 같다고 한다
我要去燒毀針刺藤蔓	I will burn the thorny vines	가시 덩굴을 태우러 가겠다고 한다
從現在起好自為之吧	You should take care of it from here	이제부턴 알아서 하라고 한다
放火燒荊棘關口	Burning the thorny vines	가시 관문 태우기
以毒攻毒(1)	Fight Poison with Poison (1)	이독제독(1)
這個主意好像還不錯	I think that's a good idea	괜찮은 생각인 것 같다고 한다
聽起來不是很好的樣子	Doesn't sound so good	별로라고 한다
關於信徒們	About the Believers	신도들에 대해
如果撿到戒指的話，我會帶回來給你	I will find your ring and bring it to you	반지를 줍게 되면 가져다 주겠다고 한다
大概已經被消化掉了吧	It's probably digested by now	아마 지금쯤 다 소화되었을 거라고 한다
觀察口袋中	Looking through the pocket	주머니를 살펴보는 중
以毒攻毒(2)	Fight Poison with Poison (2)	이독제독(2)
我馬上就帶回來	I'll get it quickly	금방 구해 오겠다고 한다
以毒攻毒(3)	Fight Poison with Poison (3)	이독제독(3)
我會試著去組合看看	I'll combine it	조합해 오겠다고 한다
關於過去的荊棘林	About the Thorn Forest in the past	과거의 가시숲에 대해
組合	Combining	조합하기
以毒攻毒(4)	Fight Poison with Poison (4)	이독제독(4)
前往溶化針刺藤蔓	I'll melt the thorny vines	가시덩굴을 녹이러 간다
以信仰之名(1)	In the Name of Faith (1)	신앙의 이름으로(1)
如果有能幫得上忙的地方，我會盡量幫忙	I'll help if I can	도와 줄 수 있는 일이라면 돕겠다고 한다
這件事與我無關	I have nothing to do with it	나와는 관련 없는 일이라고 한다
關於荊棘林的邪惡力量	About the evil energy in the Thorn Forest	가시숲의 사악한 기운에 대해
以信仰之名(2)	In the Name of Faith (2)	신앙의 이름으로(2)
以信仰之名(3)	In the Name of Faith (3)	신앙의 이름으로(3)
回收魔力水晶中	Retrieving the Magic Crystal	마력수정 회수 중
以信仰之名(4)	In the name of Faith (4)	신앙의 이름으로(4)
觀看者最後的警告	Last Warning of the Beholder	주시자의 마지막 경고
不會有事的	I'm doing fine	괜찮을거라고 한다
不要繼續向前進	Do not go any further	더 이상 앞으로 가지 않는다
些許的幫忙	Some Help	그저 약간의 도움
查明啟示者的身份後打算幫忙	I am the Revelator and I'll help you	계시자임을 밝히고 돕겠다고 한다
克巴伊拉斯森林更緊急	Kvailas Forest is more urgent	크바일라스 숲이 더 급하다고 한다
進退兩難	Caught in the Middle	이러지도 저러지도
我會立刻去清除	I'll take care of it right away	바로 해치우겠다고 한다
告訴其他信徒會比較安全	It will be safer to let the other Believers know 	다른 신도들한테 알리는 게 안전하겠다고 한다
毀謗的技術	The Art of Interference	훼방의 기술
我會試試看	I can give it a try	해봄직 하다고 한다
我一點都不想	I don't feel it	내키지 않는다고 한다
不要驚慌	Don't Panic	당황하지 말고
我會破壞召喚水晶	I will destroy the summon crystal	소환 수정을 부숴 준다고 한다
一定能順利脫逃的	You'll be able to run away	잘 도망칠 수 있을 거라고 한다
出乎意外的研究	Unexpected Research	뜻밖의 연구
交給我吧	Leave it to me	맡겨 달라고 한다
我不想要參加奇怪的研究	I don't want to be part of a weird research	이상한 연구에 참여하고 싶지 않다고 한다
褻瀆的東西	Something Blasphemous	불경스러운 것
我要去解決亞崑	I'll defeat Archon	아콘을 처치하겠다고 한다
暫時先避開	Leave the vicinity	자리를 피한다
因普羅大嘴怪咒術師的襲擊	The Attack of the Infro Holders	인프로홀더 주술사의 습격
只要躲好一點，就不會有事	It will be okay if you hide 	잘 숨어 있으면 괜찮을거라고 한다
淨化克巴伊拉斯森林(1)	Purify Kvailas Forest (1)	크바일라스 숲 정화(1)
從怪物的毒手中保護祭壇	I will protect the altar from the monsters	몬스터에게서 제단을 지켜준다고 한다
我也不清楚	I don't know	모르겠다고 한다
史比愛沙丘陵地的根	Root of Sviesa Hill Areas	스비에사 구릉지의 뿌리
碰到樹根的時候，魔龍凱拉斯就會出來阻止！	Gaigalas interrupted you as you touched the root	뿌리를 건드리자 가이갈라스가 막아섭니다!
佛蘭普攻略(1)	Capturing Bramble (1)	브람블 공략(1)
已經做好萬全準備了	I'm ready	준비 만반이라고 한다
坦基塔空地的根	Root of Tankinta Vacant Lot	틴칸타 공터의 뿌리
碰到樹根的時候，莫雷克就會出來阻止！	Molich interrupted you as you touched the root	뿌리를 건드리자 몰렉이 막아섭니다!
淨化克巴伊拉斯森林(2)	Purify Kvailas Forest (2)	크바일라스 숲 정화(2)
我會協助進行淨化作業	I'll help the purifying job	정화 작업을 돕겠다고 한다
佛蘭普攻略(3)	Capturing Bramble (3)	브람블 공략(3)
我會消滅佛蘭普，並且找回啟示	I'll defeat Bramble and retrieve the revelation	브람블을 처치하고 계시를 되찾겠다고 한다
去找薩勒女神	To Goddess Saule	사울레 여신에게
緊閉的傳點	The Unopened Portal	열리지 않는 포탈
我要去見神官	I'll meet the priest	신관을 만나보겠다고 한다
啟動方尖塔(1)	Activate the Obelisk (1)	오벨리스크 작동(1)
詢問修復方法	Ask how to restore it	복원 방법을 묻는다
算了	Just leave	관둔다
啟動方尖塔(2)	Activate the Obelisk (2)	오벨리스크 작동(2)
合成材料中	Combining the Ingredients	재료 합성 중
請回到安德伊村的神官身邊	Return to the Andale Village Priest	안데일 마을 신관에게 돌아가세요
啟動方尖塔(3)	Activate the Obelisk (3)	오벨리스크 작동(3)
詢問方尖塔的位置	Ask where the Obelisk is located	오벨리스크의 위치를 묻는다
親自去進行修復吧	Restore it yourself	복원은 직접 하라고 한다
關於神	About God	신에 대해
復原方尖塔中	Restoring the Obelisk	오벨리스크 복원 중
尼普利托溪谷的魔地獸	Moldyhorn of Nefrito Valley	네프리토 계곡의 몰디혼
瀰漫不祥氣息的耶魯薛可祭壇	Ominous Energy at Ershike Altar	불길한 기운이 감도는 에르쉬케 제단
混合材料中	Combining the ingredients	재료 조합 중
史雷平卡斯溪畔的湛藍樹精	Slepingas Stream's Blue Woodspirit	슬레핑가스 냇가의 푸른 우드 스피릿
安德伊村莊祭司的委託(1)	Andale Village Priest's Favor (1)	안데일 마을 사제의 부탁(1)
詢問協助消滅伍潘特的方法	Ask how to help defeat the Upent	우펜트 처치를 도울 방법을 묻는다
關於儀式	About the Ritual	의식에 대하여
請在那魯巴斯蜿蜒路收集無力草	Obtain Languid Herb from Narvas Curved Path	나르바스 굽잇길에서 나른초를 구하세요
安德伊村莊祭司的委託(2)	Andale Village Priest's Favor (2)	안데일 마을 사제의 부탁(2)
威力應該非常充分	The force is enough	위력은 충분할 거라고 한다
請在德慕尼溼地尋找香氣濃郁的靈魂之花	Look for a Strongly Scented Soul Flower in Dvyni Wetland	드뷔니 습지에서 향이 강한 영혼의 꽃을 찾으세요
請去找村長	Find the Village Headman	마을 촌장을 찾아가세요
製造無力草炸彈	Creating the Languid Herb Bomb	나른초 폭탄 제조
要攜帶炸藥過去	I will go get the explosives	폭약을 가지러 가겠다고 한다
請從村莊上方的火藥桶裡帶回火藥	Bring the explosives from the barrels located at the upper side of the village	마을 위쪽에 있는 폭약통에서 폭약을 가져오세요
令人全身發軟的香氣	A Drowsy Scent	나른해지는 향기
我會去使用炸彈	I'll use the bomb	폭탄을 사용하러 가겠다고 한다
我要先做好心理準備	I will prepare myself for a while	잠시 마음의 준비를 하겠다고 한다
設置無力草炸彈中	Placing the bomb	나른초 폭탄 설치 중
奇怪的井	Mysterious Well	이상한 우물
撈出物品中	Pulling out the object	물건 꺼내는 중
德慕尼溼地的曼陀花獸	Dvyni Wetland's Colimencia	드뷔니 습지의 콜리멘시아
佛蘭普攻略(2)	Capturing Bramble (2)	브람블 공략(2)
前往進行破壞	I'll destroy them	파괴하러 간다
給我一點時間	Give me some time	잠시 시간을 달라고 한다
請移動至奇里艾後院	Move to Giliaii Courtyard	길리아이 안뜰로 이동하세요
聖所潛藏的啟示(2)	The Hidden Sanctum's Revelation (2)	숨겨진 성소의 계시(2)
監獄看守者	Prison Scout	감옥의 파수꾼
逃亡的傳令兵	Messenger Running Away	도망치는 연락병
因為害怕而逃走	Chicken out	무서우니 도망친다
跟著光芒	Following the Light	빛을 따라서
正在詢問關於光明珠的事	Asking about the light bead	빛구슬에 대해 묻는 중
我會去追趕看看	I will follow it	쫓아가 보겠다고 한다
危機裡放的貓頭鷹雕像	Owl Sculpture in Danger	위기에 놓인 부엉이 조각상
卡羅利斯祭壇復原(1)	Recover the Karolis Altar (1)	카롤리스 제단 복구(1)
卡羅利斯祭壇復原(2)	Recover the Karolis Altar (2)	카롤리스 제단 복구(2)
卡羅利斯祭壇復原(3)	Recover the Karolis Altar (3)	카롤리스 제단 복구(3)
正在復原卡羅利斯祭壇	Restoring the Karolis Altar	카롤리스 제단 복원 중
森林的聖所	Altar of the Forest	숲의 성소
我要擴散聖所的力量	I'll spread the energy from the sanctuary	성소의 힘을 퍼뜨리겠다고 한다
我還是覺得沒有希望	I think it's no use	그래도 가망이 없을 것 같다고 힌다
收集貓頭鷹的力量(1)	Gather the Strength of the Owl (1)	부엉이의 힘을 모아서(1)
請求分享力量	Lend me your power	힘을 나눠달라고 한다
我想沒那個必要	I don't think it's necessary	그럴 필요는 없다고 한다
收集貓頭鷹的力量(2)	Gather the Strength of the Owl (2)	부엉이의 힘을 모아서(2)
我會消滅後再回來	I will blow it up	날려버리고 오겠다고 한다
其他貓頭鷹	Another Owl	또 다른 부엉이
卡羅利斯泉水的氣息	Energy of Karolis Springs	카롤리스 샘터의 기운
我會救出領路人貓頭鷹雕像	I'm off to save the Guide Owl Sculpture	길잡이 부엉이 조각상을 구하겠다고 한다
後面的事交給馬勒達斯，我要先走了	I'll leave the end to Mardas and go	뒤는 마르다스에게 맡기고 떠나겠다고 한다
救出領路人貓頭鷹	Saving the Guide Owl	길잡이 부엉이 구하기
傳達卡羅利斯泉水中	Transmitting the energy of Karolis Springs	카롤리스 샘터의 기운 전하는 중
森林的神聖之樹(1)	Sacred Tree of the Forest (1)	숲의 신성한 나무(1)
展示凝聚卡羅利斯泉水氣息的結晶	Show the crystal formed by the energy from Karolis Springs	카롤리스 샘터의 기운이 모인 결정을 보여준다
我認為沒辦法	I don't think it can be helped	어쩔 수 없다고 생각한다
森林的神聖之樹(2)	Sacred Tree of the Forest (2)	숲의 신성한 나무(2)
帶著樹枝出現	Take the branch and go	나뭇가지를 들고 나선다
懷疑是不是真的	Are you absolutely sure?	정말이나며 의심한다
健壯的協調者	Reliable Assistant	든든한 조력자
說有關馬勒達斯的事	Talk about Mardas	마르다스에 대해 이야기한다
我也很擔心	It worries me too	나도 걱정이라고 한다
魔族汙染的森林	Forest Corrupted by the Demons	마족이 오염시킨 숲
詢問邪惡的氣息在哪裡	Where is this evil energy?	사악한 기운은 어디에 있는 지 묻는다
避開荊棘	Away From the Watch	감시를 피해서
只相信我	Trust me	나만 믿으라고 한다
不祥的黑色氣息	Eery Black Energy	불길한 검은 기운
靈魂餓鬼(1)	Soul Starvation (1)	영혼 아귀(1)
現在是最後階段，我很快就會回來。	Let's finish this once and for all	이제 마지막이니 금방 다녀오겠다고 한다
稍微休息一下再做	I need to lie down a bit	조금만 쉬었다 하자고 한다
靈魂餓鬼(2)	Soul Starvation (2)	영혼 아귀(2)
正在建造抑制之那姆特	Setting the Namott of Suppression	억제의 나모트 세우는 중
恢復和平的森林	Peace in the Forest	숲에 찾아온 평화
說明中	Talking	이야기 하는 중
我會想看看	I will think about it	생각해보겠다고 한다
因魔力而上鎖的箱子	A Chest Locked By A Spell	마력으로 잠긴 상자
艾拉斯留下的故事	A Story Left Behind by Eras	에라스가 남긴 이야기
正在拾取信件	Picking up the letter	편지 줍는 중
正在訴說關於信件的內容	Talking about the letter	편지에 대해 말하는 중
萊塔斯祭壇	Letas Altar	레타스 제단
魔法的基礎[法師轉職]	Basic Magic [Wizard Advancement]	마법의 기초[위저드 전직]
那種能力應該不行	I don't think my skills are enough for that	그럴 만한 실력은 안되는 것 같다
火的氣息[烈焰法師轉職]	The Energy of Fire [Pyromancer Advancement]	불의 기운[파이로맨서 전직]
我不想那樣	I don't want that	그런 건 원치 않는다고 한다
魔力的冰碎片[寒冰法師轉職]	Magical Piece of Ice [Cryomancer Advancement]	마력의 얼음 조각[크리오맨서 전직]
詢問如何確認	What do I need to do?	어떻게 확인하는지 묻는다
即使很遠也要很準確[弓箭手轉職]	Afar but Precise [Archer Advancement]	멀리서도 정확히[아처 전직]
詢問是怎樣的人	What kind of test is it?	어떤 시험인지 묻는다
以一當百[遊俠轉職]	One Man Army [Ranger Advancement]	일당백[레인저 전직]
我有把握	I feel confident	자신 있다고 한다
我覺得那種程度的力量還不行	I don't think my skills are enough for that	아직 그럴 실력은 안되는 것 같다고 한다
強大從堅硬的弩開始[弩箭手轉職]	Strength Comes from a Strong Crossbow [Quarrel Shooter Advancement]	강함은 강한 쇠뇌로부터[쿼렐슈터 전직]
我的想法有點不一樣	I don't think so	조금 다른 생각이라고 한다
高手的建議[法師轉職]	Teaching from a Mentor [Wizard Advancement]	고수의 조언[위저드 전직]
詢問該問誰	Who should I ask?	누구에게 물으면 되냐고 한다
強化的火之氣息[烈焰法師轉職]	Enhanced Energy of Fire [Pyromancer Advancement]	강화된 불의 기운[파이로맨서 전직]
總覺得有點可怕	That sounds frightening	왠지 무섭다고 한다
冰氣的魔法書[寒冰法師轉職]	Frost Tome [Cryomancer Advancement]	냉기의 마법서[크리오맨서 전직]
詢問操作冰氣的方法	How can I handle the cold energy more proficiently?	냉기를 잘 다루는 법에 대해 묻는다
看不見的力量[念力法師轉職]	Unknown Force [Psychokino Advancement]	보이지 않는 힘[사이코키노 전직]
棘手的事就算了	That's too complicated; I quit	머리 아픈 건 관두겠다고 한다
連接點[鎖鏈法師轉職]	The Link [Linker Advancement]	연결고리[링커 전직]
我討厭困難的事	I hate difficult things	어려운 건 질색이라고 한다
天敵[弓箭手轉職]	Natural Enemy [Archer Advancement]	천적[아처 전직]
我馬上去一趟	I'll be back in a second	금방 다녀 오겠다고 한다
給我其他考驗	Test me again	다른 시험을 달라고 한다
支援復原歐勒夏[遊俠轉職]	Orsha Retoration Support [Ranger Advancement]	오르샤 복구 지원[레인저 전직]
黏答答[弩箭手轉職]	Sticky [Quarrel Shooter Advancement]	끈적끈적[쿼렐슈터 전직]
工兵的研究[工兵轉職]	Sapper Research [Sapper Advancement]	공병의 연구[새퍼 전직]
總覺得很棘手	That's a little out of my league	왠지 버거울 것 같다고 한다
地下城探險[獵人轉職]	Dungeon Crawl [Hunter Advancement]	던전 탐험[헌터 전직]
火的測試[烈焰法師轉職]	Tiral by Fire [Pyromancer Advancement]	불의 시험[파이로맨서 전직]
冰的測試[寒冰法師轉職]	Trial by Frost [Cryomancer Advancement]	얼음의 시험[크리오맨서 전직]
我會接受冰氣的測試	I will take the trial by frost	냉기의 시험을 받겠다고 한다
最好的位置[念力法師轉職]	The Best Spot [Psychokino Advancement]	누구보다 좋은 위치[사이코키노 전직]
靈性氣息[鎖鏈法師轉職]	Spiritual Presence [Linker Advancement]	영적 기운[링커 전직]
或大或小[奇術師轉職]	Size Does Not Matter [Thaumaturge Advancement]	크거나 혹은 작거나[쏘마터지 전직]
給我一點時間	Please give me some time	잠시만 시간을 달라고 한다
元素的理解[元素使轉職]	Elementary Understanding of Elements [Elementalist Advancement]	원소의 이해[엘리멘탈리스트 전직]
遊俠的實戰訓練[遊俠轉職]	Ranger On-Site Training [ Ranger Advancement]	레인저의 실전 훈련[레인저 전직]
堅硬的盾牌[弩箭手轉職]	Trusty Shield [Quarrel Shooter Advancement]	든든한 방패[쿼렐슈터 전직]
不會變成那種狀況	I don't think there's a need for that	그럴만한 상황이 못 된다고 한다
工兵大師的炸彈研究[工兵轉職]	Sapper Master's Bomb Experiment [Sapper Advancement]	새퍼 마스터의 폭탄 연구[새퍼 전직]
獵人的測試[獵人轉職]	Hunter's Test [Hunter Advancement]	헌터의 시험[헌터 전직]
我要挑戰	I'll give it a try	도전 하겠다고 한다
屍體的毒[巫蠱師轉職]	Corpse Poison [Wugushi Advancement]	시신의 독[무고사 전직]
詢問那裡可以取得	Where can I get it from?	어디서 구할 수 있는지 묻는다
好可怕，放棄吧	I want to stop; it's too scary	무서우니 그만 두자
比羽毛還要輕[斥侯轉職]	Featherlight [Scout Advancement]	깃털보다 가볍게[스카우트 전직]
我準備好再來	I'll get ready and come back	잠시 준비를 마치고 오겠다고 한다
交易路的上鎖的箱子	Trade Route Locked Chest	교역로의 잠긴 상자
主教的女神之夢(2)	Bishop's Dream of the Goddess (2)	주교가 꾼 여신의 꿈(2)
前往長橋溪谷	To Overlong Bridge Valley	긴다리 계곡으로
阿克梅斯山脊的羅藍塔斯尤那斯	Rolandas Jonas of Akmens Ridge	아크멘스 능선의 롤란다스 요나스
藥師的委託(1)	Pharmacist's Favor (1)	약사의 부탁(1)
藥師的委託(2)	Pharmacist's Favor (2)	약사의 부탁(2)
解開中	Untying	풀어 보는 중
觀察魔法陣中	Inspecting the magic circle	마법진을 살펴 보는중
必須解除附近出現的寶石才能強化魔法陣	You can enhance the magic circle by breaking the crystals that appeared nearby	주변에 나타난 보석을 해체해야 마법진을 강화 할 수 있습니다
等待怪物中	Waiting for the monsters	몬스터를 기다리는 중
觀察魔法陣中	Inspecting the magic circle	마법진을 살펴 보는 중
魔法陣正迴盪著奇怪的震動	The magic circle strangely vibrates	마법진에서 이상한 진동이 울리고 있습니다
請回到魔法師利馬斯的身邊向他回報魔法陣的狀況	Return to the Wizard Rimas and report to him about the magic circle	마법사 리마스에게 돌아가 이 마법진에 대해 보고하세요
潑灑混濁的精煉劑中	Spraying the Opaque Purification Liquid	혼탁한 정제액을 뿌리는 중
魔法陣現在好像順利啟動了	The magic circle is working properly now	마법진은 이제 문제 없이 잘 작동하는 것 같습니다
正在挖掘雕像的頭部	Digging the head of the sculpture	조각상 머리를 파내는 중
調查箱子中	Investigating the chest	상자 조사 중
觀察酒桶中	Looking at the wine cask	술통을 살펴 보는 중
擊破桶子中	Dismantling the cask	통을 깨는 중
觀察翅膀型的雕刻中	Looking at the wing-shaped piece	날개 모양의 조각을 살펴 보는 중
將女神像放上魔法陣中	Putting the Goddess Statue on the magic circle	마법진에 여신상을 올려 놓는 중
用腳踢籬笆中	Kicking the fence	울타리를 발로 차는 중
被汙染的碑石	Corrupted Tombstones	오염된 비석
阿爾費納的故事	The Story of Albinas	알비나스의 이야기
破壞那斯圖斯派的碑石(1)	Destroy the Tombstones of Nestopa (1)	네스토스파의 비석 파괴(1)
破壞那斯圖斯派的碑石(2)	Destroy the Tombstones of Nestopa (2)	네스토스파의 비석 파괴(2)
疑惑的開始	Beginning of Doubt	의혹의 시작
說明為什麼要破壞碑石	Explain why you have destroyed them	왜 비석을 파괴했는지 설명한다
結果和責任	Result and Responsibility	결과와 책임
對誤會的內容道歉並請求原諒	Apologize and seek for forgiveness	오해한 것을 사과하고 용서를 구한다
復原碑石(1)	Restoring the Tombstone (1)	비석 복구(1)
詢問該做的事情	Ask what should I do	무슨 일을 하면 되는지 물어본다
復原碑石(2)	Restoring the Tombstone (2)	비석 복구(2)
說對不起	I'm sorry about it	미안하게 됐다고 한다
復原碑石(3)	Restoring the Tombstone (3)	비석 복구(3)
和亞那斯圖斯派見面	Meeting the Anastospa	아나스토스파와 만남
正在詢問有關阿爾費納的事	Ask about Albinas	알비나스에 대해 물어보는 중
亞那斯圖斯的故事	The Story of Anastos	아나스토스의 이야기
調查員派遣	Deploying Investigation Guards	조사인원 파견
最後結論(1)	Final Conclusion (1)	최종 결론(1)
最後結論(2)	Final Conclusion (2)	최종 결론(2)
會找看看	I will try to find it	구해 보겠다고 한다
最後結論(3)	Final Conclusion (3)	최종 결론(3)
最後結論(4)	Final Conclusion (4)	최종 결론(4)
最後結論(5)	Final Conclusion (5)	최종 결론(5)
開始和結束	Beginning and End	시작과 마무리
募集新團員	Recruiting New Members	신규 단원 모집
點頭	Shake head	고개를 끄덕인다
新人要做的事情	Duties of Newbies	신입들의 할 일
建立佈告欄中	Setting up notice board	알림판을 세우는 중
幫助新手啟示者	Helping A Beginner Revelator	초보 계시자 돕기
回收遺失的物品(1)	Lost and Found (1)	잃어버린 물품 회수(1)
回收遺失的物品(2)	Lost and Found (2)	잃어버린 물품 회수(2)
回收遺失的物品(3)	Lost and Found (3)	잃어버린 물품 회수(3)
凱都拉商團的教育資料(1)	Educational Materials of the Kedoran Merchant Alliance (1)	케도라 상단의 교육 자료(1)
凱都拉商團的教育資料(2)	Educational Materials of the Kedoran Merchant Alliance (2)	케도라 상단의 교육 자료(2)
前往克巴伊拉斯森林	To Kvailas Forest	크바일라스 숲으로
士兵的委託	A Soldier's Favor	병사의 부탁
我會去收集遺物	I'll gather the mementos	유품을 모아 오겠다고 한다
被掠奪的糧食	Stolen Food Supplies	약탈당한 식량
我會從布貝手中奪回糧食	I'll get back the food supplies from the Vubbes	부베에게서 식량을 되찾아 오겠다고 한다
前往凱利高原	To Gele Plateau	겔리 고원으로
前往魔法師之塔	To Mage Tower	마법사의 탑으로
可疑的短劍(3)	The Suspicious Dagger (3)	수상한 단검(3)
詢問是否有人了解毒	Do you know someone who is familiar with poison?	독을 잘 아는 사람을 아는지 묻는다
詢問解毒劑的事情	Ask about the antidote	해독제에 대해 묻는다
不舒服的地方好像好多了。	I think I feel better now	아픈게 좀 나아진거 같아.
殘存的危險(1)	The Remaining Danger (1)	잔존하는 위험(1)
現在沒有這種閒情逸致	I don't have time for that now	지금은 그럴 겨를이 없다고 한다
殘存的危險(2)	The Remaining Danger (2)	잔존하는 위험(2)
要去放入香爐	I will put the incense burner	향로를 놓고 오겠다고 한다
天敵的味道	The Enemy's Smell	천적의 냄새
辛苦了	Tell him to work hard	수고하라고 한다
指定區域(1)	Designated Area (1)	구역 지정(1)
我會幫你，不用擔心	Tell him not to worry since you will help out	도와 줄 테니 걱정 말라고 한다
安慰他要加油	Comfort him to cheer him up	힘내라고 위로한다
指定區域(2)	Designated Area (2)	구역 지정(2)
要去安裝	I will install it	설치하러 가겠다고 한다
失蹤案件(1)	The Disappearance (1)	실종 사건(1)
要去現場看一下	I will go to the spot	현장으로 가 보겠다고 한다
放入靈魂之眼中	Placing the Spirit Eye	영혼의 눈 놓는 중
失蹤案件(2)	The Disappearance (2)	실종 사건(2)
確認靈魂之眼中	Checking the eyes of the spirit	영혼의 눈 확인 중
失蹤案件(3)	The Disappearance (3)	실종 사건(3)
去跟烏斯卡說這個事實	Tell Sir Uska about it	우스카에게 이 사실을 알려주러 가자
給我一點思考的時間吧！	Take some time to think about it	잠시 생각할 시간을 갖자
冤魂(1)	Depressed Spirit (1)	억울한 영혼(1)
冤魂(2)	Depressed Spirit (2)	억울한 영혼(2)
薩勒女神的請求(1)	A Request from Goddess Saule (1)	사울레 여신의 부탁(1)
詢問需要幫忙什麼	Ask him how you can help	무엇을 도와야 하는지 묻는다
觀察針刺藤蔓中	Looking at the thorny vines	가시 덩굴 살펴보는 중
薩勒女神的請求(2)	A Request from Goddess Saule (2)	사울레 여신의 부탁(2)
是很難承擔的工作	Tell him that it's hard to accept	감당하기 어려운 일이라고 한다
放入權能水晶中	Putting the crystal of authority	권능의 수정 놓는 중
私事	Private matter	사적인 일
決定要幫助實驗	I will help the experiment	실험을 돕겠다고 한다
沒有這個閒情逸致	I don't have time for it	그럴 겨를이 없다고 한다
隱藏寶物(1)	The hidden treasures(1)	숨겨진 보물들(1)
很有興趣，請告知使用方法	Ask him to tell you how to use it since you are interested	관심이 있으니 사용법을 알려달다고 한다
不需要	Tell him you don't need it	필요없다고 한다
隱藏寶物(2)	The hidden treasures(2)	숨겨진 보물들(2)
感激的使用	I will use it well	감사히 쓰겠다고 한다
以後再找	I will find it later	나중에 찾겠다고 한다
大型事故	Big Accident	대형 사고
要做的事還很多	I have many things to do	할 일이 많다고 한다
觀察魔法陣中	Examining the magic circle	마법진을 살펴보는 중
女神的封印塔(1)	The Sealed Tower of the Goddess (1)	여신의 봉인탑(1)
要幫忙守護封印塔	I will help to protect the sealed tower	봉인탑 수호를 돕겠다고 한다
沒辦法了這是必須要做的事	Tell him that it can't be helped	어떨 수 없는 일이라고 한다
觀察封印塔中	Looking at the sealed tower	봉인탑 살펴 보는 중
女神的封印塔(2)	The Sealed Tower of the Goddess (2)	여신의 봉인탑(2)
剩下的也全都會幫忙	I will help the rest	마저 돕겠다고 한다
宣告離別	Say Farewell	작별을 고한다
女神的封印塔(3)	The Sealed Tower of the Goddess (3)	여신의 봉인탑(3)
復原封印中	Restoring the seal	봉인 복구 중
大地要塞啟示	Revelation of Fortress of the Land	대지의 요새 계시
啟動裝置中	Activating device	장치 작동 시키는 중
不安的流動商人	Nervous Vendor	안절부절하는 행상인
好危險，我要逃了	I'm running away; it's too dangerous	위험하니 도망간다
羅潔的同伴們(1)	Rose's Friends (1)	로제의 동료들(1)
我願意幫忙尋找同伴	I'll help you find your colleagues	동료들을 찾아 주겠다고 한다
最好快點離開這裡	I think it's best to get away from here	빨리 여길 벗어나는 게 좋겠다고 한다
關於流動商人與信件	About the merchants and the letter	행상인과 편지에 대해
羅潔的同伴們(2)	Rose's Friends (2)	로제의 동료들(2)
跟拉舒一起去找流動商人	I will go find the merchants with Laswi	라쉬와 함께 행상인을 찾으러 간다
請讓拉舒聞流動商人的味道，再讓牠找分散的流動商人	Have Laswi follow the scent of each merchant and find them	라쉬에게 행상인의 냄새를 맡게 하여 흩어진 행상인들을 찾게 하세요
羅潔的同伴們(3)	Rose's Friends (3)	로제의 동료들(3)
一起回採藥者小木屋吧	Let's go back to the Herb Gatherers' Cabin	약초꾼 오두막으로 돌아가자고 한다
流動商人遺失的行李	Vendor's Lost Baggage	행상인의 잃어버린 짐
我替你找	I will find it for you	대신 찾아주겠다고 한다
說些安慰的話	I feel very sorry for what happened	위로의 말을 건넨다
流動商人的不安	Nervous Vendor	행상인의 불안함
最好躲到安全的地方	It's best to escape to somewhere safe	안전한 곳으로 피하는 게 좋겠다고 한다
受傷的採藥者(1)	The Injured Herbalist (1)	상처입은 약초꾼(1)
我願意幫忙取得藥草	I'll go and find the herbs	약초를 구해 주겠다고 한다
受傷的採藥者(2)	The Injured Herbalist (2)	상처입은 약초꾼(2)
請把採藥者戴伊斯的症狀告訴歐勒夏的牧師次級大師	Tell the Cleric Master in Orsha about Herbalist Tales' symptoms	오르샤에 있는 클레릭 서브 마스터에게 약초꾼 테일스의 증상을 전해주세요
受傷的採藥者(3)	The Injured Herbalist (3)	상처입은 약초꾼(3)
回去找採藥者戴伊斯	Let's go back to Tales	약초꾼 테일스에게 돌아가자
請稍後	Tell him to wait a bit longer	잠시 기다려 달라고 한다
村莊居民的行蹤(1)	Where Did Everybody Go? (1)	마을 주민의 행방(1)
我擔心魔族，願意幫忙搜索村民	I'm worried about the demons; I'll check in on your people	마족이 걱정되니까 마을 사람 수색을 돕겠다고 한다
村莊居民的行蹤(2)	Where Did Everybody Go? (2)	마을 주민의 행방(2)
再多找一些寶珠吧	Let's try and find more beads	구슬을 더 찾아보자고 한다
應該沒什麼吧	I'm sure it'll be nothing	별 것 아닐 거라고 한다
村莊居民的行蹤(3)	Where Did Everybody Go? (3)	마을 주민의 행방(3)
我找找周圍	I'll try and have a look around	주변을 찾아보겠다고 한다
最好回村莊尋找線索	It's best to go back to the village and find more clues	마을로 돌아가 다른 단서를 찾는 게 좋겠다고 한다
村莊居民的行蹤(4)	Where Did Everybody Go? (4)	마을 주민의 행방(4)
先等到平靜下來吧	Let's wait until things cool down a little	진정할 때까지 일단 기다리자
村莊居民的行蹤(5)	Where Did Everybody Go? (5)	마을 주민의 행방(5)
詳細詢問克洛亞村莊發生了什麼事	Exactly what is happening in the Croa Village?	크로아 마을에 무슨 일이 생겼는지 자세히 묻는다
以後再問	I'll ask later	나중에 물어본다
膽怯的採藥者	Frightened Herbalist	겁먹은 약초꾼
會整理周圍	I will tidy up the place	주변을 정리해주겠다고 한다
魔族太多，我沒辦法	There's too many demons; I can't do it	마족이 너무 많아 어쩔 수 없다고 한다
魔族採藥者(1)	Demon Herbalist (1)	마족 약초꾼(1)
首要之務是躲到安全的地方	First we need to escape to somewhere safe	안전한 곳으로 피하는 게 우선이라고 한다
魔族採藥者(2)	Demon Herbalist (2)	마족 약초꾼(2)
現在應該先躲避	First we need to find somewhere safe	지금은 몸을 피하는 게 우선이라고 한다
魔族採藥者(3)	Demon Herbalist (3)	마족 약초꾼(3)
我要噴灑路克塔奴的體液	I'll help you spray the Loktanun Fluid	록타눈의 체액을 뿌리겠다고 한다
拜託他馬上收手並一起回去	Can we stop and go back now?	이제 그만하고 돌아가자고 부탁하자
巨大的蕨葉(1)	Giant Bracken (1)	거대한 고사리(1)
巨大的蕨葉(2)	Giant Bracken (2)	거대한 고사리(2)
來歷不明的魔法師	Mysterious Wizard	정체불명의 마법사
停止運轉	Deactivate	작동 정지
詢問有關寒氣魔法陣的處理	Tell me about the cold magic circle	냉기 마법진의 처리에 대해 묻는다
總覺得很危險	That sounds dangerous	왠지 위험할 것 같다고 한다
前往諾巴哈修道院	To Novaha Monastery	노바하 수도원으로
我會消滅魔族	I'll defeat the demons	마족을 처치하겠다고 한다
一起等到魔族消失為止	Let's wait until the demons disappear	마족이 사라질 때까지 기다리자고 한다
落入陷阱的採藥者	Trapped Herbalist	덫에 걸린 약초꾼
如果草率招惹可能會出大事	Something could go really wrong if we're not careful	섣불리 건드렸다간 큰일 날지도 모른다고 한다
魔族的鍋子(1)	Demon Cauldron (1)	마족의 솥(1)
最好把鍋子破壞掉	It's best to destroy the cauldron	솥을 부수는 게 좋겠다고 한다
魔族的鍋子(2)	Demon Cauldron (2)	마족의 솥(2)
暫時的危險要素	Potential Threat	잠정적 위험요소
馬上回去治療吧	You should go back and get treated	이제 그만 돌아가 치료하라고 한다
救出(1)	The Rescue (1)	구출(1)
我去問問門那邊的村莊居民	I'll ask the villagers on the other side of the door	문 너머의 마을 주민에게 물어보겠다고 한다
找找其他辦法吧	Let's find another solution	다른 방법을 찾아보자고 한다
正在詢問被關在倉庫的居民	Asking the villagers locked in the storage room	창고에 갇힌 주민에게 묻는 중
救出(2)	The Rescue (2)	구출(2)
救出(3)	The Rescue (3)	구출(3)
訊問是否知道開門的方法	Is there a way to open the door?	문을 열 방법이 있는지 묻는다
關於諾巴哈修道院的襲擊	Can you tell me about the attack at the Novaha Monastery?	노바하 수도원의 습격에 대해
救出(4)	The Rescue (4)	구출(4)
給我一點時間準備	Please give me some time to prepare	조금만 준비할 시간을 달라고 한다
救出(5)	The Rescue (5)	구출(5)
由於魔族的警戒，目前還很危險	It's still dangerous because of the demons' barrier	아직 마족의 경계 때문에 위험하다고 한다
精疲力盡的身體(1)	An Exhausted Body (1)	지쳐버린 몸(1)
找看看是否有恢復藥水	Do you have a Stamina recovery potion?	회복 물약이 있는지 찾아본다
最好脫離修道院進行治療	It's best to get out of the monastery and get treatment	수도원을 빠져나와서 치료하는 게 좋겠다고 한다
精疲力盡的身體(2)	An Exhausted Body (2)	지쳐버린 몸(2)
遺物	Keepsake	유품
我找到遺物就拿去給你	I'll bring you those objects if I can find them	유품을 찾게 되면 가져다 주겠다고 한다
我想應該先保重身體	First we need to get water	몸을 챙기는 게 우선인 것 같다고 한다
救出愛德文多斯(1)	Rescue Edmundas (1)	에드문다스 구출(1)
休息一下再找吧	Let's rest for a while first	조금 쉬었다 찾자고 한다
救出愛德文多斯(2)	Rescue Edmundas (2)	에드문다스 구출(2)
我得快點走	I'll go right away	빨리 가보겠다고 한다
救出愛德文多斯(3)	Rescue Edmundas (3)	에드문다스 구출(3)
必須到法衣室那邊確認	I'll take a look around the vestry	제의실 쪽을 확인하겠다고 한다
我要休息一下	I'm going to rest for a while	잠시 쉬겠다고 한다
救出愛德文多斯(4)	Rescue Edmundas (4)	에드문다스 구출(4)
我要確認法衣室	I'll have a look in the vestry	제의실을 확인하겠다고 한다
實驗(1)	The Experiment (1)	실험(1)
我幫忙找背包	I'll find the backpack for you	배낭을 찾아 주겠다고 한다
抱歉	I'm sorry	미안하다고 한다
實驗(2)	The Experiment (2)	실험(2)
你的身體太勉強，我幫你找	You stay put; I'll do it for you	그 몸으론 무리니 대신 찾겠다고 한다
最好先休息	Getting some rest first will be better	일단 쉬는 게 좋겠다고 한다
實驗(3)	The Experiment (3)	실험(3)
去破壞實驗設施	Destroy the testing facilities	실험 시설을 파괴하러 간다
返回村莊吧	Go back to the village	마을로 돌아가라고 한다
修道士的最後使命(1)	A Monk's Last Mission (1)	수도사의 마지막 사명(1)
我會盡快收集回來	I'll collect some right away	빠르게 모아오겠다고 한다
我沒把握幫你	I'm not so sure I can help you	도와줄 자신이 없다고 한다
修道士的最後使命(2)	A Monk's Last Mission (2)	수도사의 마지막 사명(2)
給我一點時間	Just give me some time	잠깐만 시간을 달라고 한다
救出羅潔(1)	Rescue Rose (1)	로제 구출(1)
詢問該怎麼做	What do I have to do?	어떻게 해야 하는지 물어 본다
救出羅潔(2)	Rescue Rose (2)	로제 구출(2)
我會把黏液收集回來	I'll collect some mucus for you	점액을 모아 오겠다고 한다
一起思考看看超載時會不會有副作用	We should consider there won't be any side effects to overloading the device	과부화 되었을때 부작용은 없을지 생각해 보자고 한다
救出羅潔(3)	Rescue Rose (3)	로제 구출(3)
我要破壞魔法水晶	I'll destroy the magic crystal	마법 수정을 파괴하겠다고 한다
由於羅潔的精神上可能會發生問題而勸阻	Rose could be mentally affected; that's not right	로제의 정신에 문제가 생길 수도 있으니 말린다
救出羅潔(4)	Rescue Rose (4)	로제 구출(4)
愛德文多斯的擔心(1)	Edmundas' Worry (1)	에드문다스의 걱정(1)
我要消滅梅迪艾儀典室的怪物	I'll chase away the monsters at the Medie State Apartments	메디에 의전실의 몬스터를 퇴치해 주겠다고 한다
愛德文多斯的擔心(2)	Edmundas' Worry (2)	에드문다스의 걱정(2)
我要去找法師次級大師	I'll go see the Wizard Submaster	위저드 서브 마스터에게 가보겠다고 한다
我以後再去	I'll go later	나중에 가보겠다고 한다
正在傳達羅潔兄妹的情況	Explaining about Rose and her brother	로제 남매의 사정을 전하는 중
愛德文多斯的擔心(3)	Edmundas' Worry (3)	에드문다스의 걱정(3)
請告訴我方法	Please tell me how	방법을 알려달라고 한다
我準備一下再來	I'll be back after I'm ready	잠시 준비를 하고 오겠다고 한다
愛德文多斯的擔心(4)	Edmundas' Worry (4)	에드문다스의 걱정(4)
在修道院發生的事	What happened to the monastery?	수도원에서 벌어진 일
巨大的蕨葉孢子	Giant Bracken Spore	거대 고사리 포자
我願意幫忙，請告訴我詳情	I can help you; tell me more	도와줄 테니 자세히 알려달라고 한다
請告訴我詳情	Tell me more about it	자세한 이야기를 들려달라고 한다
村莊居民的行蹤(6)	Where Did Everybody Go? (6)	마을 주민의 행방(6)
請給予安慰與協助	Let's all help out	도와주겠다고 위로해주자
不要做危險的事情	Let's not do dangerous stuff	위험한 일은 하지 말자고 한다
會傳達	I will relay it	전달하겠다고 한다
會再看看狀況	Let's watch the situation first	좀 더 상황을 보자고 한다
抵達死胡同(4)	A Dead End (4)	막다른 곳에 다다라(4)
休息一下再走	Let's rest a bit more	조금만 더 쉬자고 한다
總之先救命要緊	Save the person first	일단 사람은 살리고 보자
不幫忙魔族	I can't help the demons	마족은 도울 수 없다고 한다
會餵解毒草	Tell him that you will feed him the detoxifying herb	해독초를 먹여주겠다고 한다
請再看看	Look little more	좀 더 지켜본다
餵藥中	Feeding	먹이는 중
會負責進行	Tell him that you will take care of it	맡아 주겠다고 한다
無法相信魔族	Tell him that the demons can't be trusted	마족은 믿을 수 없다고 한다
會試試看	Tell him that you will do it	해보자고 한다
一起收尾吧	Tell him that you will complete it	마무리 하자고 한다
尋找自我的旅程(7)	The Journey to Find Myself (7)	나를 찾는 여정(7)
朝聖者阿卡達斯的口袋掉出了日誌	The diary fell down from the pocket of the Pilgrim Agatas	순례자 아가타스의 주머니에서 일지가 떨어졌습니다
會考慮看看	Tell him that you will think about it	고민해보겠다고 한다
有關勒肯家	About the Legwyn Family	르귄가에 대해
我願意收集摩奇亞根莖	I'll go and collect some Mochia stems	모치아 줄기를 모아오겠다고 한다
有關卡魯塔斯的獵人	About the Kartas Hunter	카르타스의 사냥꾼에 대해
會讓家臣醒過來	Tell him that you will wake up his vassals	가신들을 깨우겠다고 한다
會收集邪惡的牙齒	Tell him that you will collect Corrupt Fangs	부정한 이빨을 모아오겠다고 한다
放置邪惡的牙齒中	Placing Corrupt Fangs	부정한 이빨을 놓는 중
也許怪物會出現	Monsters might come out	몬스터가 나올지도 모른다고 한다
請按下'F1'鍵使用屬性點數	Press the F1 key to allocate a Status Point	'F1' 키를 눌러 스테이터스 포인트를 사용해 보세요
我還有其他事要辦	I have other things to do	다른 볼일이 있다고 한다
關於神樹之日	Tell me about Medzio Diena	신수의 날에 대해
看起來很不滿	I have some complaints	불평해 본다
關於手續	Tell me about the procedure	수속에 대해
詢問有關歐勒夏主教的事	Tell me about the bishop of Orsha	오르샤 주교에 대해 묻는다
我在這裡還有事要辦	There's still things I need to take care of here	아직 여기에 볼 일이 남아 있다고 한다
請往綠色箭頭方向移動，前往歐勒夏	Follow the green arrow to visit Orsha	녹색 화살표로 이동하여 오르샤로 이동하세요
好像沒用	I don't think it'll be much use	소용 없을 것 같다고 한다
我會把有用的物品收集回來	I'll see what I can find	쓸 만한 물건을 모아 오겠다고 한다
沒辦法	Some things can't be helped	어쩔 수 없다고 한다
有關女神消失的事	Tell me about the missing goddesses	사라진 여신들에 대해
應該沒有那樣的實力	I'm not talented enough for that	그럴 실력은 아니라고 한다
如果讓我見歐勒夏主教，我就幫忙	I'll help you if you take me to the bishop of Orsha	오르샤 주교와 만나게 해 준다면 돕겠다고 한다
好像不可能	I'm afraid that'll be impossible	불가능할 것 같다고 한다
沒那種必要	I don't think that'll be needed	그럴 필요 없다고 한다
請去找雜貨商人	Find the Item Merchant	잡화 상인을 찾아가세요
我覺得好像幫不上忙	I'm afraid I can't help you with that	별로 도움이 되지 못할 것 같다고 한다
消失的主教(4)	The Missing Bishop (4)	사라진 주교(4)
我需要再準備一下	I'm not quite ready yet	조금 더 준비가 필요하다고 한다
可能已經找不到了	I think it'll be too late already	이미 찾을 수 없을 거라고 한다
我沒那種餘力	I don't think I can do that	그럴 여력은 없다고 한다
迫近的危險(1)	Imminent Danger (1)	다가오는 위험(1)
我要去追普拉那斯	I'll follow Pranas	프라나스를 쫓아가겠다고 한다
迫近的危險(2)	Imminent Danger (2)	다가오는 위험(2)
我會盡快去找	I'll go right away	빨리 찾아가 보겠다고 한다
我還有其他事要辦	I still have other things to do	다른 일이 아직 남아 있다고 한다
詢問有沒有幫得上忙的地方	Can I help you with anything?	도울 일이 없냐고 묻는다
好好休息吧	Get some rest and be careful	조심히 쉬라고 한다
我很神經質所以辦不到	That's not for me; I have a weak stomach	비위가 약해서 할 수 없다고 한다
很謝謝你，但我拒絕	Thank you but I have to decline	고맙지만 사양한다고 한다
我消滅巢穴後再回來	I'll get rid of the nest	둥지를 없애고 오겠다고 한다
最好別做危險的事	I'd rather not have to do anything dangerous	위험한 일은 하지 않는 게 좋겠다고 한다
我要準備一下	Let me get ready first	잠시 준비를 하겠다고 한다
正在傳達調查內容	Talking about the investigation	조사 내용 전달 중
最好先護理傷口	It's better to tend to the injuries first	상처를 먼저 돌보는 게 좋겠다고 한다
應該沒用	I don't think it'll be of much use	소용없을 거라고 한다
我先確認看看	I'll try and check it out	일단 확인해 보겠다고 한다
我會負責去收集	I'll collect it	모아 오겠다고 한다
不在位置上時	While You Were Gone	자리를 비운 사이에
我想聽	I want to hear it	듣고 싶다고 한다
傳達日誌內容中	Talking about the contents of the journal	일지 내용 전달 중
我一定會取得	I'll do it no matter what	반드시 구하겠다고 한다
我不想被捲進重大事件	I don't want to get caught up in anything big	엄청난 일에 휘말리고 싶지 않다고 한다
主教烏魯波納斯的去向(1)	Bishop Urbonas' Whereabouts (1)	주교 우르보나스의 행방(1)
主教烏魯波納斯的去向(2)	Bishop Urbonas' Whereabouts (2)	주교 우르보나스의 행방(2)
我很害怕	I'm afraid	두렵다고 한다
主教烏魯波納斯的去向(3)	Bishop Urbonas' Whereabouts (3)	주교 우르보나스의 행방(3)
主教烏魯波納斯的去向(7)	Bishop Urbonas' Whereabouts (7)	주교 우르보나스의 행방(7)
主教烏魯波納斯的去向(4)	Bishop Urbonas' Whereabouts (4)	주교 우르보나스의 행방(4)
詢問有沒有其他方法	Is there no other way?	다른 방법은 없냐고 묻는다
主教烏魯波納斯的去向(5)	Bishop Urbonas' Whereabouts (5)	주교 우르보나스의 행방(5)
正在說明有關惡夢的事	Explaining the nightmare	악몽에 대해 설명하는 중
主教烏魯波納斯的去向(6)	Bishop Urbonas' Whereabouts (6)	주교 우르보나스의 행방(6)
那種事很難辦	That's a little too much for me	그런 일은 버겁다고 한다
正在使用還原寶珠	Using the Orb of Return	환원의 보주 사용 중
恐嚇脅迫	Blackmail	공갈협박
好像幫不上什麼忙	I don't think I can be of help	도움이 별로 안될 것 같다고 한다
以毒攻毒	Fight Poison With Poison	독은 독으로
來歷不明的包袱(1)	Unidentified Package (1)	정체불명의 꾸러미(1)
我不做沒必要的事	I won't do anything that's not necessary	불필요한 일은 하지 않겠다고 한다
來歷不明的包袱(2)	Unidentified Package (2)	정체불명의 꾸러미(2)
正在傳達主教的傳言	Relaying the bishop's advice	주교의 전언을 전달 중
我還有事要做	I still have other things to do	아직 할 일이 남아 있다고 한다
那想法太危險了	That's a very dangerous idea	너무 위험한 발상이라고 한다
關於傳承	Tell me about the legends	전승에 대해
正為他解開	Releasing	풀어주는 중
請等我一下	Please wait a while	잠시 기다려달라고 한다
有關祭司準備的東西	Tell me about what the priests prepared	사제들이 준비한 것에 대해
請在新房中吸收水晶的力量	Go to the Bird Room and absorb the crystal's power	새의 방에서 수정의 힘을 흡수하세요
好像沒必要	I don't think that'll be needed	필요없을 것 같다고 한다
那個地方看起來也很危險	That looks dangerous too	그곳도 위험해 보인다고 한다
應該沒有那種事	I don't think that'll happen	그럴 일은 없을 것 같다고 한다
我休息一下再去	I'm going to get some rest and go	조금만 쉬었다 가겠다고 한다
我不能丟下他自己走	I can't just go	버리고 갈 수 없다고 한다
正在傳達至今所發生的事	Talking about the recent happenings	여태껏 있었던 이야기 전하는 중
我要返回歐勒夏	I'll go back to Orsha	오르샤로 돌아가겠다고 한다
收集情報	Collecting Information	정보 수집
首要之務是趕緊離開監獄	I think it's best to get out of the prison	빨리 감옥을 나오는 게 우선이라고 한다
別太擔心	Don't worry so much	너무 걱정 말라고 한다
危險的坑道	Dangerous Mine	위태로운 갱도
尋找動力	I'll find the power	동력을 찾아 본다
適當的懷疑	Justified Suspicion	적당한 의심
我願意幫忙	I'll help you	거들어주겠다고 한다
性能改良	Improvements	성능개량
去找別人吧	I'll find the other people	다른 사람을 찾아보라고 한다
傳遞情報中	Conveying information	정보를 전달 중
回收劣品	Collect the Faulty Goods	불량품 회수
我們別管啦	We should let that go	내버려두자고 한다
想遺忘的記憶	Days to Forget	잊고 싶은 기억
我不想把手弄髒	I don't want to get my hands dirty	손을 더럽히기 싫다고 한다
準備露營	Camping Preparations	야영 준비
為了安全	For Safety	안전을 위하여
開墾地的怪物	Monsters From the Settlement Clearing	개간지의 몬스터
很難承受的事	Too Much For One Person	감당하기 힘든 일
榮耀消逝	Vanished Glory	영광은 사라지고
值的住的鄰里	Nice Place to Live	살만한 동네
守護王陵	Protect the Royal Masoleum	왕릉을 지켜라
隱藏的魔力裝置	Hidden Magic Devices	숨겨진 마력장치
為贖罪而做的努力	Efforts Towards Redemption	속죄를 위한 노력
迷失的朝聖者	Lost Pilgrim	길 잃은 순례자
危險的防礙者	Dangerous Distraction	위험한 방해꾼
適合復原的日子	Good Day to Recover	회복하기 좋은 날
為的是甚麼	For What	무엇을 위하여
被藏起來的農具	Hidden Farming Equipment	숨겨둔 농사 도구
挑戰精神	Can-do Spirit	도전 정신
生活的根據	Habitat	삶의 터전
向遠方眺望	Thinking Ahead	멀리 내다보기
嚴重的動亂	Violent Rampage	너무 심한 난동
期帶女神復原	Hoping the Goddess Will Recover	여신의 회복을 바라며
走投無路的同伴們	Stuffy Colleagues	꽉 막힌 동료들
尋找隱藏遺物	Find the Hidden Artifacts	숨은 유물 찾기
我要再考慮看看	I'll think about it again	다시 생각해 보겠다고 한다
感覺不像考驗	That doesn't look like a test	시험은 좀 아닌 것 같다고 한다
我什麼都願意做	I'll do what I have to do	뭐든 하겠다고 한다
我再也不會逞強	I don't want to push myself too far anymore	더 이상 무리는 하지 않겠다고 한다
我要製作人偶	I'll try and make a doll	인형을 만들겠다고 한다
我很難接受瑣碎的請求	I don't think I can tend to such a puny request	사소한 부탁은 들어주기 힘들다고 한다
詢問有沒有配送	Do you need something delivered?	배달은 없는지 묻는다
我是抱著從頭學起的覺悟來的	Learning is why I came here in the first place	처음부터 배울 각오로 왔다고 한다
我準備好面對使命了	I'm ready to take on the mission	사명에 임할 준비가 되었다고 한다
符咒所需的東西[邪靈祭司轉職]	Charm Requirements [Bokor Advancement]	부적에 필요한 것[보코르 전직]
詢問是什麼材料	What kind of material is it?	어떤 재료인지 묻는다
我去尋找本體	I'll go and look for it	본체를 찾아가겠다고 한다
新的陰謀	A New Plot	새로운 음모
表明自己是啟示者	I'm a Revelator	계시자임을 밝힌다
接受警告後回到安全的地方	I understand; I'm going somewhere safe	경고를 받아들이고 안전한 곳으로 돌아간다
探索保護咒語	Investigating the Protection Cast	보호 주문 탐색
我很難參與	It'll be difficult for me to take part in that	참여하기 어렵겠다고 한다
好啊	Okay	좋다고 한다
我要等梅西歐拉斯準備	I'll wait for Melchioras to get ready	멜히오라스의 준비를 기다리겠다고 한다
關於柯拉佩達的啟示者	Tell me about the Revelators of Klaipeda	클라페다의 계시자에 대해
我以後再幫忙	I'll help you next time	나중에 돕겠다고 한다
把安潔奈聖所上方的保護符文解開吧！	Remove the protection spell above Amjene Sanctuary	암제네 성소 위쪽에 있는 보호 주문을 해제하세요
炸掉魔力供給裝置	Destroy the Magic Power Supply Device	마력 공급장치 폭파하기
我把晶球放好就回來	I'll set down the orbs	구슬을 놓고 오겠다고 한다
把伊薛提十字路口的魔力供應裝置移動到其他地方吧！	Go to the Magic Power Supply Device in Ishinti Crossroads 	이쉰티 사거리에 있는 마력 공급 장치 주변으로 이동하세요
在德慕爾莊園碰面吧	Let's meet at Delmore Manor	델무어 장원에서 만나자고 한다
我願意幫忙，但該收集什麼情報呢？	I can help you; what kind of information do you need me to gather?	도와줄 테니 어떤 정보를 모아야 하는지 묻는다
那點能耐還不夠	I don't think I'm skilled enough for that	그럴 실력은 못 된다고 한다
正在傳達取得的情報	Relaying all information gathered	얻은 정보를 전해주는 중
我要忙其他事	I'm busy with other things	다른 일로 바쁘다고 한다
我會在消滅怪物時順便找看看	I'll do it while I hunt some monsters	몬스터를 처치하는 김에 찾아보겠다고 한다
既然是用過的東西就扔了吧	Give up everything that's already been used	이미 한 번 쓴 물건은 포기하라고 한다
其他的啟示者應該會找到辦法	I think the other Revelators will find a way	다른 계시자들이 방법을 찾을 것 같다고 한다
現在我已經累了	I'm a little tired now	이제는 지쳤다고 한다
這次我無法相信	I can't believe anymore	이번엔 믿지 못하겠다고 한다
克魯比那與啟示者	Kruvina and the Revelators	크루비나와 계시자
請等我一下	Please wait a while	잠시만 기다려달라고 한다
請交給我吧	Just tell me what you need	맡겨만 달라고 한다
最好盡量堆積周圍的物品	It's best to gather as much as possible from this area	되는대로 주변 물건들을 쌓는게 좋겠다고 한다
我會消滅四周的魔族	I'll defeat some demons around here	주변의 마족을 처치하겠다고 한다
我沒閒功夫幫你	I have no time to help you	도와줄 겨를이 없다고 한다
疚歉的心	A Sorrowful Heart	미안한 마음
家鄉的秘訣	Hometown Secret	고향의 비결
我有其他更急的事	I have more urgent issues to tend to	다른 일이 더 급하다고 한다
追擊德慕爾城主(1)	Chasing Lord Delmore (1)	델무어 성주 추격(1)
我們快追趕吧	Let's follow after	어서 뒤쫓자고 한다
追擊德慕爾城主(2)	Chasing Lord Delmore (2)	델무어 성주 추격(2)
頑強的結界	Unbreakable Barrier	집요한 결계
我們快走吧	Let's hurry	어서 가자고 한다
我們稍微喘口氣吧	Let's catch our breath for a while	잠시 숨 좀 돌리자고 한다
前往官廳廢墟	To the Government Ruins	관청 폐허로
我們趕快出發吧	Let's go now	어서 출발하자고 한다
我們休息一下再走吧	Let's get some rest first	조금만 쉬었다 가자고 한다
咒術人偶與恩人	The Shaman Doll and the Savior	주술 인형과 은인
逼入絕境(1)	Lead to a Dead-end (1)	막다른 곳으로 몰다(1)
逼入絕境(2)	Lead to a Dead-end (2)	막다른 곳으로 몰다(2)
安慰他們	Comforting Them	그들을 위로하며
這只不過是開始	This is Only the Beginning	이것은 시작일 뿐
我們回去找梅西歐拉斯吧	Let's go back to Melchioras	멜히오라스에게 돌아가자고 한다
別再發生那種事	For It to Never Happen Again	다시는 그런 일이 없도록
我會積極幫忙	I'll help out as much as I can	적극 돕겠다고 한다
現在是時候離開了	I think it's time to leave	이제 떠날 때가 되었다고 한다
我負責善後吧	I'll take it from here	뒤처리는 맡기겠다고 한다
我會馬上收集到手交給你	I'll bring it to you as soon as I have it	바로 모아다 주겠다고 한다
看起來不一定要出手	It doesn't seem like we need to take action	굳이 손쓸 필요는 없어 보인다고 한다
祈禱妨礙者	Those Who Disturb the Prayers	기도를 방해하는 자들
這種事太為難人了	It's hard for me	이런 일은 곤란하다고 한다
事前預防	Preventive Measures	사전 예방
會破壞棺木跟淨化亡者	I'll purify the dead ones by destroying the coffins	관을 파괴하여 망자들을 정화하겠다고 한다
嬌貴的守墓人	The Picky Grave Keeper	까탈스러운 묘지기
會去見守墓人	I'll search for the grave keeper	묘지기를 찾아 가겠다고 한다
直接解開比較好	It'll be better to untie it yourself	직접 푸는 게 좋겠다고 한다
關於女神的聖物	About the holy relic of the goddess	여신의 성물에 대해
讓亡者安息	Rest In Peace	망자에게 안식을
尤塔說會找回女神	Tell him that Juta has come to look for the goddess	유타는 여신을 찾아왔다고 한다
那就沒有辦法了	Tell him that you're not interested	그럼 어쩔 수 없겠다고 한다
詭異的聖所 (1)	Suspicious Sanctum (1)	수상한 성소 (1)
詭異的聖所 (3)	Suspicious Sanctum (3)	수상한 성소 (3)
會四處看看再過來	I will take a look around	둘러보고 오겠다고 한다
談話中	Talking	이야기하는 중
誤信	The Wrong Faith	잘못된 믿음
會先走一步	I will go there first	먼저 가 있겠다고 한다
詭異的信徒們	Suspicious Believers	수상한 신도들
陷入危機的男子	Desperate Man	위기의 남자
生前記得的邪念	Remembering the Thoughts of Life before Death	생전을 기억하는 사념
為了入團一定會幫忙	I'll help in order to join the Order	입단을 위해서라면 도와주겠다고 한다
為了入團會進行	I will do it if it is for the Order	입단을 위해서라면 하겠다고 한다
教壇的指導者	The Leader of the Order	교단의 지도자
在尋找教壇的邪惡行為	I am looking for the corrupted acts of the Order	교단의 부정을 찾고 있다고 한다
看起來似乎會白費功夫就當作沒這回事吧	Let's ignore since it seems you are seeing some hallucinations	헛것이 보이는 것 같으니 무시하자
說明看到的東西中	Explaining to him what you saw	본 것을 설명하는 중
靈魂審問	Spirit Interrogation	영혼 심문
會去看看卡拉伊爾	I will go to Carlyle	칼라일에게 가보겠다고 한다
會保留	I will suspend it	보류하겠다고 한다
會揭發真理之樹教團的陰謀	I am in search of the Order of the Tree of Truth's conspiracy	진리의 나무 교단의 음모를 파헤치러 왔다고 한다
與其給這些傢伙(1)	I Won't Give It To Them (1)	놈들에게 넘길 바에야 (1)
要做的事情已經完成要離開了	I will leave since I've done my task	할 일을 다했으니 떠나겠다고 한다
莊園持有者名單在這裡的理由	The reason why the list of manor owners is here	장원 소유자 명단이 여기 있는 이유
詭異的聖所 (2)	Suspicious Sanctum (2)	수상한 성소 (2)
現在請你自己看著辦	Do as you wish now	이제 알아서 하라고 한다
與其給這些傢伙(2)	I Won't Give It To Them (2)	놈들에게 넘길 바에야 (2)
會燒了他們	I will burn them	불태우겠다고 한다
這樣做很可惜	It is too good to do that	그러기엔 아깝다고 한다
幫忙的人手	Helping Hand	도움의 손길
神秘少女(1)	The Mysterious Girl (1)	신비한 소녀 (1)
找回糧食	Reclaiming Food	식량 되찾기
有關神秘的少女說明中	Talking about the Mysterious Girl 	신비한 소녀에 대해 이야기 중
神秘少女(2)	The Mysterious Girl (2)	신비한 소녀 (2)
染在雪貂上的圖騰	Ferret-Controlling Totem	페릿을 물들인 토템
神秘少女(3)	The Mysterious Girl (3)	신비한 소녀 (3)
有關不能向近處求助的原因	Why can't you ask for help around here?	인근에 도움을 구하지 못하는 이유에 대해
需要可以喝的東西	Thirst for Drinks	마실 것이 필요해
有關不向四周求助的原因	Why don't you ask for help around here?	주변에 도움을 구하지 않는 이유에 대해
調味(1)	Putting Spices (1)	양념 치기 (1)
會去汙染	I will come back after polluting it	오염시키고 오겠다고 한다
調味(2)	Putting Spices (2)	양념 치기 (2)
和平雕像(1)	Statue of Peace (1)	평화의 조각상 (1)
會打聽看看	I will find out more about it	알아보겠다고 한다
和平雕像(2)	Statue of Peace (2)	평화의 조각상 (2)
引導的少女(1)	The Guiding Girl (1)	인도하는 소녀 (1)
引導的少女(2)	The Guiding Girl (2)	인도하는 소녀 (2)
消失的少女(1)	The Missing Girl (1)	사라진 소녀 (1)
正訴說著少女遭到綁架	Explaining about the Kidnapped Girl	소녀가 납치당했다고 말하는 중
消失的少女(2)	The Missing Girl (2)	사라진 소녀 (2)
消失的少女(3)	The Missing Girl (3)	사라진 소녀 (3)
女神的安排(1)	The Goddess' Assignment (1)	여신의 안배 (1)
女神的安排(2)	The Goddess' Assignment (2)	여신의 안배 (2)
女神的安排(3)	The Goddess' Assignment (3)	여신의 안배 (3)
收集行動方式	Recording the Behavior	행동양식 수집
物我一體	The Blurred Barrier Between The Thing and I	물아일체
正在告知打聽到的情報	Explaining all the info you have found	알아낸 정보를 얘기하는 중
無法相信的現實(1)	Unbelievable Reality (1)	믿을 수 없는 현실 (1)
告知結果中	Reporting the results	결과를 얘기하는 중
無法相信的現實(2)	Unbelievable Reality (2)	믿을 수 없는 현실 (2)
與神靈的相遇	Divine Encounter 	신성과의 조우
被綁架的女神	Kidnapped Goddess	납치된 여신
詢問要做什麼	What should I do?	뭘 해야하는지 묻는다
解放束縛	Release the Goddess	구속 해방
破壞生命力吸收裝置	Destroy Vitality Absorption Device	생명력 흡수 장치 파괴
必須要消失的存在	The Thing That Should Not Let It Be	사라져야할 존재
女神的隱藏訊息	The Goddess' Hidden Message	여신의 숨겨진 메시지
神殿復原準備(1)	Temple Rebuilding Preparation (1)	신전 복구 준비 (1)
神殿復原準備(2)	Temple Rebuilding Preparation (2)	신전 복구 준비 (2)
我會打聽後回來	I will come back with some answers	알아보고 오겠다고 한다
正在說明情況	Explaining the situation	사정을 설명하는 중
神殿復原準備(3)	Temple Rebuilding Preparation (3)	신전 복구 준비 (3)
我會淨化後回來	I will be the one to purify	정화하고 오겠다고 한다
蘊藏大地氣息的花	The Flower Enriched With the Earth	대지의 기운을 품은 꽃
請自己看著辦	Do as you wish	알아서 하라고 한다
很煩	I am too lazy to do it	귀찮다고 한다
陷入危機的奎波爾 (1)	Kupole in Danger (1)	위기의 큐폴 (1)
陷入危機的奎波爾 (2)	Kupole in Danger (2)	위기의 큐폴 (2)
被封印的女神傳說 (1)	The Legend of the Goddess' Seal (1)	봉인된 여신 전설 (1)
被封印的女神傳說 (2)	The Legend of the Goddess' Seal (2)	봉인된 여신 전설 (2)
詢問可否使用移動魔法陣	Can we use the Teleportation Magic Circle?	이동 마법진을 사용할 수 있는지 물어본다
詢問複原魔法陣的方法	How can we restore the magic circle?	마법진을 복구하는 방법을 묻는다
前往女神的安息處 (1)	To the Goddess' Refuge (1)	여신의 안식처로 (1)
前往女神的安息處 (2)	To the Goddess' Refuge (2)	여신의 안식처로 (2)
前往女神的安息處 (3)	To the Goddess' Refuge (3)	여신의 안식처로 (3)
不間斷的騷擾 (1)	Constant Interference (1)	빈틈 없는 방해 (1)
不間斷的騷擾 (2)	Constant Interference (2)	빈틈 없는 방해 (2)
向女神前進的腳步	One Step Closer to the Goddess	여신을 향한 발걸음
被洗腦的部族 (1)	Brainwashed Tribe (1)	세뇌당한 부족 (1)
被洗腦的部族  (2)	Brainwashed Tribe (2)	세뇌당한 부족 (2)
被洗腦的部族 (3)	Brainwashed Tribe (3)	세뇌당한 부족 (3)
日漸脆弱的氣息 (1)	Weakening Aura (1)	미약해지는 기운 (1)
日漸脆弱的氣息 (2)	Weakening Aura (2)	미약해지는 기운 (2)
又一個奎波爾 (1)	Another Kupole (1)	또 다른 큐폴 (1)
又一個奎波爾 (2)	Another Kupole (2)	또 다른 큐폴 (2)
詢問發生甚麼事了	What happened?	무슨 일이 있었는지 물어본다
救出奎波爾 (1)	Kupole Rescue Mission (1)	큐폴 구출 (1)
救出奎波爾 (2)	Kupole Rescue Mission (2)	큐폴 구출 (2)
救出奎波爾 (3)	Kupole Rescue Mission (3)	큐폴 구출 (3)
恢復的氣息	Recovering Energy	회복의 기운
詢問是否有恢復賽力亞氣息的方法。	Is there a way to restore Serija's energy?	세리야의 기운을 회복시킬 방법이 없는지 물어본다
女神在哪呢	Where is the Goddess	여신은 어디에
血正召喚著血	Blood Begets Blood	피는 피를 부른다
越來越衰弱	Dwindling Energy	쇠약해진 기력
把眼光降低	Less Eyes to See	보는 눈 줄이기
危險的會面 (1)	Dangerous Encounter (1)	위험한 만남 (1)
危險的會面 (2)	Dangerous Encounter (2)	위험한 만남 (2)
危險的會面 (3)	Dangerous Encounter (3)	위험한 만남 (3)
被黑暗吞噬的奎波爾 (1)	Kupole in the Darkness (1)	어둠에 물든 큐폴 (1)
被黑暗吞噬的奎波爾 (2)	Kupole in the Darkness (2)	어둠에 물든 큐폴 (2)
發瘋的女神 (1)	Deranged Goddess (1)	미쳐버린 여신 (1)
發瘋的女神 (2)	Deranged Goddess (2)	미쳐버린 여신 (2)
發瘋的女神 (3)	Deranged Goddess (3)	미쳐버린 여신 (3)
被綁架的女神	Abducted Goddess	납치당한 여신
再怎麼急也沒辦法	Despite Urgent Matters	아무리 급해도
有點晚了不過	Too Late Already	이미 늦었지만
最後的機會 (1)	Before It's Too Late (1)	더 늦기 전에 (1)
最後的機會 (2)	Before It's Too Late (2)	더 늦기 전에 (2)
到底躲去哪了呢？ (1)	They Hid Her (1)	어디에 숨겼을까 (1)
到底躲去哪了呢？ (2)	They Hid Her (2)	어디에 숨겼을까 (2)
到底躲去哪了呢？ (3)	They Hid Her (3)	어디에 숨겼을까 (3)
可行嗎？	Is that even possible?	그게 가능하냐고 한다
到底躲去哪了呢？ (4)	They Hid Her (4)	어디에 숨겼을까 (4)
到底躲去哪了呢？ (5)	They Hid Her (5)	어디에 숨겼을까 (5)
借用女神的力量 (1)	With the Power of the Goddess (1)	여신의 힘을 빌려 (1)
詢問通知魔王正在靠近的方法	Explaining about the Demon Kings and asking what to do	마왕이 다가오고 있음을 알리고 방법을 물어보는 중
借用女神的力量 (2)	With the Power of the Goddess (2)	여신의 힘을 빌려 (2)
再前進一步	One Final Step	한 걸음만 더
有毅力的傢伙們	Persistent Creatures	끈질긴 녀석들
邪惡符咒	Evil Talismans	사악한 부적
源泉縫隙	Preemptive Defense	원천봉쇄
勢力弱化	Reducing Numbers	세력 약화
女神死去之地	The Place of the Hidden Goddess	여신이 숨겨진 곳
魔王抵達之前 (1)	Before the Demon King Arrives (1)	마왕이 도착하기 전에 (1)
問問看有沒有方法	Is there any way we can do it?	방법이 있는지 물어본다
魔王抵達之前 (2)	Before the Demon King Arrives (2)	마왕이 도착하기 전에 (2)
一起去找找看	We should look for them	찾아보자고 한다
魔王抵達之前 (3)	Before the Demon King Arrives (3)	마왕이 도착하기 전에 (3)
秘傳武器	Unexpected Weapon	비장의 무기
無法忽視的存在 (1)	Powerful Being (1)	강력한 존재 (1)
無法忽視的存在 (2)	Powerful Being (2)	강력한 존재 (2)
女神的犧牲 (1)	The Goddess' Sacrifice (1)	여신의 희생 (1)
女神的犧牲 (2)	The Goddess' Sacrifice (2)	여신의 희생 (2)
女神的遺言	Her Last Words	여신의 마지막 목소리
朝向強大的副本去	Road to the Ruthless Dungeon	강력한 던전을 향해
柯拉佩達的傭兵委託所	Klaipeda's Mercenary Post 	클라페다의 용병의뢰소
汙染的湖水(1)	The Corrupted Lake (1)	오염된 호수(1)
汙染的湖水(3)	The Corrupted Lake (3)	오염된 호수(3)
我還沒有能力解決那種事	I don't think I'm skilled enough to solve a problem like that	그런 걸 해결할 수 있는 능력은 못된다고 한다
調查中	Investigating	조사중
灰燼裡發現了什麼。	You found something in the ashes	잿더미 속에서 무언가를 발견했습니다.
汙染的湖水(4)	The Corrupted Lake (4)	오염된 호수(4)
我去尋找村長	I'll find the village chief	촌장을 찾아 보겠다고 한다
汙染的湖水(5)	The Corrupted Lake (5)	오염된 호수(5)
我再也不能眼睜睜看人惹事了	I can't see any more accidents	더 이상 사고치는 걸 볼 수 없다고 한다
汙染的湖水(6)	The Corrupted Lake (6)	오염된 호수(6)
請閱讀日誌	Read the diary to me	일지를 읽어 달라고 한다
請以後再讀	Read it to me later	나중에 읽어 달라고 한다
給女神的貢品(1)	Offerings to the Goddess (1)	여신께 공물을(1)
雖然有點奇怪，但我會幫忙	That's a bit weird but I'll help you	조금 이상하긴 하지만 일단 돕겠다고 한다
女神不可能會做那種事	There's no way the goddesses would do that	여신은 그런 짓을 할 리가 없다고 한다
給女神的貢品(2)	Offerings to the Goddess (2)	여신께 공물을(2)
不管怎麼說都不是這個	I don't think this is it	아무래도 이건 아닌 것 같다고 한다
我不會去	I have nothing to do there	갈 일이 없다고 한다
這點事我願意幫忙	I can help you with that	그 정돈 돕겠다고 한다
解決汙染源(1)	Clear the Corruption (1)	오염원 해결(1)
正在傳達日誌內容	Relaying the contents of the diary	일지의 내용을 알려주는 중
時機未到	It's not time for that yet	아직 그럴 때가 아니라고 한다
解決汙染源(2)	Clear the Corruption (2)	오염원 해결(2)
一起想想	Joining Forces	같이 생각해 본다
如果找到方法請告訴我	Let me know if you find a way	방법을 찾으면 알려달라고 한다
正在說有關水螅的事	Talking about the Hydra	히드라에 대해 이야기하는 중
解決汙染源(3)	Clear the Corruption (3)	오염원 해결(3)
解決汙染源(4)	Clear the Corruption (4)	오염원 해결(4)
我會等到陷阱全部完成	I'll wait until you're done with the trap	덫을 다 만들때까지 기다리겠다고 한다
解決汙染源(5)	Clear the Corruption (5)	오염원 해결(5)
解決汙染源(6)	Clear the Corruption (6)	오염원 해결(6)
我要去抓水螅	I'll go and catch the Hydra	히드라를 잡으러 가겠다고 한다
那水不能喝啦	You Can't Drink That	마시는 물이 아니라니까
我沒那種閒工夫	I don't think I have time for that	그럴 겨를은 없을 것 같다고 한다
防止再度發生(1)	Recurrence Prevention (1)	재발 방지(1)
為了讓他不能再做那種事，我願意幫忙	I'll help you so something like that doesn't happen again	다시는 그런 짓을 못하도록 돕겠다고 한다
很危險，你就忍忍嘛	It's too dangerous; just hold on	위험하니 참으라고 한다
防止再度發生(2)	Recurrence Prevention (2)	재발 방지(2)
最好還是忍耐比較好	Waiting it out is definitely the best	역시 참는 게 좋겠다고 한다
汙染的湖水(2)	The Corrupted Lake (2)	오염된 호수(2)
察看貓頭鷹(1)	Observing the Owl (1)	부엉이 살펴보기(1)
沉睡的貓頭鷹雕像的記憶	Memories of the Sleeping Owl	잠든 부엉이상의 기억
尤拉泰女神的繼承者(1)	Goddess Jurate's Loremaster (1)	유라테 여신의 전승자(1)
建造祭壇(1)	Raising an Altar(1)	제단 세우기(1)
建造祭壇(2)	Raising an Altar (2)	제단 세우기(2)
建造祭壇(3)	Raising an Altar (3)	제단 세우기(3)
奪回祭壇	Retaking the Altar	제단 되찾기
比較好的貢品	Better Offerings	더 나은 공물
最近關注的議題	What Interests You These Days	요즘 관심이 가는 것
獻給女神的儀式	Ceremony for the Goddess	여신께 바치는 의식
耍心機(1)	Winning Favors (1)	환심사기(1)
耍心機(2)	Winning Favors (2)	환심사기(2)
事先收集(1)	Preparing for the Future (1)	미리 모아두기(1)
事先收集(2)	Preparing for the Future (2)	미리 모아두기(2)
短劍的主人	Dagger's Owner	단검의 주인
極有人情的	Extremely Humanly	지극히 인간적으로
開始進行仲裁(2)	A Mediator is Born (2)	중재 시작(2)
開始進行仲裁(3)	A Mediator is Born (3)	중재 시작(3)
劇情有了意外發展(1)	Plot Twist (1)	의외의 전개(1)
劇情有了意外發展(2)	Plot Twist (2)	의외의 전개(2)
首先，詢問兩人爭吵的理由是否因為紅楓	Are you fighting because of the leaves?	일단, 둘이 싸우는 이유가 단풍 때문인지 묻는다
製造魔法具(1)	Making the Magic Sphere (1)	마법구 만들기(1)
製造魔法具(2)	Making the Magic Sphere (2)	마법구 만들기(2)
詢問有關亮晶晶粉末	What's the glimmering powder?	반짝이는 가루에 대해 묻는다
尤拉泰女神侍奉者(1)	Followers of Goddess Jurate(1)	유라테 여신을 섬기는 자들(1)
尤拉泰女神侍奉者(2)	Followers of Goddess Jurate(2)	유라테 여신을 섬기는 자들(2)
尤拉泰女神侍奉者(3)	Followers of Goddess Jurate(3)	유라테 여신을 섬기는 자들(3)
尤拉泰女神侍奉者(4)	Followers of Goddess Jurate(4)	유라테 여신을 섬기는 자들(4)
看來得告訴你使用紀錄寶珠時的注意事項才行！{nl}紀錄寶珠烙印在腦海中的時間並不長。	The Missing Loremaster	사라진 전승자
急救(1)	First Aid(1)	응급처치(1)
急救(2)	First Aid(2)	응급처치(2)
猜忌的哈勃克大概是因為自己的部下巨錘王沒有出現，所以起疑了，目前已經去找欺瞞的哈勃克了。	Ritual for the Sea(1)	바다를 위한 의식(1)
海洋儀式(2)	Ritual for the Sea(2)	바다를 위한 의식(2)
海洋儀式(3)	Ritual for the Sea(3)	바다를 위한 의식(3)
包在我身上	I can handle it	맞겨달라고 한다
可疑的魔族動向	The Suspicious Demons	수상한 마족의 동향
魔法陣的來歷	Identifying the Magic Circle	마법진의 정체
被封印的聖物	Sealed Relic	봉인된 성물
該怎麼做？	What do I have to do?	어떻게 해야하는지 묻는다
破壞可疑裝置	Destroy the Suspicious Device	수상한 장치 파괴
淨化儀式	Purification Ritual 	정화 의식
我願意幫忙淨化	I'll help with the purification	정화를 돕겠다고 한다
結束後告訴我	Tell me when you are finished	끝나고 말해달라고 한다
尤拉泰女神的傳言	Goddess Jurate's Message	유라테 여신의 전언
沒有任何問題	There's no problem	아무 문제 없다고 한다
前往耶沛羅塔歐海岸	Towards Eperotao Coast	에페로타오 해안으로
迅速淨化	Swift Purification	신속한 정화
現在有其他重要的事	Right now I have other important task	지금은 다른 중요한 일이 있다고 한다
消滅殘存的魔族	Dealing with the remaining demons	잔존한 마족 정리
這次很很困難	It'll be difficult this time	이번에는 힘들다고 한다
把握狀況	Figuring out the situation	상황 파악
我會準備	Let me get ready	준비를 하겠다고 한다
正在述說看到的內容	Relaying what you saw	본 내용을 말하는 중
破壞魔族的裝置(1)	Destroy the Demon Device(1)	마족의 장치를 파괴하라(1)
破壞魔族的裝置(2)	Destroy the Demon Device(2)	마족의 장치를 파괴하라(2)
破壞魔族的裝置(3)	Destroy the Demon Device(3)	마족의 장치를 파괴하라(3)
我在這理等	I'll wait here	여기서 기다리겠다고 한다
破壞巨大克魯比那(1)	Destroy the Massive Kruvina(1) 	거대 크루비나 파괴(1)
我去停止裝置再回來	I'll stop the device	장치를 멈추고 오겠다고 한다
破壞巨大克魯比那(2)	Destroy the Massive Kruvina(2) 	거대 크루비나 파괴(2)
女神的回應	The Goddess' Reply	여신의 응답
淨化研究(1)	Purification Research(1)	정화를 위한 연구(1)
淨化研究(2)	Purification Research(2) 	정화를 위한 연구(2)
詢問方法	How can I do it?	방법을 묻는다
現在很難	That's too difficult to do now	지금은 어렵다고 한다
消滅殘黨	Defeat the stragglers	잔당 처치
我願意消滅殘黨	I'll eradicate the stragglers	잔당 퇴치를 하겠다고 한다
我還得休息	It has to be easier now	아직은 쉬어야 한다고 한다
看人很準	Unusual Eyes	보는 눈이 남 달라
好消息	Good News	반가운 소식
修理劍練習台(1)	Sword Pell Repair (1)	검 연습대 수리(1)
修理劍練習台(2)	Sword Pell Repair (2)	검 연습대 수리(2)
我珍貴的朋友(1)	My Precious Friend (1)	내 소중한 친구(1)
詢問如何製作飼料	How do you make the food?	먹이는 어떻게 만드냐고 묻는다
我珍貴的朋友(2)	My Precious Friend (2)	내 소중한 친구(2)
第一中的第一	Best of the Best	으뜸 중에 으뜸
詢問過得如何。	How are you doing?	잘지냈냐고 묻는다
不間斷的怪物	Monsters after Monsters	끊임없는 몬스터
罪犯們的隱密場所	The Inmates' Secret Spots	죄수들의 은밀한 장소
犧牲者的請求	Victims' Request	희생자의 요청
雪貂的壞習慣	Ferrets and Their Grabby Hands	패릿의 못된 손 버릇
追悼犧牲者們(1)	Remembering the Victims (1)	희생자들을 추모하며(1)
追悼犧牲者們(2)	Remembering the Victims (2)	희생자들을 추모하며(2)
意外的消息	Unexpected News	뜻밖의 소식
為了成功進行研究	Research For Success	성공을 위한 연구
詢問該怎麼幫忙	How can I help you?	어떻게 도와주면 되냐고 묻는다
為了恢復魯西安的名譽(1)	Restoring Lucienne's Honor (1)	루시엔의 명예 회복(1)
為了恢復魯西安的名譽(2)	Restoring Lucienne's Honor (2)	루시엔의 명예 회복(2)
將史普恩的意思轉達給魯西安溫特知道	Complete the last mission using the decoy at Grobis Crossroads	루시엔 윈터스푼의 의사를 전달하는 중
[活動] 隱藏的寶箱	[Event] Scavenge Challenge	[이벤트] 숨겨진 보물 상자
[活動] 箱子快遞員	[Event] Daily Mystery Delivery	[이벤트] 상자 배달원
執行柯拉佩達傭兵委託所的委託	Carry out Klaipeda's Mercenary Post Mission	클라페다 용병 의뢰소 의뢰 수행
柯拉佩達傭兵委託所的委託報告	Klaipeda Mercenary Post's Mission Report	클라페다 용병 의뢰소의 의뢰 보고
和警戒兵交談	Talk to the Sentinel	경계병과 대화
在西邊森林營區和騎士堤塔斯交談	Talk to Knight Titas in Western Forest Camp	서쪽 숲 캠프에서 기사 티타스와 대화
再和騎士堤塔斯交談	Talk to Knight Titas again	기사 티타스와 다시 대화
在標示的地方和偵察兵交談	Talk to the Scout in the marked area	표시된 곳에서 정찰병과 대화
擊退蜂擁而來的凱帕	Defeat the Kepas surging in	몰려드는 케파 무리 처치
確認偵察兵的狀態	Check on the Scout	정찰병의 상태를 확인
再次告知偵察兵前往柯拉佩達的歸隊命令	Remind the Scout that there is an order to assemble to Klaipeda	정찰병에게 클라페다로 가기 위한 복귀 명령이 있음을 다시 알림
將行李包袱交給偵察兵	Return the belongings	정찰병에게 짐 꾸러미 전달
和戰鬥組長交談	Talk to the Battle Commander	전투 조장과 대화
向騎士堤塔斯報告	Report to Knight Titas	기사 티타스에게 보고
在標示的地方尋找搜查兵	Find the Search Scout in the marked area	표시된 곳에서 수색병 찾기
和搜查兵交談	Talk to the Search Scout	수색병과 대화
消滅蜂擁而來的巨大凱帕	Defeat the Large Kepa	달려드는 대형 케파 처치
和拉伊摩那斯交談	Talk to Laimonas	라이모나스와 대화
敬拜女神像	Worship the Goddess Statue	여신상에 경배
和柯拉佩達警備兵隊長交談	Talk to the Klaipeda Guard Captain	클라페다 경비병 대장과 대화
消滅礦石龜	Defeat Infrorocktor	인프로락터 처치
移動到柯拉佩達	Go to Klaipeda	클라페다로 이동
消滅突然出現的遠古石龜獸	Defeat the Rocktortuga that suddenly appeared	갑자기 나타난 락토르투가 처치
去找戰鬥組長，並且告知歸隊命令	Notify the Battle Commander of the order to assemble	전투 조장에게 복귀 명령 알림
移動到粉紅小花怪出沒地	Go to the Hanaming-infested area	하나밍 출몰지로 이동
追擊粉紅小花怪	Chase the Hanamings	하나밍 추격
消滅周圍的粉紅小花怪	Defeat the surrounding Hanamings	주변의 하나밍들을 처치
移動到粉紅小花怪棲息地	Go to the Hanaming habitat	하나밍 서식지까지 이동
將粉紅小花怪花瓣交給戰鬥組長	Give the Hanaming Petals to the Battle Commander	전투 조장에게 하나밍 꽃잎 전달
探索看起來相當危險的地方	Scout the dangerous looking area	위험해 보이는 곳 탐색
向戰鬥組長報告	Report to the Battle Commander	전투 조장에게 보고
消滅青苔泥人	Defeat Golem	골렘 처치
消滅巨大凱帕	Defeat the Large Kepa	대형 케파 처치
回去找搜查兵	Return to the Search Scout	수색병에게 돌아가기
移動到東邊森林營區據點	Go to the Eastern Woods Base Camp	동쪽 숲 캠프 거점으로 이동
消滅出現在東邊森林營區據點的波亞塔	Defeat the Poata in the Eastern Woods Base Camp	동쪽 숲 캠프 거점에 나타난 포아타 처치
和騎士阿拉斯交談	Talk to Knight Aras	기사 아라스와 대화
消滅襲擊前哨基地的波亞塔	Defeat the Poata that raided the outpost	전초기지를 습격한 포아타 처치
向騎士阿拉斯詢問有關礦山村莊	Talk to Knight Aras to inquire about the Miners' Village	기사 아라스에게 광산 마을에 대해 문의하기
消滅農場的波庫布	Defeat the Pokubus at the farm	농장의 포쿠부 처치
向騎士阿拉斯報告	Go to Knight Aras	기사 아라스에게 보고
狩獵卓柏卡布拉 	Hunt Chupacabras	츄파카브라 사냥
回去向警戒兵報告	Return and report to the Sentinel	경계병에게 돌아가 보고
向警戒兵聽取關於補給地的說明	Listen to the Sentinel about the Supplies Camp	경계병에게 보급지에 관한 설명 듣기
奪取補給地	Reclaim the Supplies Camp	보급지 탈환
回去向前哨基地警戒兵報告	Report back to the Outpost Sentinel	전초기지 경계병에게 돌아가 보고
消滅補給基地的卓柏卡布拉	Defeat the Chupacabras in the Supplies Camp	보급기지의 츄파카브라 처치
向補給負責官取得卓柏卡布拉的情報	Obtain information about Chupacabras from the Supply Officer	보급 담당관에게 츄파카브라 정보 얻기
解決巨大灰色卓柏卡布拉 	Defeat the Large Gray Chupacabras	대형 회색 츄파카브라 처치
回去向補給負責官報告	Report back to the Supply Officer	보급 담당관에게 돌아가 보고
消滅繼卓柏卡布拉之後出現的巨大灰色卓柏卡布拉	Defeat the Large Gray Chupacabras that appears from defeating a Chupacabra	츄파카브라 처치 시 출현하는 대형 회색 츄파카브라 처치
和補給負責官交談	Talk to the Supply Officer	보급 담당관과 대화
往補給地下方移動	Go to the lower side of the camp	보급지 아랫쪽으로 이동
請在補給地下方追蹤韋伯的蹤跡。	Track the trails of the Weaver at the lower side of the base	보급지 아랫쪽에서 위버의 흔적을 추적하세요.
消滅韋伯	Defeat Weaver	위버 처치
為了追尋女神的啟示進入了水晶礦山的騎士阿拉斯的提案中，請跟他聊聊這次要執行的任務吧。	Talk about what to do now to go to Crystal Mine	여신의 계시를 좇아 수정광산으로 들어가기 위한 기사 아라스의 제안 중 이번에 해야 할 일에 대해 이야기해 보세요.
向波波小獅王收集線索	Collect a clue from Popolions	포포리온에게서 단서가 될 만한 것 수집
將布貝衣服碎片交給作戰負責人	Give the Piece of Vubbe Cloth to the Operations Officer	부베 옷 조각을 작전 담당관에게 전달
和作戰負責人交談	Talk to the Operations Officer	작전 담당관과 대화
調查上面的地區	Investigate the upper area	위쪽 지역을 조사
向作戰負責人報告	Report to the Operations Officer	작전 담당관에게 보고
消滅布貝鬥士的部下	Defeat Vubbe Fighter's subordinates	부베 투사의 부하들 처치
和東邊森林補給兵交談	Talk to the Supply Soldier in the Eastern Woods	동쪽 숲 보급병과 대화
收集韋伯的腳趾甲	Collect Weaver Claws	위버의 발톱 수집
將韋伯的腳趾甲交給補給兵	Give the Weaver Claws to the Supply Soldier	보급병에게 위버의 발톱 전달
消滅波庫布	Defeat Pokubus	포쿠부를 처치
和補給兵交談	Talk to the Supply Soldier	보급병과 대화
消滅波庫布	Defeat Pokubus	포쿠부 처치
去尋找搜查兵	Find the Search Scout	수색병을 찾아 가기
搜索布貝鬥士	Search for the Vubbe Fighter	부베 투사 수색
告訴搜查兵已經擊退布貝鬥士了	Notify the Search Scout that the Vubbe Fighter has been defeated	수색병에게 부베 투사 퇴치를 알림
消滅布貝鬥士	Defeat the Red Vubbe Fighter	부베 투사 처치
回去向騎士阿拉斯報告	Return to Knight Aras	기사 아라스에게 돌아가 보고
和騎士阿拉斯進行有關礦山村莊的對話	Talk to Knight Aras about the Miners' Village	기사 아라스와 광산 마을에 대해 대화
消滅追趕難民的怪物	Defeat the monsters that are chasing the refugees	피난민을 뒤쫓는 몬스터 처치
和拜杜塔斯交談	Talk to Vaidotas	바이도타스와 대화
搜索村民	Search for the villagers	마을 주민 수색
和礦夫交談	Talk to the Miner	광부와 대화
消滅突然湧入的水晶蜘蛛	Defeat the Crystal Spiders that suddenly appeared	갑자기 몰려든 수정거미 처치
消滅尼多普巴伊	Defeat Netherbovine	네더보바인 처치
確認可疑的封印	Examine the suspicious seal	수상해 보이는 봉인 확인
消滅魔族米爾堤斯	Defeat Demon Mirtis	마족 미르티스 처치
消滅米爾堤斯	Defeat Mirtis	미르티스 처치
和石匠皮波堤交談	Talk to Stonemason Pipoti	석공 피포티와 대화
尋找皮波堤的同伴	Find Pipoti's colleague	피포티의 동료 찾기
消滅襲擊的怪物	Defeat the attacking monsters	습격한 몬스터 처치
移動到皮波堤地圖上標示的地方	Move to the area marked on Stonemason Pipoti's map	피포티의 지도에 표시된 곳으로 이동
避開怪物的妨礙，並且確認寶箱	Defeat the monsters and check the treasure chest	몬스터 방해를 피해 보물상자 확인
消滅約納喬雷	Defeat Yonazolem	요나졸렘 처치
移動到石匠皮波堤給的地圖上標示的地方	Move to the marked area on Stonemason Pipoti's map	석공 피포티가 준 지도에 표시된 곳으로 이동
避開怪物的妨礙，並且確認寶箱	Defeat the monsters and check the treasure chest	몬스터의 방해를 피해 보물상자 확인
消滅造成妨礙的霍克瑪	Defeat the interfering Hogmas	방해하는 호그마들 처치
和探險家巴奇斯交談	Talk to Adventurer Varkis	탐험가 바키스와 대화
從巴奇斯遺失的背包中回收日誌	Retrieve the Research Materials from Varkis' lost bag	바키스가 잃어버린 가방에서 일지 회수
拯救被襲擊的巴奇斯	Rescue Varkis who is under attack	습격받은 바키스 구출
確認探險家巴奇斯的狀態	Check on Adventurer Varkis	탐험가 바키스의 상태 확인
消滅利托雷克斯	Defeat Lithorex	리토렉스 처치
前往巴奇斯的營地	Go to Camp of Varkis	바키스의 캠프로 이동
在迪基內岔路收集巴奇斯的資料	Collect Varkis' Research Materials at Dykyne Fork	디키네 갈림길에서 바키스의 자료 수집
在蛇之頸絕壁收集巴奇斯的資料	Collect Varkis' Research Materials at Neck Cliff of Snake	뱀의 목 절벽에서 바키스의 자료를 수집
消滅邪惡寶箱怪	Defeat Unknocker	언낙커 처치
在阿帕堤懸崖附近尋找巴奇斯的資料	Look for Varkis' Research Materials near Apatinis Cliff	아파티 벼랑 근처에서 바키스의 자료를 찾기
消滅發動襲擊的怪物	Defeat the monsters	습격해온 몬스터 처치
和探險家巴奇斯的靈魂交談	Talk to Adventurer Varkis' Spirit	탐험가 바키스의 영혼과 대화
消滅發動襲擊的霍克瑪	Defeat Hogma	습격해온 호그마 처치
在碑石路的紀念碑材料中採取岩石	Collect stones from Stele Road	비석로에서 추모비 재료 중 바위 채취
去找柯拉佩達鐵匠	Meet the Blacksmith of Klaipeda	클라페다 대장장이 만나기
向柯拉佩達鐵匠購買石匠用工具	Buy stonemason tools from the blacksmith in Klaipeda 	클라페다 대장장이에게서 석공용 도구 구입
轉交給石匠皮波堤	Give it to Stonemason Pipoti	석공 피포티에게 전달
和莫勒庫斯‧尤那斯交談	Talk to Morkus Jonas	모르쿠스 요나스와 대화
和莫勒庫斯交談	Talk to Morkus	모르쿠스와 대화
把書交給鎖鏈法師次級大師	Give the book to the Linker Submaster	링커 서브 마스터에게 책 전달
向重裝步兵次級大師報告結果	Report the results to the Hoplite Submaster	하플라이트 서브 마스터에게 결과 보고
把精髓交給念力法師次級大師	Deliver the essence to the Psychokino Submaster	사이코키노 서브 마스터에게 정수 전달
收集用來寫符咒的怪物血液	Gather monster blood to be used when crafting charms	부적에 쓰일 몬스터의 혈액 모으기
將怪物血液轉交給邪靈祭司大師	Deliver the monster's blood to the Bokor Master	몬스터의 혈액을 보코르 마스터에게 전달
與鎖鏈法師次級大師對練	Duel the Linker Submaster	링커 서브 마스터와 대련
與巫蠱師次級大師對話	Talk to the Wugushi Submaster	무고사 서브 마스터와 대화
與巫蠱師次級大師對練	Duel the Wugushi Submaster	무고사 서브 마스터와 대련
與圓盾劍士次級大師對話	Talk to the Rodelero Submaster	로델레로 서브 마스터와 대화
向圓盾劍士次級大師報告	Report to the Rodelero Submaster	로델레로 서브 마스터에게 보고
與元素使次級大師對話	Talk to the Elementalist Submaster	엘리멘탈리스트 서브 마스터와 대화
執行元素使次級大師的課題	Complete the Elementalist Submaster's task	엘리멘탈리스트 서브 마스터의 과제 수행
把課題交給元素使次級大師	Relay the task to the Elementalist Submaster	엘리멘탈리스트 서브 마스터에게 과제 전달
與鐵甲騎兵次級大師對話	Talk to the Cataphract Submaster	캐터프랙트 서브 마스터와 대화
向鐵甲騎兵次級大師報告	Report to the Cataphract Submaster	캐터프랙트 서브 마스터에게 보고
消滅史潘飛行獸人	Defeat Sparnasman	스파나스맨 처치
回收亂落四處的補給品箱	Retrieve the supply boxes	흩어진 보급품 상자 회수
將補給品箱交給補給負責官	Give the supply boxes to the Supply Officer	보급 담당관에게 보급품 상자 전달
確認封鎖區域的結界石	Check the Crystal Pillar in the Closed Area	폐쇄된 구역의 결계석 확인
收集布貝魔石	Collect Vubbe Magic Stones	부베 마석 수집
使用位於封鎖地區的結界石裡的布貝魔石	Insert Vubbe Magic Stones into the Crystal Wall	폐쇄된 구역의 결계석에 부베 마석 사용
布貝	Vubbe	부베
和聯絡官尼爾斯交談	Talk to Liaison Officer Niels	연락관 닐스와 대화
尋找記錄官尤那斯	Find Archivist Jonas	기록관 요나스를 찾기
和記錄官尤那斯交談	Talk to Archivist Jonas	기록관 요나스와 대화
點燃烽火	Light the signal fire	봉화 올리기
回去找調查團營地的聯絡官尼爾斯	Return to Liaison Officer Niels at the Excavation Camp	조사단 캠프의 연락관 닐스에게 돌아가기
尋找傭兵米勒塔	Find Mercenary Mirta	용병 미르타 찾기
和史學家菲歐德交談	Talk to Historian Viode	사학자 비어드와 대화
消滅襲擊營地的怪物	Defeat the monsters attacking the camp	캠프를 습격하는 몬스터 처치
消滅對史學家造成威脅的怪物	Defeat the monsters that threaten the historian	사학자를 위협하는 몬스터 처치
和史學家凱佩克交談	Talk to Historian Kepeck	사학자 케펙과 대화
凱佩克發現的遺物記錄	Record the artifact that Kepeck discovered	케펙이 발견한 유물 기록
消滅奇葛拉斯	Defeat Ginklas	긴클라스 처치
和考古學家戴志克交談	Talk to Archaeologist Dezic	고고학자 데지크와 대화
幫忙考古學家戴志克消滅周圍的怪物	Defeat the nearby monsters for Archaeologist Dezic	고고학자 데지크를 위해 주변 몬스터를 처치
請和技術員哈伊奈恩交談	Talk to Technician Heinen	기술자 하이넨과 대화하세요
消滅纜車周圍的怪物	Defeat the monsters around the cable car	케이블카 주변 몬스터들을 처치
和技術員哈伊奈恩交談	Talk to Technician Heinen	기술자 하이넨과 대화
消滅威脅纜車的怪物	Defeat the monsters threatening the cable car	케이블카를 위협하는 몬스터 처치
破壞努歐圖里絕壁西邊的結界	Destroy the West Region Barrier at Nutoles Cliff	누오토리 절벽의 서쪽 결계를 파괴
破壞西邊的結界	Destroy the West Region Barrier	서쪽 결계 파괴
請和助手艾伊里奈交談	Talk to Assistant Airine	조수 아이리네와 대화하세요
和助手艾伊里奈交談	Talk to Airine	조수 아이리네와 대화
解除束縛艾伊里奈的結界裝置	Remove the barriers from Airine	아이리네를 속박하는 결계장치 해제
和傭兵葛雷恩交談	Talk to Mercenary Glen	용병 글렌과 대화
尋找薩厄加口袋裡的失蹤線索	Search for a clue of the disappearances from Sauga's bags 	사우가의 주머니에서 실종의 단서 찾기
保護艾伊里奈不受怪物傷害	Protect Airine from the monsters	몬스터들로 부터 아이리네를 지키기
回去找戴志克	Report back to Dezic	데지크에게 돌아가 보기
消滅巨魔蠍	Defeat Scorpio	스콜피오 처치
和新王陵研究員交談	Talk to the New Researcher in the Royal Mausoleum	신입 왕릉 연구원과 대화
回去找新王陵研究員	Return to the New Researcher	신입 왕릉 연구원에게 돌아가기
尋找遺失的研究報告書	Look for the old research reports	잃어버린 연구 보고서 찾기
消滅賈沛圖獲得王陵研究報告書	Obtain the research report by defeating Geppetto	제페토를 처치하여 왕릉연구보고서 획득
被撕破的研究記錄	Torn Research Record	찢어진 연구 기록
 收集	 Records	 수집
消滅吞吐斯獲得被撕破的研究記錄	Obtain Ripped research Records by defeating Tontus	톤투스를 처치하여 찢어진 연구 기록 획득
和尼爾斯交談	Talk to Niels	닐스와 대화
和商人達比歐交談	Talk to Merchant Davio	상인 다비오와 대화
哥拉斯的擔憂	Gorath's Concern	고라쓰의 걱정
和哥拉斯交談	Talk to Gorath	고라쓰와 대화
擊退莫雷克	Defeat Molich	몰렉 퇴치
消滅莫雷克	Defeat Molich	몰렉 처치
和藥材商交談	Talk to the Medicine Dealer	약재상과 대화
收集峽谷梅圖斯	Collect Canyon Metos	협곡 메토스 수집
為了完成藥，請回去找商人團的達比歐。	Return to Davio to complete the medicine	약의 완성을 위해 상인단의 다비오에게 돌아가세요.
和傭兵米勒塔交談	Talk to Mercenary Mirta	용병 미르타와 대화
去尋找耶畢扎丘陵的史學家凱佩克	Find Historian Kepeck at Apvija Hill	앱비자 언덕의 사학자 케펙 찾기
和礦山的拜杜塔斯交談	Talk to Vaidotas in the Mine	광산의 바이도타스와 대화
修理第1層的淨化裝置	Repair the Purifiers on 1F	1층의 정화 장치를 수리
確認第1層入口的淨化裝置	Inspect the Entrance Purifier on the 1st Floor	1층 입구 정화장치 확인
回收淨化裝置零件	Retrieve Purifier Parts	정화장치 부품 회수
修理第1層入口的淨化裝置	Repair the Entrance Purifier on 1F	1층 입구 정화장치 수리
修理第2層的淨化裝置	Repair the Purifiers on 2F	2층의 정화 장치를 수리
請修理第2層的所有淨化裝置。	Repair all the Purifiers on 2F	2층의 정화 장치를 모두 수리하세요.
確認中央淨化裝置	Inspect the Central Purifier	중앙 정화장치 확인
使用礦山羅盤	Use the Mine Compass	광산 나침반을 사용
搜索第4區域預備淨化裝置	Search District 4 for the Spare Purifier	4구역 예비 정화장치 수색
請從預備淨化裝置中取得替換用的零件。	Get the replacement parts from the Spare Purifier	예비 정화장치에서 교체용 부품을 획득하세요.
消滅水晶礦山獨眼巨人	Defeat Cyclops in the Crystal Mine	수정광산 사이클롭스 처치
消滅獨眼巨人	Defeat Cyclops	사이클롭스 처치
確認第1層通道的淨化裝置	Inspect the Passage Purifier on 1F	1층 통로 정화장치 확인
在第6區搜索淨化裝置零件	Search District 6 for Purifier Parts	6구역에서 정화장치 부품 수색
修理第1層通道的淨化裝置	Repair the Passage Purifier on 1F	1층 통로 정화장치 수리
檢查循環淨化裝置	Inspect the Circulation Purifier	순환 정화장치 점검
修理淨化管	Repair the Purifier Pipe	정화관 수리
確認循環淨化裝置 	Inspect the Circulation Purifier	순환 정화장치 확인
確認第2區淨化管	Inspect the Purifier Pipe in District 2	2구역 정화관 확인
消滅蓋洛貝斯寄居蟹	Defeat Carapace	캐러페이스 처치
啟動循環淨化裝置	Activate the Circulation Purifier	순환 정화장치 가동
確認第2層的輔助淨化裝置	Inspect the Auxiliary Purifier on 2F	2층 보조 정화장치 확인
使用礦山羅盤	Use the Mine Compass	광산 나침반 사용
確認魔力供給裝置	Inspect the Magic Supply Device	마력 공급장치 확인
搜索消除生鏽的工具	Search for tools to remove rust	녹을 제거할 도구 수색
恢復第4區的魔力供給裝置	Restore the Magic Supply Device in District 4	4구역의 마력 공급장치 복구
啟動第2層輔助淨化裝置	Activate the Auxiliary Purifier on 2F	2층 보조 정화장치 가동
確認主淨化裝置的狀態	Check the Main Purifier	주 정화장치 상태 확인
使用礦山羅盤掌握遺失零件的位置。	Use the Mine Compass to locate the missing parts of the purifier	광산 나침반을 사용하여 잃어버린 부품의 위치를 파악하세요.
前往第6區搜索零件	Search District 6 for parts	6구역으로 부품 수색
回到主淨化裝置進行修理。	Fix the Main Purifier	주 정화장치로 돌아가 수리
消滅石鯨怪	Defeat Stone Whale	석화고래 처치
和亞希拉斯尤那斯交談	Talk to Ahylas Jonas	아힐라스 요나스와 대화
和庫斯塔斯的學生交談，並且解除封印裝置	Talk to the Disciple of Gustas to learn how to release the seal	구스타스의 제자와 대화 하고 봉인 장치를 해제
和庫斯塔斯的學生交談	Talk to the Disciple of Gustas	구스타스의 제자와 대화
解除封印裝置	Unleash the seal device	봉인 장치를 해제
和庫斯塔斯尤那斯交談	Talk to Gustas Jonas	구스타스 요나스와 대화
和傭兵圖都宇交談	Talk to Mercenary Toby	용병 토도우와 대화
獲得實力評價	Prove your skills	실력 평가 받기
收集盜墓裝備	Find and collect the equipment for graverobbing	도굴 장비 수집
和考古學家勞迪交談	Talk to Archaeologist Laudi	고고학자 라우디와 대화
消滅巨眼丹提獲得遺址碎片	Obtain the Relic Fragment by defeating Denoptic	덴옵틱을 처치하여 유적 파편 획득
將遺址碎片交給考古學家勞迪	Give the Relic Fragment to Archaeologist Laudi	고고학자 라우디에게 유적 파편 전달
消滅巨眼丹提	Defeat Denoptic	덴옵틱 처치
前往考古學家勞迪要進行研究的區域消滅怪物	Defeat the monsters that abide near the place where Archaeologist Laudi will do his research	고고학자 라우디가 연구할 지역에 있는 몬스터 처치
消滅奧德卡丘陵路附近的怪物	Defeat the monsters near Odega Uphill	오데가 언덕길 근처의 몬스처 처치
收集古老的遺物	Collect the old inheritance	오래된 유물 수집
消滅突然出現的怪物	Defeat the monsters that suddenly appeared	갑자기 나타난 몬스터 처치
再次調查石柱	Examine the pillar again	다시 돌기둥 조사
消滅湧入的怪物	Defeat the monsters	몰려든 몬스터 처치
消滅虛那印	Defeat Shnayim	쉬나임 처치
和隊長皮歐交談	Talk to Vio	대장 비오와 대화
尋找傭兵利特	Find Mercenary Lindt	용병 린트 찾기
和傭兵利特交談	Talk to Mercenary Lindt	용병 린트와 대화
奪回被溫迪戈偷走的補給品	Retrieve the supplies which Wendigo stole	웬디고가 훔쳐간 보급품 되찾기
將補給品交給傭兵利特	Give the supplies to Lindt	용병 린트에게 보급품 전달
從溫迪戈那獲得補充物資	Obtain the supplies from Wendigo	웬디고들에게서 보급품 획득
採取峽谷歐彼尼斯	Collect Canyon Apynys	협곡 아피니스 채취
和傭兵埃塔交談	Talk to Mercenary Eta	용병 에타와 대화
尋找毒	Obtain the poison	독 구하기
獲得怪物毒	Obtained the poison of the monsters	몬스터의 독 획득
在阿爾庫內階梯路放置靈氣流動的石頭	Put the Spiritual Stones at Alkune Stairway	알쿠네 계단길에 영기가 흐르는 돌을 놓아 두기
消滅薩厄加	Defeat Sauga	사우가 처치
從阿爾庫內階梯路右邊引誘薩厄加斯	Lure the Saugas from the right side of Alkune Stairway	알쿠네 계단길의 오른쪽에서 사우가스 유인
消滅發動襲擊的怪物	Defeat the monsters that are rushing in	습격해오는 몬스터 처치
和補給隊隊長皮歐交談	Talk to Vio	보급대 대장 비오와 대화
解除聖所內的封印	Release the seal inside the sanctum	성소 안에 있는 봉인 해제
抵達礦山村莊	Arrive at the Miners' Village	광산 마을 도착
和礦山村莊村長交談	Talk to the Miners' Village Mayor	광산 마을 촌장과 대화
和獵人交談	Talk to the Hunter	사냥꾼과 대화
和礦山所長布林肯交談	Talk to Mine Manager Brinker	광산 소장 브링커와 대화
從周圍的石堆中收集補強用材料	Collect Reinforcement Stones from the rubbles nearby	주변의 돌무더기에서 보강용 자재 수집
將材料交給礦山所長布林肯	Give the Reinforcement Stones to Brinker	광산 소장 브링커에게 자재 전달
消滅周圍造成威脅的怪物	Defeat the monsters nearby	주변의 위협적인 몬스터 제거
告知礦山所長布林肯已經安全了	Tell Brinker that it is safe	광산 소장 브링커에게 안전함을 알리기
和治療師小姐交談	Talk to the Healer Lady	치유사 아가씨와 대화
帶難民過來	Bring the refugees	피난민 데리고 오기
將難民移交給治療師小姐	Turn over the refugees to the Healer Lady	치유사 아가씨에게 피난민 인계 하기
消滅具威脅性的怪物	Defeat the monsters	위협적인 몬스터 처치
消滅佔領村子的布貝	Defeat the Vubbes who invaded the village	마을을 점령한 부베 처치
消滅布貝	Defeat the Vubbes	부베 처치
消滅布貝	Defeat the Vubbes	부베들 처치
消滅突然出現的赤紅布貝鬥士	Defeat the Red Vubbe Fighter that suddenly appeared	갑자기 나타난 붉은 부베 투사 처치
消滅因為炸藥聲而湧入的布貝	Defeat any Vubbe that assembles after hearing the explosives	폭약 소리를 듣고 몰려드는 부베 처치
和水晶礦山第 1層樓的拜杜塔斯交談	Talk to Vaidotas in Crystal Mine 1F	수정광산 1층의 바이도타스와 대화
救出被束縛的靈魂	Rescue the restrained souls	묶여있는 영혼 구출
確認王陵碑文	Check the epitaph of the Royal Mausoleum	왕릉 비문을 확인
在王陵魔方附近制伏普巫葛後將之吸收	Defeat Boowooks near a Royal Cube to absorb	부우크를 왕릉 큐브 근처에서 제압하여 흡수
閱讀王陵碑文	Read the epitaph	왕릉 비문 읽기
破壞被汙染的守護裝置	Destroy the corrupted defense mechanism	더럽혀진 수호 장치 파괴
破壞被汙染的守護裝置	Destroy the corrupted defense mechanism	더럽혀진 수호장치 파괴
確認王陵碑文	Check the epitaph of the Royal Mausoleum	왕릉 비문 확인
向守護者取得動力源，對奉獻箱進行奉獻	Get the power source from the Guardians and dedicate it to the containers	수호자에게서 동력원을 얻어 봉헌함에 봉헌
消滅守護者艾哈特	Defeat Achat	수호자 에하트 처치
守護者艾哈特	Guardian Achat	수호자 에하트
答應治療師小姐的委託	Listen to the Healer Lady's request	치유사 아가씨의 부탁 들어주기
消滅切波勒	Defeat Chafer	체이퍼 처치
將結果告訴治療師小姐吧	Inform the results to the Healer Lady	치유사 아가씨에게 결과 알려주기
消滅擋路的切波勒	Defeat Chafer that is blocking the way	길을 막은 체이퍼 처치
和守護者的石像交談	Talk to the Guardian Stone Statue	수호자의 석상과 대화
消滅被汙染的守護者	Defeat the corrupted Guardian	오염된 수호자 처치
消滅被汙染的畢卡拉斯博學者	Defeat Corrupt Vikaras Mage	오염된 비카라스 메이지 처치
收集濃縮的魔力源	Collect Condensed Magic Source	응축된 마력원 수집
請對受到汙染而沉睡的守護者使用濃縮的魔力源。	Use the Condensed Magic Source on sleeping Guardians	오염된 채로 잠들어 있는 수호자에게 응축된 마력원 사용
和寶物獵人艾當交談	Talk to Treasure Hunter Eden	보물사냥꾼 에당과 대화
和金石學者雷蒙德交談	Talk to Epigraphist Raymond	금석학자 레이몬드와 대화
和艾洛堤柱列廣場的金石學者史密德交談	Talk to Epigraphist Schmid at Irody Square	아이로디 주열 광장의 금석학자 스미드와 대화
消滅汙染的元凶巨眼丹提 	Destroy Denoptic who is the source of the corruption	오염의 원흉인 덴옵틱 처치
瀏覽王陵設計圖	Read the design plan of the Royal Mausoleum	왕릉 설계도 읽기
尋找正在逐漸崩潰的位置	Find the guardians that are trying to cause the collapse	붕괴가 진행되는 위치 찾기
消滅企圖破壞王陵的守護者	Defeat the Guardians that are trying to destroy the Royal Mausoleum	왕릉을 파괴하려는 수호자 처치
阻止守護者的石像被破壞	Prevent the Guardians from destroying the Stone Statue	수호자의 석상 파괴 저지
瀏覽王陵的碑石	Read the epitaph of the Royal Mausoleum	왕릉의 비석 읽기
阻止企圖破壞王陵的守護者	Prevent the Guardians from destroying the Royal Mausoleum	왕릉을 파괴하려는 수호자 저지
消滅貝亞卡拉斯，阻止王陵崩潰	Prevent the collapse of the Royal Mausoleum by defeating Bearkaras	베아카라스를 처치하여 왕릉 붕괴 저지
消滅貝亞卡拉斯	Defeat Bearkaras	베아카라스 처치
和秘密的守護者交談	Talk to the Secret Guardian	비밀의 수호자와 대화
收集王陵魔力的源泉	Collect the Royal Mausoleum's Magic Sources	왕릉 마력의 원천 수집
取得靈魂之甕	Obtain the Soul Pot	영혼 항아리 입수
將王陵魔力的源泉倒入王陵的甕中	Pour the magic sources into the jars	왕릉의 항아리에 왕릉 마력의 원천을 붓기
設置完整的魔力甕	Place the Soul Pot	완전한 마력 항아리 설치
將甕交給秘密的守護者	Give the pot to the Secret Guardian	비밀의 수호자에게 항아리 전달
擊退雷克西波	Defeat Rexipher	렉시퍼 퇴치
移動到王的墓室	Go to the burial chamber of the Royal Mausoleum	왕의 묘실로 이동
聽取札卡里耶爾王的讒言	Listen to the advice of Zachariel	자카리엘의 참언 듣기
向王陵守護者取得燃燒之石	Obtain the Burning Stone from the Guardians of the Royal Mausoleum	왕릉 수호자에게서 불타는 돌 획득
利用燃燒之石點燃王陵石燈	Light up the stone lantern with the Burning Stone	불타는 돌로 왕릉 석등 밝히기
獲得石燈動力	Obtained the power supply of the stone lantern	석등 동력 획득
阻止魔族破壞王陵石燈	Protect the stone lantern of the Royal Mausoleum from the demons	마족에게서 왕릉 석등을 보호
消滅女妖克萊默	Defeat Clymen	클라이멘 처치
收集破壞王陵抑制器的活性石	Collect the activation stones to break the Regulator of the Royal Mausoleum	왕릉 억제기 파괴를 위한 활성석 수집
再次瀏覽王陵抑制器說明書	Read the manual of the Regulator of the Royal Mausoleum	왕릉 억제기 설명서 다시 읽기
收集活性石	Collect the activation stones	활성석 수집
再次瀏覽王陵抑制器說明書	Read the manual for the Regulator again	왕릉 억제기 설명서를 다시 읽기
破壞王陵抑制器	Destroy the Regulator of the Royal Mausoleum	왕릉 억제기 파괴
破壞抑制器	Destroy the Regulator	억제기 파괴
瀏覽祕密場所說明書	Read the Secret Location Manual	비밀장소 설명서 읽기
獲得守護者的氣息	Obtained the Guardian Energy	수호자의 기운 획득
往祕密場所移動	Move to the secret location	비밀장소로 이동
消滅墓主洛德	Defeat Tomb Lord	툼로드를 처치
尋找王室秘寶	Find the secret treasure of the Royal Family	왕실 비보를 찾기
消滅墓主洛德	Defeat Tomb Lord	툼로드 처치
收集燃燒的魔力源	Collect the Blazing Magic Sources	타오르는 마력원 수집
點燃與保護王陵石燈	Light up the stone lantern and protect it	왕릉 석등 점화 및 보호
處理魔力容器周圍的守護者	Defeat the Guardians near the Magic Vessels	마력 용기 주변 수호자 처리
清除被汙染的疙瘩	Remove the corrupted cores	오염된 응어리 제거
破壞被汙染的石燈	Destroy the corrupted Stone Lantern	오염된 석등을 파괴
破壞被汙染的石燈	Destroy the corrupted Stone Lantern	오염된 석등 파괴
破壞被汙染的王陵魔力控制器	Destroy the Corrupt Royal Mausoleum Magic Control Device	오염된 왕릉 마력 제어기 파괴
消滅亞崑	Defeat Archon	아콘 처치
確認王陵記錄書	Examine the Royal Mausoleum Archives	왕릉 기록서 확인
收集霍倫的信物	Collect Wheelen Marks	휠렌의 증표 수집
瀏覽王陵記錄書	Read the Royal Mausoleum Archive	왕릉 기록서 읽기
消滅敵對的貝奴凱洛斯	Destroy the hostile Venucelos	적대적인 베누켈로스 처치
消滅敵對的貝奴凱洛斯	Defeat Venucelos	적대적인 베누켈로스 처치하기
消滅遠古石龜獸取得秘寶	Obtain the secret treasure after defeating Rocktortuga	락토르투가를 처치하고 비보 얻기
消滅遠古石龜獸	Defeat Rocktortuga	락토르투가 처치
和追隨者多納塔史交談	Talk to Follower Donatas	추종자 도나타스와 대화
收集魔族們的靈魂	Collect demon souls	마족들의 영혼 수집
和庫班交談	Talk to Coben	코벤과 대화
尋找庫班想要的日誌	Find the diary Coben is looking for	코벤이 원하는 일지 찾기
將日誌交給庫班	Hand the diary over to Coben	코벤에게 일지 전달
確認崩塌公所的碑石內容	Check the monument at the Crumbled Chapel	무너진 공소의 비석 내용 확인
將內容轉告庫班	Tell Coben what was written on the monument	코벤에게 내용 전달
確認第二個碑石內容	Check the writings on the second monument	두 번째 비석 내용 확인
將碑石內容告訴庫班	Tell Coben what was written on the monument	코벤에게 비석 내용 전달
確認第三個碑石內容	Check what is written on the third monument	세 번째 비석 내용 확인
確認第四個碑石內容	Check what is written on the fourth monument	네 번째 비석 내용 확인
補充強力的魔力吸收裝置	Recharge the Strong Magical Power Absorption Jar	강력한 마력흡수 장치 충전
確認教訓的碑石內容	Check the writings on the Commanding Monument	교훈의 비석 내용 확인
消滅惡魔葛洛夫	Defeat Devilglove	데블글로브 처치
與石匠凱諾林對話	Talk to Stonemason Canolyn	석공 캐놀린과 대화
消滅柯卡特里斯	Defeat Cockatrice	코카트리스 처치
向石匠凱諾林報告	Report back to Stonemason Canolyn	석공 캐놀린에게 보고
消滅莫厄	Defeat Moa	모아 처치
和塔拉瑪爾茲交談	Talk to Tara Miles	타라 마일즈와 대화
消滅周圍的怪物	Defeat the monsters nearby	주변의 몬스터 처치
從幽靈范托身上取得灰塵樣本	Collect dust samples from Hallowventers	할로우벤터에게서 먼지 샘플 수집
將灰塵樣本交給塔拉瑪爾茲	Hand over the dust samples to Tara Miles	타라 마일즈에게 먼지 샘플 전달
收集灰塵樣本	Collect Dust Samples	먼지 샘플 수집
收集柯卡特的尾巴	Collecting Cockat Tails	코카트의 꼬리 수집
把柯卡特的尾巴轉交給塔拉瑪伊茲	Hand the Cockat tail to Tara Miles	타라 마일즈에게 코카트의 꼬리 전달
獲得柯卡特的尾巴	Obtain Cockat tails	코카트의 꼬리 획득
使用紅焰寶石	Use the Jewel of Prominence	홍염의 보석 사용
和加比婭女神交談	Talk to Goddess Gabija	가비야 여신과 대화
和追隨者巴伊杜堤斯交談	Talk to Follower Vaidutis	추종자 바이두티스와 대화
收集力量結晶	Collect the Power Crystals	힘의 결정 수집
開啟聖堂正門	Open the church entrance	성당 정문 열기
消滅乃伊賈西特	Defeat Mummyghast	머미가스트 처치
消滅朋德爾和朋德	Defeat Pawndel and Pawnd	폰델과 폰드 처치
消滅朋德爾	Defeat Pawndel	폰델 처치
消滅朋德	Defeat Pawnd	폰드 처치
追隨者多納塔史需要你的幫忙	Follower Donatas is seeking for your help	추종자 도나타스가 당신의 도움을 필요로 하고 있습니다.
收集朋德爾和朋德的衣角	Collect the clothes of Pawndel and Pawnd	폰델과 폰드의 옷자락 수집
消滅魔族怪物	Defeat demons	마족 몬스터 처치
將朋德爾和朋德引誘到阿薩厄加祭壇	Lure Pawndel and Pawnd to the Apsauga Altar	폰델과 폰드를 압사우가 제단으로 유인
在葛羅貝加斯祭壇讓魔族改變信仰	Convert demons at the Globejas Altar	글로베자스 제단에서 마족 개종
確認中央祭壇	Check the Central Altar	중앙 제단 확인
消滅瑪爾雷飛龍	Defeat Mallet Wyvern	말렛와이번 처치
和追隨者托瑪斯交談	Talk to Follower Tomas	추종자 토마스와 대화
消滅約諾溫	Defeat Yognome	요노움 처치
收集狂氣的瞳孔	Collect the Eyes of Madness	광기의 눈동자 수집
獲得狂氣的瞳孔	Obtain the Eyes of Madness	광기의 눈동자 획득
和追隨者堤貝里尤斯交談	Talk to Follower Tiberius	추종자 티베리유스와 대화
利用聖靈炸彈消滅葛利查頓	Defeat Glizardon using the Holy Bomb	성령 폭탄으로 글리자돈 처치
和追隨者帕伊達史交談	Talk to Follower Vaidas	추종자 바이다스와 대화
補充聖靈石	Charge the Holy Stone	성령석 충전
消滅葛利查頓	Defeat Glizardon	글리자돈 처치
解除傑斯堤的結界	Deactivate the barrier that Gesti created	제스티의 결계 해제
去見追隨者巴伊杜堤斯	Find Follower Vaidutis	추종자 바이두티스 찾기
請消滅獨眼巨人	Defeat Cyclops	사이클롭스를 처치하세요
和追隨者阿爾基斯交談	Talk to Follower Algis	추종자 알기스와 대화
前往鐘塔	Go to the Bell Tower	종탑으로 이동
目睹傑斯堤教訓部下的景象。	Saw Gesti scolding her subordinates	제스티가 부하들을 훈계하는 장면을 목격했습니다.
在中央大廳製作陷阱	Make a trap at Sventove Central Hall	중앙 홀에 함정 만들기
補充下級聖靈寶珠 	Charge the low level spirit crystal	하급 성령 구슬을 충전
消滅伊諾溫	Defeat Egnome	이노움 처치
和傑斯堤進行決戰	Fight with Gesti	제스티와의 결전
前往隱藏聖所尋找啟示	Find the revelation in the hidden sanctuary	숨겨진 성소에서 계시 찾기
和看守者艾倫交談	Talk to Watcher Allen	파수꾼 알렌과 대화
收集破壞的結界碎片	Collect Destroyed Barrier Piece	파괴된 결계의 조각 수집
和追隨者凱耶陀納斯交談	Talk to Follower Kayetonas	추종자 카예토나스와 대화
補充樹木哨所的結界	Charge the Tree Guard Post Barrier	나무 초소의 결계 충전
和看守者凱奈司交談	Talk to Watcher Kenneth	파수꾼 케네스와 대화
清除魔族召喚陣	Remove the Demon Summoning Circles	마족 소환진 제거
消滅已分離的魔族靈魂	Defeat severed demons' souls	분리된 마족의 영혼 처치
消滅凱奈司周圍的魔族怪物	Defeat the demon monsters nearby Kenneth	케네스 주변의 마족 몬스터 처치
聽追隨者阿爾基斯說明	Listen to Follower Algis' explanations	추종자 알기스에게 설명 듣기
聖殿十字軍大師正在找你。	The Paladin Master is looking for you	팔라딘 마스터가 당신을 찾고 있습니다.
啟動彼烈洛基山峰的結界	Help the Paladin Master	필랴로제 봉우리의 결계 작동
消滅王座大蜘蛛	Defeat Throneweaver	쓰론 위버 처치
消滅被汙染的王陵守護者	Defeat the corrupted Royal Mausoleum Guardians	오염된 왕릉 수호자 처치
消滅守護王陵的王陵守護者	Defeat the Royal Mausoleum Guardian	왕릉을 수호하는 왕릉 수호자 처치
瀏覽王陵碑石	Read the Royal Mausoleum gravestone	왕릉 비석 읽기
消滅被汙染的王陵守護者	Defeat the corrupted Royal Mausoleum Guardians	오염된 왕릉 수호자 처치하기
尋找隱藏的寶箱	Find the hidden treasure	숨겨진 보물 상자 찾기
消滅羅斯拉特	Defeat Rusrat	러스라트 처치
和羅藍塔斯尤那斯交談	Talk to Rolandas Jonas	롤란다스 요나스와 대화
在比耶尼沙高原尋找地圖	Search for the map at Vienisa Highland	비에니사 고원에서 지도 찾기
和羅藍塔斯交談	Talk to Rolandas	롤란다스와 대화
探索羅藍塔斯尤那斯告知的位置	Check the area Rolandas Jonas told you	롤란다스 요나스가 알려준 위치 탐색
探索羅藍塔斯告知的位置	Check the area Rolandas told you	롤란다스가 알려준 위치 탐색
在拉塔斯岔路尋找地圖	Find the map at Ratas Fork	라타스 갈림길에서 지도 찾기
在洛圖瑪第1遺址尋找地圖	Search for the map at Rodoma 1st Ruins	로도마 제1 유적지에서 지도 찾기
探索羅藍塔斯告知的位置	Search the area Rolandas told you	롤란다스가 알려준 위치를 탐색한다
在墳墓看守人的小木屋附近尋找地圖	Search for the map nearby Tomb Guard's Cabin	무덤지기의 오두막 근처에서 지도 찾기
在舊墳墓看守人的小木屋附近尋找地圖	Search for the map nearby Tomb Guard's Cabin	옛 무덤지기 오두막 근처에서 지도 찾기
墳墓看守人的小木屋尋找地圖	Search for the map at Tomb Guard's Cabin	무덤지기의 오두막에서 지도 찾기
為了考古學家戴志克取得解毒劑	Find an antidote for the archaeologist	고고학자 데지크를 위해 해독제 구하기
解除堤塔斯峽谷的所有封印裝置	Release all seals of Tiltas Valley	틸타스 협곡의 모든 봉인 장치 해제
前往札卡里耶爾交叉路的王陵入口	Enter the entrance to Royal Mausoleum in Zachariel Crossroads	자카리엘 교차로의 왕릉입구로 들어가기
前往王陵的祕密場所	Go to Royal Mausoleum's secret location	왕릉의 비밀장소로 이동
確認箱子	Examine the chest	상자 확인
消滅怪物	Defeat the monsters	몬스터 처치
消滅發動攻勢的怪物	Defeat the monsters	공격해 오는 몬스터 처치
和史學家雷克西波交談	Talk to Historian Rexipher	사학자 렉시퍼와 대화
瀏覽伊茲巴里托遺址的碑文	Read the epitaph of Isvalyta Historic Site	이즈발리타 유적지의 비문 읽기
瀏覽薛魯那斯高原的碑文	Read the epitaph at Serno Highland	쉬르나스 고원의 비문 읽기
消滅碑文周圍的怪物	Defeat the monsters near the epitaph	비문 주위에 나타난 몬스터 처치
尋找史學家雷克西波	Find Historian Rexipher	사학자 렉시퍼 찾아가기
瀏覽迪基內岔路左邊的碑文	Read the epitaph left of Dykyne Fork	디키네 갈림길 왼쪽에 있는 비문 읽기
消滅吉努特卡斯	Defeat Zinutekas	지누테카스 처치
瀏覽阿帕堤懸崖最後的碑文	Read the last epitaph at Apatinis Cliff	아파티 벼랑에 있는 마지막 비문 읽기
防禦王陵石燈	Protect the Royal Mausoleum Stone Lantern	왕릉 석등을 방어
前往王陵第3層樓追雷克西波	Follow Rexipher to Royal Mausoleum 3F	렉시퍼를 쫓아 왕릉 3층으로 가기
消滅被汙染的守護者	Defeat the corrupted Guardians	오염된 수호자를 처치
消滅無法辨識彼此的阿哈得	Defeat the Echad that can't identify friend or foe	피아식별을 못하는 에하드 처치
到王陵更深處進行探索	Search the deeper part of the Royal Mausoleum	왕릉 더 깊은 곳까지 탐색
消滅誤認為是敵人的虛那印	Defeat the Shnayim that thinks you are a foe	적으로 오인하는 쉬나임 처치
和維塞特交談	Talk to Vincent	빈센트와 대화
消滅追擊圖都宇的怪物	Defeat the monster chasing Toby	토도우를 쫓아 온 몬스터 처치
消滅圖都宇帶來的約納喬雷	Defeat Yonazolem that was chasing Toby	토도우가 끌고 온 요나 졸렘 처치
取得霍克瑪的牙齒	Get Hogma Teeth	호그마의 이빨 구하기
收集霍克瑪的牙齒	Collect Hogma Teeth	호그마의 이빨 수집
尋找史學家雷克西波的行蹤	Find out Historian Rexipher's whereabouts	사학자 렉시퍼의 행방을 찾기
再次詢問史學家希來尼亞‧歐德爾關於雷克西波的行蹤	Ask Historian Cyrenia Odell about Rexipher's whereabouts	사학자 시레니아 오델에게 렉시퍼의 행방 다시 묻기
追尋雷克西波的行蹤	Trace Rexipher's whereabouts	렉시퍼의 행방 쫓기
前往雷克西波所在的黑塞德祭壇	Go to the Chesed Altar where Rexipher is attacking	렉시퍼가 있었다던 헤세드 제단으로 가 본다
消滅霍克瑪	Defeat the Hogmas	호그마 처치
搜尋雷克西波的行蹤	Find Rexipher	렉시퍼의 행방 추적
和附近的史學家希來尼亞‧歐德爾交談	Talk to Historian Cyrenia Odell	근처에 있는 사학자 시레니아 오델과 대화
和史學家希來尼亞‧歐德爾交談	Talk to Historian Cyrenia Odell	사학자 시레니아 오델과 대화
消滅石像中出現的霍克瑪	Defeat the Hogmas shown as stone statues	석상에서 나타난 호그마들 처치
比雷克西波更早一步啟動比爾夏祭壇	Activate the Sviesa Altar before Rexipher does	렉시퍼보다 먼저 비에샤 제단 활성화
和希來尼亞‧歐德爾交談	Talk to Cyrenia Odell	시레니아 오델과 대화
啟用比爾夏祭壇	Activate the Sviesa Altar	비에샤 제단 활성화
去找希來尼亞‧歐德爾	Go to Cyrenia Odell	시레니아 오델에게로 이동
消滅發動襲擊的雷克西波的部下	Defeat Rexipher's Subordinates	습격해온 렉시퍼의 부하 처치
製作組合的探索棒	Create Crude Divining Rod	조잡한 탐사막대 제작
尋找第一個紀念碑碎片	Find the first fragment of the tombstone	첫 번째 추모비 조각 찾기
小樹枝	Stumpy Tree Branch	몽당 나뭇가지
尋找第一個碑石碎片	Find the first fragment of the tombstone	첫 번째 비석 조각 찾기
探索塞克魯斯橋下方第二個碑石碎片	Find the second fragment of the tombstone under Seklus Bridge	세크루스 다리 아래쪽에 두 번째 비석 조각 탐색
消滅艾哈特	Defeat Achat	에하트 처치
收集沾染灰塵的遺址碎片	Collect the Dusty Fragments	먼지묻은 유적 파편 수집
燃燒安佛露樹獲得炭化的破片	Burn Tree Ambuloes and get Carbonized Tombstone Fragment	트리암블로를 불태워 탄화된 파편 획득
收集炭化的遺址碎片	Collect Carbonized Tombstone Fragment	탄화된 유적 파편 수집
到夏奧雷伊礦山村莊收集赤紅凱帕的外皮	Collect Red Keppa Peels from the Miners' Village	샤울레이 광산 마을에서 붉은 케파의 껍질 수집
獲得赤紅凱帕的外皮	Obtain Red Kepa Peels	붉은 케파의 껍질 획득
消滅赤紅凱帕	Defeat Red Kepa	붉은 케파를 처치
消滅幽格普斯獲得幽格普斯的核	Defeat Jukopus to Obtain their Cores	유코푸스를 처치해 유코푸스의 핵 획득
獲得幽格普斯的核	Obtain Jukopus Cores	유코푸스의 핵 획득
和位於柯拉佩達的牧師大師交談	Go and talk to the Cleric Master in Klaipeda	클라페다에 있는 클레릭 마스터를 찾아가 대화한다
聽取關於特性的說明	Learn about Attributes	특성에 대해서 설명을 듣는다
熟悉特性後和牧師大師交談	Learn attributes and talk to the Cleric Master	특성을 익힌 후 클레릭 마스터와 대화한다
瀏覽王陵奠基石	Read the Royal Mausoleum Foundation Stone	왕릉 초석 읽기
喚醒沉睡的守護者普巫葛	Wake the sleeping Boowook	잠든 수호자 부우크 깨우기
尋找其他碑文	Find another epitaph	다른 비문 찾기
和看守者里凱交談	Talk to Watcher Rikke	파수꾼 리케와 대화
清除蜂窩	Remove the beehive	벌집 제거
和看守者艾拉交談	Talk to Watcher Erra	파수꾼 에라와 대화
消滅希德米亞	Defeat Seedmia	씨드미아 처치
獲得綠頭鴨的脂肪	Obtain Mallardu Fat	말라두의 지방 획득
收集綠頭鴨的脂肪	Collect Mallardu's fat	말라두의 지방 수집
從豬籠草身上採取蘊藏靈力的樹液	Extract Spiritually Enchanted Sap from Nepenthes	네펜더스에게 영력이 깃든 수액 채취
對潘圖進行洗腦	Brainwash the Pantos	판토 세뇌시키기
操控潘圖消滅巨大潘圖槍兵	Control the Pantos and defeat the Large Panto Spearmen	판토를 조종하여 대형 판토 창병 처치
和追隨者阿爾馮薩斯交談	Talk to Follower Alfonsas	추종자 알폰사스와 대화
惡搞魔族召喚陣	Write over the Demon Summoning Circles	마족 소환진 뒤집기
去找追隨者阿爾基斯	Find Follower Algis	추종자 알기스 찾아가기
追擊傑斯堤	Pursue Gesti	제스티 추격
追蹤雷克西波	Trace Rexipher	렉시퍼 추적
破壞塞希查走廊的王陵守護裝置	Destroy the Royal Mausoleum Guardian Device at Sesija Entrance 	세시자 도열주랑의 왕릉 수호장치 파괴
和雷克西波交談	Talk to Rexipher	렉시퍼와 대화
消滅塞希查走廊的王陵守護者	Defeat the Royal Mausoleum Guardian at Sesija Entrance	세시자 도열주랑의 왕릉 수호자 처치
消滅雷克西波召喚的仙人掌妖精	Defeat the Cactusvel summoned by Rexipher 	렉시퍼가 소환한 캑터스벨 처치
確認希來尼亞‧歐德爾的安全	Check Cyrenia Odell's safety	시레니아 오델의 안전을 확인
消滅雷克西波的召喚獸	Defeat Rexipher's summon	렉시퍼의 소환수 처치
去王陵入口追擊雷克西波	Pursue Rexipher at the Royal Mausoleum Entrance	왕릉 입구로 렉시퍼를 추격
消滅雷克西波的部分	Defeat Rexipher's servants	렉시퍼의 부하 처치
和金石學者史密德交談	Talk to Epigraphist Schmid	금석학자 스미드와 대화
修復露克立斯的紀念碑	Restore the monument of Ruklys	루클리스의 추모비 복원
修復露克立斯紀念碑，獲得露克立斯的遺產。	Restron Ruklys memorial stone and get Ruklys legacy	루클리스 추모비를 복원하고 루클리스의 유산을 획득하세요.
協助金石學者史密德	Help Epigraphist Schmid	금석학자 스미드 돕기
消滅火山龜獸	Defeat Magburk	매그버크 처치
開啟正門	Open the Gate	정문 열어주기
確認最後一個碑石	Check the last gravestone	마지막 비석 확인
和獵人塔洛斯交談	Talk to Hunter Talus	헌터 탈러스와 대화
製作變熱的箭頭	Make Fire Hardened arrowheads	달궈진 화살촉 제작
和邪靈術師特拉修斯交談	Talk to Necromancer Drasius	사령술사 드라슈스와 대화
消滅失控的地獄亡靈	Defeat the uncontrollable Necroventer	통제불능 네크로벤터 처치
消滅地獄亡靈	Defeat Necroventer	네크로밴터 처치
和徘徊的靈魂交談	Talk to the Wandering Spirit	배회하는 영혼과 대화
和少女交談	Talk to the girl	소녀와 대화
將哥哥的死訊轉告徘徊靈魂的妹妹。	Tell the Wandering Spirit's sister about her brother's death	배회하는 영혼의 여동생에게 오빠의 죽음을 알려주세요.
和技術員歐萊昂交談	Talk to Technician Orion	기술자 오라이온과 대화
設置陷阱後躲在樹木後方	Prepare the trap and hide behind a tree	함정 설치 후 나무 뒤에 숨기
躲起來觀察	Hide and watch	숨어서 지켜보기
藏在樹木後方	Hide behind a tree	나무 뒤로 숨기
消滅引誘出來的尖角皮德蟲	Defeat the lured Ravinepede	유인해낸 라바인피드를 처치
和技術員歐萊昂交談	Talk to Technician Orion	기술자 오라이언과 대화
消滅尖角皮德蟲	Defeat Ravinepede	라바인피드 처치
設置霍克瑪的護身符	Place Hogma's Amulet	호그마의 호신부 놓기
在葛圖那斯高原的石柱設置霍克瑪的護身符	Place the amulet of Hogma on the stone pillar in Geltonas Highland	겔토나스 고원의 돌기둥에 호그마의 호신부 놓기
在石柱設置護身符	Place the amulet on the stone pillar	돌기둥에 호신부 올려놓기
和考古學家普利特卡交談	Talk to Archaeologist Friedka	고고학자 프리드카와 대화
收集修理練習用木人所需要的材料	Gather materials for repairing the wooden seal	연습용 목인을 고치는데 필요한 재료 모으기
和看守者哈梅史交談	Talk to Watcher James	파수꾼 하메스와 대화
和哈梅史交談	Talk to James	하메스와 대화
消滅來自貓頭鷹之墓的怪物	Defeat the monsters in Owl Burial Ground	매너클 묘지에서 나오는 몬스터 처치
消滅野外BOSS死靈查普利SS	Defeat Field Boss Chapparition	필드 보스 체퍼리션 처치
泰內聖堂	Tenet Church	테넷 성당
消滅陰森的死靈查普利	Defeat spooky Chaparition	음산한 채퍼리션 처치
和冤魂交談	Talk to the resentful soul	억울한 영혼과 대화
和跑腿者交談	Talk to the messenger	심부름꾼과 대화
將信件交給佩迪米安的警備兵利波	Deliver the letter to Ripper in Fedimian	페디미안에 있는 경비병 리퍼에게 편지 전달
將食物交給傭兵利特	Share food with Lindt	용병 린트에게 음식 주기
和史學家寇林交談	Talk to Historian Colin	사학자 콜린과 대화
焚燒祭文	Burn the oration	제문 불태우기
向史學家寇林報告	Report to Colin	사학자 콜린에게 보고
修理練習用木人	Repair the wooden seal for practice	연습용 목인 수리하기
消滅夏奧雷伊礦山村莊的幽格普斯	Defeat Jukopus near the Miners' Village	샤울레이 광산 마을의 유코푸스 처치
和柯拉佩達的劍士交談	Go and talk to the Swordsman Master in Klaipeda	클라페다에 있는 소드맨을 찾아가 대화한다
聽關於特性的說明	Listen to the explanation about attributes	특성에 대해 듣는다
熟練特性後和劍士大師交談	Learn the attributes and talk to the Swordsman Master	특성을 익힌 후 소드맨 마스터와 대화한다
和法師大師交談	Talk to the Wizard Master	위저드 마스터와 대화하세요
和弓箭手大師交談	Talk to the Archer Master	아처 마스터와 대화하세요
和看守者吉爾伯特交談	Talk to Watcher Gilbert	파수꾼 길버트와 대화
消滅克魯莫和希德米亞	Defeat Grummers and Zignuts	그루머와 씨드미아 처치
消滅傑克諾茲	Defeat Zignuts	지그너츠 처치
消滅克魯莫	Defeat Grummer	그루머 처치
消滅潘圖回收齒輪	Defeat the Pantos and retrieve the gears	판토를 처치하고 톱니바퀴 회수
消滅潘圖	Defeat the Pantos	판토 처치
回收控制桿把手固定鎖	Find the lever handle latches	레버 손잡이 고정쇠 찾기
和看守者莫爾黎交談	Talk to Watcher Molly	파수꾼 몰리와 대화
試著將高原甜菜交給年幼的潘圖	Give sugar beets to Baby Pantos	새끼 판토에게 고원 사탕무 줘보기
和看守者梅透交談	Talk to Watcher Matthew	파수꾼 매튜와 대화
回收纜車零件	Retrieve Cable Car Parts	케이블카 부속 회수
擊退對纜車造成威脅的波亞塔	Defeat Poata who is a threat to the cable car	케이블카를 위협하는 포아타 퇴치
消滅波亞塔	Defeat Poata	포아타 처치
帶年幼的潘圖去找卡普里亞	Take the Baby Pantos and find Capria	새끼 판토들을 데리고 카프리아를 찾아가기
消滅卡普里亞	Defeat Capria	카프리아 처치
去找聖殿十字軍大師	Meet the Paladin Master	팔라딘 마스터 만나기
和看守者帕吉爾交談	Talk to Watcher Basil	파수꾼 바질과 대화
收集小綠頭鴨的種子	Collect Mali Seeds	말리의 씨앗 수집
和看守者默利交談	Talk to Watcher Molly	파수꾼 모리와 대화
利用咒術人偶破壞潘圖族圖騰	Destroy Panto Totems with Shaman Dolls	주술인형으로 판토족 토템 파괴
處治希默普	Defeat Simorph	시모프 처단
和破壞用咒術人偶一起消滅希默普	Defeat Simorph with the shaman dolls	파괴용 주술인형과 함께 시모프를 처치하세요
消滅巴里歐山莊嶺的希默普	Defeat Simorph at Valio Mountain Cabin Hill	발리오 산장고개의 시모프 처치
淨化魔族汙染地	Purify the demon corrupted land	마족 오염지 정화
消滅變狂暴的魔花卡諾波	Defeat Wild Carnivore	광폭해진 카너버 처치
請消滅受魔族汙染而變狂暴的魔花卡諾波.	Defeat Wild Carnivore tainted by demon corruption	마족 오염의 영향으로 광폭해진 카너버를 처치하세요
消滅帕修利瑪原野的變狂暴的魔花卡諾波	Defeat Wild Carnivore in Pasiulyma Field	파슐리마 벌판의 광폭해진 카너버 처치
收集儀式用繩子	Collect ritual rope	의식용 밧줄 수집
獲得儀式用繩子	Get rope for ritual	의식용 밧줄 획득
收集充滿靈力的鬃毛	Collect Mushcaria's Enchanted Mane	영력깃든 갈기 수집
獲得充滿靈力的鬃毛	Get Mushcaria's Enchanted Mane	영력 깃든 갈기 획득
和薩勒女神交談	Talk to Goddess Saule	사울레 여신과 대화
確認大神壇結界	Check the barrier at Saule Grand Shrine	대신단 결계 확인
消滅束縛女神的魔族	Defeat the demon restraining the goddess	여신을 구속하고 있는 마족 처치
和女神薩勒交談	Talk to Goddess Saule	여신 사울레와 대화
消滅夏勒琵雅	Defeat Harpeia	하르피아 처치
確認勃斯巴空地的束縛魔法陣	Check the binding magic circle in Vapsva Vacant Lot	밥스바 공터의 구속 마법진 확인
消滅摩吉	Defeat Merge	머지 처치
消滅大神壇附近的怪物	Defeat monsters nearby the Grand Shrine	대신단 근처의 몬스터 처치
解除魔族的結界	Release the Demon Barrier	마족의 결계 해제
解除薩勒女神的束縛球	Remove restraining sphere that is trapping Goddess Saule	사울레 여신의 구속구 해제
拜託薩勒女神解釋啟示	Ask Goddess Saule about the revelation	사울레 여신에게 계시 해석을 부탁하기
前往貝雅山谷一帶搜索傳點	Search the portal in Veja Ravine	베야 골짜기 일대에서 포탈 수색
收集提努的淨化石	Collect Purifying Stones from Tanu	타누의 정화석 수집
向村莊老人報告	Report to the Old Man	마을 노인에게 보고
和村莊老人交談	Talk to the Old Man	마을 노인과 대화
尋找老人派遣的村民	Find the villager sent by the Old Man	노인이 보냈다는 마을 주민 찾기
和負傷的村民交談	Talk to the Injured Villager	부상당한 마을 주민과 대화
消滅襲擊村民的怪物	Defeat the monsters that attacked the villager	마을 사람을 습격한 몬스터 처치
確認奴葛里亞聖所的祭壇	Check the altar at Nugria Sanctum	누그리아 성소의 제단 확인
確認奴葛里亞聖所的傳點	Check the Portal at Nugria Sanctum	누그리아 성소의 포탈 확인
消滅莫亞班羅喀	Defeat Moyabruka	모야브루카 처치
確認貝伊特瑪上坡路的汙染源	Check the source of corruption in Veidma Uphill	베이드마 오름길의 오염원 확인
確認神聖的池塘	Check out Holy Pond	신성한 연못 확인
消滅蒙雷幾那	Defeat Merregina	머레지나 처치
前往奴葛里亞聖所的祭壇	Go to the altar of Nugria Sanctum	누그리아 성소의 제단으로 가기
隱藏的王陵之書登場	Hidden Royal Mausoleum Book appeared	숨겨져 있던 왕릉 책 등장
取得任務道具	Get the mission item	미션 아이템 구해오기
和王陵之書交談	Talk to the Royal Mausoleum Book	왕릉 책과 대화
和庫班交談。	Talk to Koven 	코벤과 대화하세요.
尋找寶箱	Find the Treasure Chest	보물상자 찾기
和未知的存在交談	Talk to unknown being	알 수 없는 존재와 대화
輸入線索	Enter the clue	단서 입력
謎題的答案	Answer to the riddle	수수께끼의 정답
破壞輔助封印裝置	Destroy the sentinels	보조 봉인 장치 파괴
調查阿爾庫內山坡路周圍的石柱	Check the stone pillars of Alkune Stairway	알쿠네 언덕길 주변의 돌기둥 조사
札卡里耶爾交叉路的寶箱	Treasure Chest of Zachariel Crossroads	자카리엘 교차로의 보물상자
消滅發動襲擊的霍克瑪	Defeat the Hogmas	습격해 오는 호그마 처치
和警備兵交談	Talk to the Security Guard	경비병과 대화
在沒有痕跡的廢墟尋找寶箱	Finding the treasure chest in the Traceless Ruins	흔적 없는 폐허에서 보물상자 찾기
警備兵尋找的東西	Look for the Security Guard	경비병이 찾는 것
從霍克瑪身上找尋項鍊	Find the necklace from the Hogmas	호그마들에게서 목걸이 찾기
取得項鍊	Bring the necklace 	목걸이 가져다주기
確認封鎖地區內的水晶是否啟動	Check the Crystal Pillar in the Closed Area	폐쇄된 구역 안의 수정 기둥 확인
獲得石板	Obtained the Mysterious Slate	석판 획득
和柯拉佩達騎士團長烏斯卡交談	Talk to Knight Commander Uska	클라페다 기사단장 우스카와 대화
拜託邪靈祭司大師解釋啟示	Ask the Bokor Master for interpretation of the revelation	보코르 마스터에게 계시의 해석을 부탁하기
和偵察兵交談	Talk to the Scout	정찰병과 대화하기
利用鑰匙開啟資訊視窗後使用狀態	 - use this key to open your Character Information then use Status Points	 키로 정보창을 연 후 스테이터스 사용
和偵察兵交談	Talk to the Scout	정찰병과 대화
和偵察兵再次交談	Talk to the Scout again	정찰병과 다시 대화한다
前往回去的路口	On the road back	돌아가는 길목으로
到夏奧雷伊礦山村莊找隱形眼鏡	Find a lens from the Miners' Village	샤울레이 광산 마을에서 렌즈 찾기
收集布貝毒樣本	Collect Vubbe Poison Samples	부베 독 견본 수집
擊退發動襲擊的毒魔蛙圖圖	Defeat Tutu	습격한 투투 퇴치
和聯絡官尼安交談	Talk to Liaison Officer Nian	연락관 니안과 대화
聯絡官尼安正在針對奇妙石頭給予指引當中。	Nian is informing you about the mysterious stone	연락관 니안이 기묘한 돌에 대해 안내를 해 주고 있습니다.
消滅攻擊尼安的怪物	Defeat the monsters attacking Liaison Officer Nian	니안을 공격하는 몬스터 처치
和史學家亞德交談	Talk to Historian Adelle	사학자 아델과 대화
收集刻有奇妙紋樣的石頭	Collect stones with mysterious patterns	기묘한 모양이 새겨진 돌 수집
交給亞德	Give it to Adelle	아델에게 전달
消滅霍克瑪弓箭手取得刻有奇妙紋樣的石頭	Defeat Hogma Archers and gather Stones with a strange engraving	호그마 궁수를 처치해 기묘한 문양이 새겨진 돌 획득
和考古學家普利特卡交談	Talk to Archaeologist Friedka	고고학자 프리드카와 대화하세요
取得怪物的護身符	Get the monster's amulet	몬스터의 호신부를 획득하세요
在突其頓丘陵收集拓本	Gather the rubbings from Stone Pillar Hill	돌기둥 언덕에서 탁본을 입수
消滅妨礙取得拓本的火暴地鼠獸	Defeat the Bebraspion that is interfering the rubbing	탁본을 방해하는 베브라스피온 처치
抵擋發動襲擊的怪物	Defeat the monsters	습격해오는 몬스터 막기
和巴拉特交談	Talk to Historian Badat	바다트와 대화
快點將研究資料交給巴拉特，讓他能快點回去調查團營地。	Give the research materials quickly so that Badat can return to camp/	빨리 바다트가 조사단 캠프로 돌아갈 수 있도록 연구 자료를 전해 줍시다.
消滅吞吐斯後，找回巴拉特的研究資料	Defeat Tontus and retrieve the research material	톤투스를 처치하고 바다트의 연구자료 되찾기
和凱賓交談	Talk to Kevin	케빈과 대화
收集木柴	Collect firewood	장작 모으기
向周圍的怪物收集堅硬的石灰	Collect Hard Lime from monsters	주변 몬스터에게서 딱딱한 석회 수집
沙漠卓柏卡布拉/吉努特	Desert Chupacabra/Zinute	사막 츄파카브라/지누테
製作偽造品	Making Counterfeits	위조품 만들기
將偽造品交給維塞特	Give the forgeries to Vincent	빈센트에게 위조품 전달
和雕刻家喜爾達交談	Talk to Sculptor Hilda	조각가 힐다와 대화
尋找雕刻家喜爾達說的漂亮的柱子	Find the cool pillar Hilda talked about	조각가 힐다가 말하는 멋진 기둥 찾기
保護雕刻家喜爾達	Protect Sculptor Hilda	조각가 힐다를 보호
保護雕刻家喜爾達	Protect Sculptor Hilda	조각가 힐다 보호
採集貴重的樹液	Collect Shiny Tree Sap	귀중한 나무 수액 채집
和亞希拉斯交談	Talk to Ahylas	아힐라스와 대화
取得峽谷阿瑪拉斯	Collect Canyon Amalas	협곡 아말라스 구하기
交給亞希拉斯	Give it to Ahylas	아힐라스에게 전달
消滅泰瑪	Defeat Tama	타마 처치
尋找第四個碑石碎片	Find the Fourth Tombstone Fragment	네 번째 비석 조각 찾기
採取樹妖樹液	Collect Stumpy Tree Sap	몽당 나무 수액 채취
尋找遺址碎片	Finding fragments of ruins	유적 파편 찾기
製作比度雷山莊的第一個碑石拓本	Get the first rubbing at Virdului Mountain Cabin	빌률뤼 산장의 첫 번째 비석 탁본 뜨기
第二個拓本作業	The Second Rubbing	두 번째 탁본 작업
確認榭魯瑪祭壇的第四個碑石	Check the fourth gravestone at the Shiluma Altar Site	쉴루마 제단 터의 네 번째 비석 확인
尋找最後一個碑石	Finding the Last Gravestone	마지막 비석 찾기
在克里尤貝街道另一端尋找最後一個碑石	Find the Last Gravestone at Griuve Highway	그리유베 가도 너머에서 마지막 비석 찾기
尋找亞佳伊拉弗羅里的碑文	Find Agailla Flurry's gravestones 	아가일라 플러리의 비문 찾기
瀏覽亞佳伊拉弗羅里的碑文	Read the inscription on Agailla Flurry's gravestone 	아가일라 플러리의 비문 읽기
修復破損的亞佳伊拉弗羅里碑文	Restore the damaged gravestone of Agailla Flurry 	파손된 아가일라 플러리의 비문 복원하기
消滅努德鉤子	Defeat Old Hooks	누덕 갈고리 처치
答應村民的委託	Do Villager's Favor	마을 사람의 부탁 들어주기
將行李包交給村民	Give the Bag to the Villager	마을 사람에게 짐가방 전해주기
尋找村民的行李包	Find the Villager's Bag	마을 사람의 짐가방 찾기
和村民交談	Talk to the Villager	마을 사람과 대화
消滅露克立斯紀念碑周圍的怪物	Defeat the monsters nearby Ruklys Memorial Stone	루클리스 추모비 주변 몬스터 처치
確認奇怪的布袋	Check the strange sack	이상한 자루 확인
收集實驗材料	Collect experiment materials	실험 재료 수집
消滅長臂樹怪	Defeat Long-Branched Trees	긴팔 나무 처치
收集水草	Collect Waterweed	물풀 수집
女神的古院的邪靈術師特拉修斯在等待他人的幫助。	Lizardman Mind-Control	여신의 옛뜰의 사령술사 드라슈스가 누군가의 도움을 기다리고 있습니다.
支配蜥蜴人的精神	Mind-controlled Lizardmen	리자드맨 정신지배
支配因普洛博克的精神	Mind-controlled Infroburk	인프로버크 정신지배
移動至柯拉佩達和騎士團長烏斯卡交談	Move to Klaipeda and Talk to Knight Commander Uska	클라페다로 이동해 기사단장 우스카와 대화
膜拜奧施莉奈女神像	Worship the Statue of Goddess Ausrine	아우슈리네 여신상에 경배
與雜貨商人對話	Talk to the Item Merchant	잡화 상인과 대화
確認軍用背包	Check the Military Backpack	군용 배낭 확인
執行樹木山溝作戰	Commence Operation Wooden Village	나뭇골 작전 실행
進行引誘獨角獸的準備	Prepare to lure Unicorn	유니콘 유인 준비
消滅喬雷	Defeat Zolems	졸렘 처치
執行樹木山溝作戰	Carry out Operation Tree Dale	나뭇골 작전 수행
消滅獨角獸	Defeat Unicorn	유니콘 처치
向徘徊的靈魂報告	Report to the Wandering Spirit	배회하는 영혼에게 보고
和村莊青年凱伊希交談	Talk to Villager Cahill	마을 청년 케이힐과 대화
和姆杰老人交談	Talk to Old Man Moses	모제 영감과 대화
將木材交給姆杰老人	Give lumber to Old Man Moses	모제 영감에게 목재를 가져다 주기
和姆杰迪瑟交談	Talk to Moses Diesel	모제 디셀과 대화
取得飛天青蛙的堅硬皮革	Get Strong Flying Frog Leather	날개 개구리의 단단한 가죽 구하기
交給姆杰老人	Give them to Old Man Moses	모제 영감에게 전달
將拐扙交給村莊青年凱伊希	Give crutches to Villager Cahill	마을 청년 케이힐에게 목발 전해 주기
和信徒托馬斯交談	Talk to Believer Domas	신도 도마스와 대화
交給信徒托馬斯	Give them to Believer Domas	신도 도마스에게 전달
和薩勒女神的信徒亞德雷交談	Talk to Goddess Saule Believer Adele	사울레 여신의 신도 아델레와 대화
將腳趾甲交給信徒亞德雷	Give the claws to Believer Adele	신도 아델레에게 발톱 전달
和信徒亞德雷交談	Talk to Believer Adele	신도 아델레와 대화
尋找信徒亞德雷的戒指	Find Believer Adele's ring	신도 아델레의 반지 찾아주기
將戒指交給信徒亞德雷	Give the ring to Believer Adele	신도 아델레에게 반지 전달
將毒菇交給信徒亞德雷	Give Truffle's Poisonous Mushrooms to Believer Adele	신도 아델레에게 독버섯 전달
在調和祭壇製作組合液	Combine the mixed solution at the Altar of Harmony	조화의 제단에서 조합액 제작
將組合液交給信徒亞德雷	Give the mixed solution to Believer Adele	신도 아델레에게 조합액 전달
利用酸性溶液溶化針刺藤蔓	Melt the thorny vines using the Acid Solution	산성 용액으로 가시덩굴 녹이기
和信徒皮勒基史交談	Talk to Believer Virgis	신도 비르기스와 대화
在凝聚魔力的地方補充魔力水晶	Charge the Magic Crystal in the condensed magic spots	마력이 응축된 곳에서 마력수정 충전하기
精煉魔力水晶的魔力	Refine the magic in the Magic Crystals	마력수정의 마력 정제하기
獲得完成精煉的魔力水晶	Get the refined Magic Crystal	정제가 끝난 마력수정 획득
使用魔力水晶消除針刺藤蔓	Use the refined Magic Crystal to remove the thorny vines	마력 수정을 사용하여 가시 덩굴 없애기
和信徒諾尤司交談	Talk to Believer Nojus	신도 노유스와 대화
尋找不祥聲音的主人	Find the 'ominous voice'	불길한 목소리의 주인 찾아가기
前往克巴伊拉斯森林	Move to Kvailas Forest	크바일라스 숲으로 이동
消滅被召喚的波亞塔	Defeat the summoned Poata	소환된 포아타 처치
和信徒奧比狄司交談	Talk to Believer Alvydas	신도 알비다스와 대화
尋找薩勒女神的信徒	Look for Goddess Saule Believers	사울레 여신의 신도를 찾아보기
和信徒拉敏塔交談	Talk to Believer Raminta	신도 라민타와 대화
消滅散佈邪惡力量的元凶	Defeat the source of the evil energy	사악한 기운을 퍼뜨리는 원흉 처치
向信徒拉敏塔報告	Report to Believer Raminta	신도 라민타에게 보고
消滅利卡烏斯	Defeat Rikaus	리카우스 처치
和信徒埃帕爾達史交談	Talk to Believer Evaldas	신도 에발다스와 대화
妨礙梅羅葛咒術師的咒術儀式	Interrupt the Merog Shaman's Ritual	메로그 주술사의 주술 의식 방해
向信徒埃帕爾達史報告	Report to Evaldas	신도 에발다스에게 보고
消滅設置魔族召喚陣的梅羅葛咒術師	Defeat the Merog Shaman performing a ritual	마족 소환진을 설치하고 있는 메로그 주술사 처치
和信徒查內塔交談	Talk to Believer Zaneta	신도 자네타와 대화
破壞魔族召喚水晶	Destroy the Demon Summoning Crystal	마족 소환 수정 파괴
向信徒查內塔報告	Report to Believer Zaneta	신도 자네타에게 보고
和信徒希瑪史交談	Talk to Believer Simas	신도 시마스와 대화
向信徒希瑪史報告	Report to Believer Simas	신도 시마스에게 보고
破壞召喚水晶	Destroy the Demon Summoning Crystal	소환 수정 파괴
和信徒奧奴泰交談	Talk to Believer Onute	신도 오누테와 대화
向信徒奧奴泰報告	Report to Believer Onute	신도 오누테에게 보고
和信徒普羅紐斯交談	Talk to Believer Bronius	신도 브로뉴스와 대화
消滅企圖攻擊信徒的怪物	Defeat the monsters trying to kill the Believer	신도를 공격하려는 몬스터 처치
和薩勒女神的信徒沙曼塔交談	Talk to Believer Samantha	사울레 여신의 신도 사만타와 대화
從消滅怪物開始保護祭壇	Protect the altar from the monsters	몬스터로부터 제단 보호
確認史比愛沙丘陵地	Check Sviesa Hill Areas	스비에사 구릉지 확인
和信徒猶勒卡交談	Talk to Believer Jurga	신도 유르가와 대화
守護佛蘭普的根的魔龍凱拉斯	Defeat Gaigalas	브람블의 뿌리를 지키는 가이갈라스
破壞佛蘭普的根	Destroy Bramble's Root	브람블의 뿌리 파괴
確認坦基塔空地	Check Tankinta Vacant Lot	탄킨타 공터 확인
消滅守護佛蘭普的根的莫雷克	Defeat Molich	브람블의 뿌리를 지키는 몰렉 처치
和信徒卡基斯交談	Talk to Believer Kazis	신도 카지스와 대화
淨化卡拉達斯小路	Purify Karadas Path	카라다스 오솔길 정화하기
消滅佛蘭普且找回啟示	Defeat Bramble and retrieve the revelation	브람블을 처치하고 계시 되찾기
獲得啟示	Retrieve the revelation	계시 획득
消滅佛蘭普	Defeat Bramble	브람블 처치
和安德伊村莊元老交談	Talk to the Old Man of Andale Village	안데일 마을 원로와 대화
去找安德伊村莊神官	Go to the Andale Village Priest	안데일 마을 신관 찾아가기
和村莊神官交談	Talk to the Village Priest	마을 신관과 대화
在白橡樹森林取得樹木津液	Collect tree sap from White Oak Forest	갈참나무 숲에서 나무 진액 구하기
前往耶魯薛可祭壇	Go to the Ershike Altar	에르쉬케 제단으로 가기
前往耶魯薛可祭壇回收染料	Retrieve dye from the Ershike Altar	에르쉬케 제단에서 염료 회수
修復方尖塔	Restore the Obelisk	오벨리스크 복원
與安德伊村莊的神官對話	Talk to the Village Priest	얀데일 마을 신관과 대화
前往尼普利托溪谷	Go to Nefrito Valley	네프리토 계곡으로 가기
消滅魔地獸	Defeat Moldyhorn	몰디혼 처치
確認耶魯薛可祭壇 	Check the Ershike Altar	에르쉬케 제단 확인
消滅對不祥氣息產生反應的怪物	Defeat the monsters that reacted to the ominous energy	불길한 기운에 반응한 몬스터 처치
確認方尖塔	Check the Obelisk	오벨리스크 확인
消滅湛藍樹精	Defeat Blue Woodspirit	푸른 우드스피릿 처치
請消滅方尖塔附近的湛藍樹精。	Defeat the Blue Woodspirit that appeared near the Obelisk	오벨리스크 근처에 나타난 푸른 우드스피릿을 처치하세요.
去找安德伊村莊的祭司	Find the Andale Village Priest	안데일 마을의 사제 찾아가기
和安德伊村莊的祭司交談	Talk to the Andale Village Priest	안데일 마을의 사제와 대화
和安德伊村莊的村長交談	Talk to Andale Village Headman	안데일 마을의 촌장과 대화
尋找炸藥	Find a Useful Bomb	폭약 찾기
對沉睡的伍潘特使用無力草炸彈	Use the Languid Bomb on the sleeping Upents	잠든 우펜트에게 나른초 폭탄 사용
確認貝雅山谷的傳點	Check the portal of Veja Ravine	베야 골짜기의 포탈 확인
消滅魔族居民	Defeat Demon Resident	마족 주민 처치
前往老舊的井	Go to the old well	낡은 우물로 가기
尋找能放入老舊的井中的物品	Look for something to put in the old well	낡은 우물 속에 넣어볼만한 물건 찾기
前往德慕尼溼地	Go to Dvyni Wetland	드뷔니 습지로 가기
小心觀看者的奸計	Beholder's Careful Trick	주시자의 간계 조심하기
將這段期間的事情告訴聖殿十字軍大師	Tell the Paladin Master about the story so far	팔라딘 마스터에게 그 간의 이야기를 전해 주자
確認赤紅氣息	Investigate the Red Energy	붉은 기운 확인
消滅地獄三頭犬	Defeat Cerberus	켈베로스 처치
和馬勒達斯對話	Speak with Mardas	마르다스와 대화
調查巴斯提提斯原野後再來	Investigate Bastymosi Field	바스티티스 벌판 살펴보고 오기
追蹤貓頭鷹雕像送出的光明珠	Follow the light bead from the Owl Sculpture	부엉이 조각상이 보내는 빛구슬 추적
請追逐光明珠前往骨風絕壁	Follow the light bead to Bonewide Cliff	빛구슬을 쫓아 뼈바람 절벽 쪽으로 이동
卡羅利斯祭壇復原	Recover the Karolis Altar	카롤리스 제단 복구
回收卡羅利斯祭壇水晶	Retrieve the Karolis Altar Crystal	카롤리스 제단 수정 회수
回收怪物手中的卡羅利斯祭壇的碎片	Retrieve Karolis Altar Fragments from monsters	몬스터로부터 카롤리스 제단의 파편 회수
點亮卡羅利斯之光	Illuminate Karolis' light	카롤리스의 빛 밝히기
收集貓頭鷹的力量	Gather the Strength of the Owl	부엉이의 힘을 모아서
聚集貓頭鷹雕像的力量	Collect the power of the Owl Sculptures	부엉이 조각상들의 힘을 모아오기
破壞杜歐葛雷殿堂的精神支配之塔	Destroy the Mind Control Tower at Duoklu Hall	듀오클뤼 전당의 정신 지배의 탑 파괴
和貓頭鷹隊長雕像再次對話	Speak with the Owl Chief Sculpture again	대장 부엉이 조각상과 다시 한번 대화
收集卡羅利斯泉水的氣息	Collect the Energy of Karolis Springs	카롤리스 샘터의 기운 수집
尋找萊塔斯小溪邊的領路人貓頭鷹雕刻像	Find the Guide Owl Sculpture at Letas Stream	레타스 개울가에 있는 길잡이 부엉이 조각상 찾기
森林的神聖之樹	Sacred Tree of the Forest	숲의 신성한 나무
和領路人貓頭鷹雕像交談	Talk to the Guide Owl Sculpture	길잡이 부엉이 조각상과 대화
搜索萊塔斯的神聖樹枝	Find Letas' Sacred Branch	레타스의 신성한 나뭇가지 수색
跟領路人貓頭鷹雕像報告	Report to the Guide Owl Sculpture	길잡이 부엉이 조각상에게 보고
吸收已淨化的力量	Absorb the purified energy	정화된 힘 흡수
去找馬勒達斯	Speak to Mardas	마르다스 찾아가기
消除污染森林的邪惡氣息	Clear out the evil energy contaminating the forest	숲을 오염시키는 사악한 기운 제거
跟馬勒達斯報告	Report to Mardas	마르다스에게 보고
消除監視區管理魔法陣	Remove the Surveillance Sphere Magic Circle 	감시구 관리 마법진 제거
消除黑暗氣息	Remove the Black Energy	검은 기운 제거
靈魂餓鬼	Soul Starvation	영혼 아귀
解除所有保護靈魂餓鬼的防護魔法陣	Remove all magic circles protecting the Soul Starvation	영혼 아귀를 지키는 보호 마법진 전부 해제
解除保護靈魂餓鬼的防護魔法陣	Remove the magic circles protecting the Soul Starvation	영혼 아귀를 지키는 보호 마법진 해제
用抑制之那姆特破壞靈魂餓鬼	Destroy the Soul Starvation with the Namott of Suppression	억제의 나모트로 영혼 아귀 파괴
確認上鎖的箱子	Look inside the locked chest	잠겨진 상자 확인
消滅周圍的怪物並向上鎖的箱子提供魔力	Defeat monsters to supply magic to the Locked Chest	주변의 몬스터를 처치하여 잠겨진 상자에 마력 공급
開啟上鎖的箱子	Open the locked chest	잠겨진 상자 열기
確認掉落在地板上的信件	Check the letter on the ground	바닥에 떨어진 편지 확인
尋找信件的主人	Find the right recipient	편지의 주인 찾기
確認萊塔斯祭壇	Check the Letas Altar	레타스 제단 확인
消滅擾亂萊塔斯祭壇氣息的周邊怪物	Defeat the nearby monsters disrupting the energy of the Letas Altar	레타스 제단의 기운을 어지럽히는 주변의 몬스터 처치
和法師次級大師對話	Talk to the Wizard Submaster	위저드 서브 마스터와 대화
消滅加橋森林的怪物	Defeat the monsters in the Woods of the Linked Bridges	덧댄다리 숲의 몬스터 처치
跟法師次級大師報告	Report to the Wizard Submaster	위저드 서브 마스터에게 보고
和烈焰法師次級大師對話	Talk to the Pyromancer Submaster	파이로맨서 서브 마스터와 대화
與蘊含火之氣息的晶球一起消滅怪物	Defeat monsters with the Fire Energy Bead	불의 기운이 담긴 구슬과 함께 몬스터 처치
跟烈焰法師次級大師報告	Report to the Pyromancer Submaster	파이로맨서 서브 마스터에게 보고
和寒冰法師次級大師對話	Talk to the Cryomancer Submaster	크리오맨서 서브 마스터와 대화
消滅怪物後，把魔力注入魔力寒冰碎片	Defeat monsters and replenish the Magical Piece of Ice	몬스터를 처치해서 마력의 얼음 조각에 마력 충전
跟寒冰法師次級大師報告	Report to the Cryomancer Submaster	크리오맨서 서브 마스터에게 보고
和弓箭手次級大師對話	Talk to the Archer Submaster	아처 서브 마스터와 대화
攻擊遠距離怪物	Attack monsters from a distance	먼 거리에서 몬스터 공격
跟弓箭手次級大師報告	Report to the Archer Submaster	아처 서브 마스터에게 보고
和遊俠次級大師對話	Talk to the Ranger Submaster	레인저 서브 마스터와 대화
單獨在10秒內連續消滅怪物	Defeat monsters all by yourself in 10 seconds	혼자서 몬스터를 10초안에 연속해서 처치
跟遊俠次級大師報告	Report to the Ranger Submaster	레인저 서브 마스터에게 보고
和弩箭手次級大師對話	Talk to the Quarrel Shooter Submaster	쿼렐슈터 서브 마스터와 대화
跟弩箭手次級大師報告	Report to the Quarrel Shooter Submaster	쿼렐슈터 서브 마스터에게 보고
聆聽其他魔法師系列大師們的建議	Listen to advice from the masters of other magic areas	다른 마법사계열 마스터들에게 조언 듣기
消滅濃縮的火焰石周圍的怪物	Defeat monsters nearby the Condensed Firestone	응축된 화염석 주변의 몬스터 처치
使用冰氣的魔法書後消滅怪物	Defeat monster after using Frost Tome	냉기의 마법서 사용 후 몬스터 처치
使用念力法師卷軸擊飛怪物	Blow away monsters using the Psychokino Scroll	사이코키노 스크롤을 사용해서 몬스터 날려보내기
和在歐勒夏的鎖鏈法師大師對話。	Talk to the Linker Master in Orsha	오르샤에 있는 링커 마스터와 대화하세요.
在找到鎖鏈法師的連接點為止持續攻擊怪物	Attack monsters until you find a linkage point	링커의 연결점을 찾을 때까지 몬스터 공격
消滅既是飛行型也是布防禦類型的怪物	Defeat Flying-type monsters with the Cloth armor-type	비행형이면서 천 방어 타입인 몬스터 처치
收集城牆修復用石材	Collect Wall Restoration Stones	성벽 복구용 석재 수집
向植物型怪物取得黏稠植物汁液	Obtain Sticky Plant Sap from Plant-type monsters	식물형 몬스터에게서 끈적이는 식물 진액 획득
和工兵次級大師對話	Talk to the Sapper Submaster	새퍼 서브 마스터와 대화
收集堅硬的研究用石材	Collect Sturdy Research Stones	단단한 연구용 석재 수집
跟工兵次級大師報告	Report to the Sapper Submaster	새퍼 서브 마스터에게 보고
和獵人次級大師對話	Talk to the Hunter Submaster	헌터 서브 마스터와 대화
到地下城消滅怪物	Defeat monsters in a dungeon	던전에서 몬스터 처치
所有地下城地區	All dungeon areas	모든 던전 지역
跟獵人次級大師報告	Report to the Hunter Submaster	헌터 서브 마스터에게 보고
消滅火屬性怪物	Defeat fire property monsters	불 속성 몬스터 처치
消滅冰屬性怪物	Defeat ice property monsters	얼음 속성 몬스터 처치
消滅魔力控制感應球範圍內的怪物	Defeat monsters with the range of Magic Control Detection Orb	마력제어 감지구 범위 안의 몬스터 처치
消滅怪物收集靈性氣息	Defeat monsters to collect Spiritual Energy	몬스터를 처치하여 영적 기운 수집
和奇術師次級大師對話	Talk to the Thaumaturge Submaster	쏘마터지 서브 마스터와 대화
跟奇術師次級大師報告	Report to the Thaumaturge Submaster	쏘마터지 서브 마스터에게 보고
消滅卡拉伊爾陵墓中的地獄亡靈	Defeat Necroventer at Carlyle's Mausoleum	칼라일의 영묘에 있는 네크로벤터 처치
向德慕爾外城的怪物收集火藥劑	Collect Gun Powder from monsters at Delmore Outskirts	델무어 외성의 몬스터에게서 화약재 수집
搜索獵人的測試信物	Search for Hunter's Pass	헌터의 시험증표 수색
對怪物使用屍毒瓶並提取屍毒	Collect poison from monsters in the Poison Bottle	몬스터에게 시독병을 사용해서 시독 채취
和斥侯次級大師對話	Talk to the Scout Submaster	스카우트 서브 마스터와 대화
攻擊敵人卻不被攻擊	Attack enemies without getting hit	적에게 피격되지 않고 공격
跟斥侯次級大師報告	Report to the Scout Submaster	스카우트 서브 마스터에게 보고
請與歐勒夏的劍士次級大師對話	Talk to the Swordsman Submaster in Orsha	오르샤에 있는 소드맨 서브 마스터와 대화하세요
請在熟練特性後與劍士次級大師對話	Learn the attributes and talk to the Swordsman Submaster	특성을 익힌 후 소드맨 서브 마스터와 대화하세요
請與歐勒夏的法師次級大師對話	Talk to the Wizard Submaster in Orsha	오르샤에 있는 위저드 서브 마스터와 대화하세요
請在熟練特性後與法師次級大師對話	Learn the attributes and talk to the Wizard Submaster	특성을 익힌 후 위저드 서브 마스터와 대화하세요
請與歐勒夏的弓箭手次級大師對話	Talk to the Archer Submaster in Orsha	오르샤에 있는 아처 서브 마스터와 대화하세요
請在熟練特性後與弓箭手次級大師對話	Learn the attributes and talk to the Archer Submaster	특성을 익힌 후 아처 서브 마스터와 대화하세요
請與歐勒夏的牧師次級大師對話	Talk to the Cleric Submaster in Orsha	오르샤에 있는 클레릭 서브 마스터와 대화하세요
請在熟練特性後與牧師次級大師對話	Learn the attributes and talk to the Cleric Submaster	특성을 익힌 후 클레릭 서브 마스터와 대화하세요
消滅周圍的怪物並獲得鑰匙	Defeat monsters to obtain the key	주변의 몬스터를 처치해서 열쇠 획득
和飾品商人交談	Talk to the Accessory Merchant	악세서리 상인과 대화
和長橋溪谷的莫勒庫斯‧尤那斯見面	Meet Morkus Jonas in Overlong Bridge Valley	긴다리 계곡의 모르쿠스 요나스 만나기
前往阿克梅斯山脊	Move to Akmens Ridge	아크멘스 능선으로 이동
和羅藍塔斯尤那斯見面	Meet Rolandas Jonas	롤란다스 요나스 만나기
和藥師大叔交談	Talk to the Pharmacist Lady	약사 아가씨와 대화
交出藥材	Give medicinal ingredients to Pharmacist Lady	약 재료 건네 주기
藥師大叔的委託	Pharmacist's Favor	약사 아가씨의 부탁
取得藥材	Get medicinal ingredients	약 재료 구해 오기
搜查草堆	Search in the bushes	풀더미 수색
轉交找到的食物	Bring the food that you found	찾아낸 먹을거리 전달
在堤利亞小路的魔法陣放上女神像	Put the Goddess Statue on the magic circle at Tylila Path	틸리아 오솔길의 마법진에 여신상 올려 놓기
和阿爾費納對話	Talk to Albinas	알비나스와 대화
破壞那斯圖斯派的碑石	Destroy the Tombstones of Nestopa	네스토스파의 비석 파괴
破壞那斯圖斯的碑石	Destroy the Tombstone of Nestopa	네스토스의 비석 파괴하기
和丹米尤那斯對話	Talk to Damijonas	다미요나스와 대화
回到丹米尤那斯身邊	Return to Damijonas	다미요나스에게 돌아가기
解開丹米尤那斯的誤會	Explain yourself	다미요나스의 오해 풀기
復原碑石	Restoring the Tombstone	비석 복구
和艾圖那司對話	Talk to Eduinas	에뒤나스와 대화
營地周邊的怪物整頓	Defeat the monsters around the camp	캠프 주변의 몬스터 정리
聖所復原	Restore the sanctum	성소 복구 하기
和凱泰斯對話	Talk to Gedas	게다스와 대화
收集易燃粉末	Collect Flammable Powder	불에 잘 타는 가루 수집
取得易燃粉末	Obtain Flammable Powder	불에 잘 타는 가루 구하기
最後結論	The Final Conclusion	최종 결론
和巴勒泰對話	Talk to Barte	바르테와 대화
詢問現在到底要做什麼事情。	Ask what you should do now	이제 무엇을 해야 하는지 물어보세요.
消滅阿爾費納的真面目火焰權杖	Defeat Fire Lord	알비나스의 본색인 파이어로드 처치
和雷歐普達斯對話	Talk to Leopoldas	레오폴다스와 대화
和凱勒泰對話	Talk to Gerda	게르다와 대화
回去找凱勒泰	Return to Gerda	게르다에게 돌아가기
和賽拉彼納斯對話	Talk to Serapinas	세라피나스와 대화
回去找賽拉彼納斯	Return to Serapinas	세라피나스에게 돌아가기
回收遺失的物品	Lost and Found	잃어버린 물품 회수
尋找梅瑞莎	Find Merrisa	메리사 찾아가기
交給梅瑞莎	Deliver to Merrisa	메리사에게 전달
與梅瑞莎對話	Talk to Merrisa	메리사와 대화
消滅因普洛博克後回收濕濕的紙片	Defeat Infroburks and retrieve the Damp Pieces of Paper	인프로 버크를 처치하고 축축한 종이 조각 회수
向梅瑞莎報告	Report to Merrisa	메리사에게 보고
凱都拉商團的教育資料	Educational Materials of the Kedoran Merchant Alliance	케도라 상단의 교육 자료
和馬勒傑利尤思對話	Talk to Margellius	마르젤리유스와 대화
收集因普洛博克體液	Obtain Infroburk Body Fluid	인프로 버크 체액 수집
克巴伊拉斯森林	Kvailas Forest	크바일라스 숲
和士兵傑伊司交談	Talk to Soldier Jace	병사 제이스와 대화
尋找士兵的遺物	Retrieving Soldiers' Mementos	병사들의 유품 찾아오기
消滅布貝掠奪者	Defeat Vubbe Thief	부베 약탈자를 처치
和士兵艾德嘉交談	Talk to Soldier Edgar	병사 에드가와 대화
找回布貝奪走的糧食	Retrieve the stolen food supplies from the Vubbes	부베가 약탈한 식량 되찾기
前往凱利高原	Travel to Gele Plateau	겔리 고원으로 이동
凱利高原	Gele Plateau	겔리 고원
移動到佩迪米安	Go to Fedimian	페디미안으로 이동
佩迪米安	Fedimian	페디미안
 按著按鍵在休息狀態下 	 key to enter Rest Mode and press the 	 키를 눌러 휴식상태에서 
將解毒劑交給奇堤斯	Give antidote to Gytis	기티스에게 해독제 전달
幫助守護農場出入口的士兵艾爾倫	Help Soldier Alan guard the Farm Entrance	농장 출입문을 지키고 있는 병사 앨런 돕기
殘存的危險	Remaining Danger	잔존하는 위험
確認水晶礦山布貝的動靜	Survey Vubbe Activity in the Crystal Mine	수정광산 부베들의 움직임 확인
設置拜杜塔斯特製香爐	Set Vaidotas' Special Incense Burner	바이도타스 특제 향로 설치
收集莫厄之瘤	Collect Moa Lumps	모아의 혹 수집
再將它交給看守者艾拉	Hand them over to Watcher Erra	파수꾼 에라에게 전달
指定區域	Territorial Assignment	구역 지정
收集串繩材料	Collect Odd Fish Stringers	꿰미 재료 수집
卡汀森林入口全區	Entire region of Entrance of Kateen Forest	카틴 숲 입구 전 지역
再將它轉交給看守者莫爾黎	Hand them over to Watcher Molly	파수꾼 몰리에게 전달
設置串繩	Set the Stringers	꿰미 설치
失蹤案件	Disappearances	실종 사건
搜查失蹤現場	Search the spot where the disappearances took place	실종 현장 수색
保護柯拉佩達市場的靈魂	Protect the Spirit of Klaipeda's Mayor	클라페다 시장의 영혼 보호
與柯拉佩達市場的靈魂對話	Talk to the spirit of Klaipeda's Mayor	클라페다 시장의 영혼과 대화
消滅想攻擊柯拉佩達市場的靈魂的人	Defeat those trying to attack the spirits of the Klaipeda Market	클라페다 시장의 영혼을 공격하려는 자들 처치
用提尼的精髓替安慰之珠充電	Fill the Orb of Comfort with Tini Essence	티니의 정수로 위로의 구슬 충전
科博爾特森林全區	The whole territory of Cobalt Forest	코발트 숲 전 지역
將怨念吸收至安慰之珠	Absorb the resentment into the Orb of Comfort	원념을 위로의 구슬에 흡수
薩勒女神的請求	Goddess Saule's Request	사울레 여신의 부탁
清除通往關口路要道上的針刺藤蔓	Remove the thorny vines obstructing the way to the Gate Route	관문로 가는 길목의 가시 덩굴 제거
清除針刺藤蔓	Remove the thorny vines	가시 덩굴 제거
在史爾特凱拉森林設置權能結晶	Set the crystal of the authority at Sirdgela Forest	시르드겔라 숲에 권능의 수정 설치
收集純粹的寒氣結晶	Collect the Crystal of Pure Frost	순수한 냉기의 결정 수집
請將它交給寒冰法師大師	Deliver to the Cryomancer Master	크리오맨서 마스터에게 전달
隱藏寶物	Hidden Treasures	숨겨진 보물들
茲貝克的粒粒充電	Charging Zubeck's Orb	즈벡의 구슬 구슬 충전
破壞魔族召喚陣	Destroy the demon summon field	마족 소환진 파괴
女神的封印塔	Sealed Tower of the Goddess	여신의 봉인탑
與祭司拉美莉耶對話	Talk to Priest Ramelie	사제 라멜리아와 대화
封印塔防禦	Protect the Sealed Tower	봉인탑 방어
與祭司拉美莉耶對話	Talk to Priest Ramelie	사제 라멜리에와 대화
為奧斯特雅女神的紋章充電	Charge the Goddess Austeja's Scripture 	아우스테야 여신의 문장 충전
將奧斯特雅女神的紋章獻給封印塔	Offer the Goddess Austeja's Scripture to the Sealed Tower	아우스테야 여신의 문장을 봉인탑에 봉헌
啟動露克立斯的裝置尋找啟示	Activate the Ruklys device to find the revelation	루클리스의 장치를 작동시켜 계시 찾기
前往採藥者小木屋拯救流動商人	Go to the Herb Gatherers' Cabin to save the merchants	행상인들을 구하러 약초꾼 오두막으로 이동
與流動商人羅潔對話	Talk to Traveling Merchant Rose	행상인 로제와 대화
消滅威脅流動商人們的魔族	Defeat the demons threatening the merchants	행상인들을 위협하는 마족 처치
羅潔的同伴們	Rose's Colleagues	로제의 동료들
把耐力藥丸給拉舒	Give Laswi a Stamina Pill	라쉬에게 스태미나 알약 주기
和拉舒一起尋找失散的流動商人	Find the merchants with Laswi	라쉬와 함께 흩어진 행상인 찾기
尋找剩下的最後一個流動商人	Find the last Traveling Merchant	마지막 남은 행상인 찾기
與流動商人卡西亞斯對話	Talk to Traveling Merchant Cassias	행상인 카시야스와 대화
消滅來襲的魔族	Defeat the attacking demons	습격해오는 마족 처치
向流動商人羅潔報告	Report to Traveling Merchant Rose	행상인 로제에게 보고
與流動商人安德雷斯對話	Talk to Traveling Merchant Andres	행상인 안드레스와 대화
搜尋丟失的行李包裹	Look for the Lost Package	잃어버린 짐보따리 수색
轉交給流動商人安德雷斯	Deliver to Traveling Merchant Andres	행상인 안드레스에게 전달
和流動商人高梅斯對話	Talk to Traveling Merchant Gomez	행상인 고메스와 대화
消滅採藥者小木屋四周的怪物	Defeat the monsters nearby Herb Gatherers' Cabin	약초꾼 오두막 주변의 몬스터 처치
向流動商人高梅斯報告	Report to Traveling Merchant Gomez	행상인 고메스에게 보고
消滅採藥者小木屋四周的怪物	Defeat the monsters nearby Herb Gatherers' Cabin	약초꾼 오두막 주변 몬스터 처치
受傷的採藥者	Injured Herbalist	상처입은 약초꾼
在那巴吉加高地採集倫奇亞草	Collect Ronjia Grass at Nevaginga Hillside	네바깅가 고지대에서 론지아 풀 채집
交給採藥者戴伊斯	Deliver to Herbalist Tales	약초꾼 테일스에게 전달
把泰爾斯的症狀告訴歐勒夏的牧師次級大師	Tell the Cleric Master in Orsha about Herbalist Tales' symptoms	오르샤의 클레릭 서브 마스터에게 테일스의 증상 전달
把藥交給採藥者戴伊斯	Deliver the medicine to Herbalist Tales	약초꾼 테일스에게 약 전달
村莊居民的行蹤	Where Did Everybody Go?	마을 주민의 행방
請跟著流動商人羅潔前往克尼多斯森林	Follow Traveling Merchant Rose to Knidos Jungle	크니도스 숲으로 행상인 로제 따라가기
搜索克洛亞村莊並推測發生了什麼事	Search in Croa Village to find out what happened	크로아 마을 수색해 무슨 일이 있었는지 추측
跟著掉落在地面上的晶球走	Follow the beads on the ground	바닥에 떨어진 구슬 따라가기
搜索四周，尋找其他晶球或線索	Look for more beads or other clues	주변을 수색해 다른 구슬이나 단서 찾기
與躲起來的人對話	Talk to the person who is hiding	숨어있는 사람과 대화
與泰斯對話	Talk to Tess	테스와 대화
回去和泰斯對話	Return to to Tess and talk to her	테스에게 돌아가 대화
消滅追趕泰斯的魔族	Defeat the demons chasing Tess	테스를 쫓아온 마족 처치
和採藥者亞斯對話	Talk to Herbalist Ash	약초꾼 아스와 대화
消滅四周的魔族	Defeat nearby demons	주변의 마족 처치
魔族採藥者	Demon Herbalist	마족 약초꾼
採集魔族過去所蒐集的藥草	Collect the same herbs as the demon	마족이 채집했다던 약초 채집
交給採藥者亞斯	Deliver to Herbalist Ash	약초꾼 아스에게 전달
收集路克塔奴的體液	Collect Loktanun Fluid	록타눈의 체액 수집
把路克塔奴的體液灑在烏頭草上	Spray the Loktanun Fluid on the Aconite	바꽃에 록타눈의 체액 뿌리기
巨大的蕨葉	Giant Bracken	거대한 고사리
跟隨前往達坦森林的流動商人羅潔	Follow Traveling Merchant Rose to Dadan Jungle	다단 숲으로 간 행상인 로제 따라가기
找到魔族的實驗室後消滅該處的魔族	Find the demon laboratory and defeat the demons there	마족의 실험실을 찾아 그곳의 마족 처치
搜尋與巨大蕨類有關的資料	Search for materials on the Giant Bracken	거대 고사리와 관련된 자료 수색
把日誌交給流動商人羅潔	Deliver the diary to Traveling Merchant Rose	행상인 로제에게 일지 전달
回去把日誌交給流動商人羅潔	Return to Rose and deliver the diary	행상인 로제에게 돌아가 일지 전달
救出流動商人羅潔	Rescue Traveling Merchant Rose	행상인 로제 구출
消滅想綁架羅潔的魔族	Defeat the demons that tried to kidnap Rose	로제를 납치하려는 마족 처치
找出動力供給裝置並清除動力源	Find the Power Supply Device and remove the power source	동력 공급 장치를 찾아 동력원 제거
跟著流動商人羅潔到諾巴哈修道院入口	Follow Traveling Merchant Rose to the entrance of the Novaha Monastery	노바하 수도원 입구로 행상인 로제 따라가기
消滅看守要道的魔族	Defeat the sentinel demons	길목을 지키고 있는 마족 처치
消滅看守修道院入口的小魔怪	Defeat the Gremlin guarding the monastery entrance	수도원 입구를 지키고 있는 그렘린 처치
與採藥者戴拉斯對話	Talk to Herbalist Talas	약초꾼 탈라스와 대화
幫採藥者戴拉斯解開陷阱	Free Herbalist Talas from the trap	약초꾼 탈라스의 덫 풀어주기
魔族的鍋子	Demon Cauldron	마족의 솥
清除正在保護魔族的鍋子的保護膜	Remove the Protective Barrier around the Demon Cauldrons	마족의 솥을 보호하고 있는 보호막 제거
破壞魔族的鍋子	Destroy the Demon Cauldrons	마족의 솥 파괴
焚燒裝有毒草的箱子	Set the boxes of Poisonous Herbs on fire	독초가 든 상자 불태우기
向採藥者戴拉斯報告	Report to Herbalist Talas	약초꾼 탈라스에게 보고
救出	The Rescue	구출
跟著流動商人羅潔進入諾巴哈修道院	Follow Rose into the Novaha Monastery	행상인 로제를 따라 노바하 수도원으로 진입
與克羅亞村莊居民對話	Talk to the people of the Croa Village	크로아 마을 주민과 대화
解救被帶到安凱爾小會堂的修道士柯斯	Rescue Monk Goss at the Ankel Small Corridor	앙켈 소회당으로 끌려간 수도사 커스 구출
收集草綠幻影亡靈的精髓	Obtain Green Apparition Essence	초록 어패리션의 정수 수집
交給修道士柯斯	Deliver to Monk Goss	수도사 커스에게 전달
保護修道士柯斯，直到打開特別閱覽室的門為止	Protect Monk Goss until the door to the Special Reading Room is open	특별 열람실의 문을 열 때까지 수도사 커스 보호
與修道院入口的流動商人羅潔對話	Talk to Rose at the Novaha Monastery entrance	수도원 입구 쪽에 있는 행상인 로제와 대화
消滅來襲的木乃伊賈西特	Defeat the attacking Mummyghast	습격해오는 머미가스트 처치
疲累的身體	Exhausted	지쳐버린 몸
與實驗受害者提里斯對話	Talk to Experiment Victim Tilis	실험 피해자 틸리스와 대화
轉交恢復藥水	Give a Stamina Recovery Potion	회복 물약 전달
與實驗受害者提里斯對話	Talk to Experiment Victim Tilis	실험피해자 틸리스와 대화
向實驗受害者提里斯報告	Report to Experiment Victim Tilis	실험 피해자 틸리스에게 보고
消滅周圍的魔族	Defeat the demons nearby	주변에 있는 마족 처치
與實驗受害者皮爾斯對話	Talk to Experiment Victim Fils	실험 피해자 필스와 대화
收集實驗受害者的遺物	Collect Experiment Victims' Relic	실험 피해자들의 유품 수집
交給實驗受害者皮爾斯	Deliver to Experiment Victim Fils	실험 피해자 필스에게 전달
解救愛德文多斯	Rescue Edmundas	에드문다스 구출
與前去諾巴哈別館的流動商人羅潔對話	Follow Traveling Merchant Rose to the Novaha Annex	노바하 별관으로 간 행상인 로제와 대화
往阿沛卡儀典室的方向追上流動商人羅潔	Follow Rose into the Apega State Chamber	아페가 의전실로 행상인 로제 쫓아가기
去除讓愛德文多斯痛苦的因素	Eliminate the cause of Edmundas' pain	에드문다스를 고통스럽게 하는 원인 제거
破壞可疑魔法師召喚的痛苦魔法石	Destroy the Mysterious Wizard's Magic Stone of Pain	의문의 마법사가 소환한 고통의 마법석 파괴
尋找讓愛德文多斯掙脫的方法	Find a way to release Edmundas from the shackles	에드문다스를 속박에서 풀려날 방법 찾기
實驗	The Experiment	실험
與實驗受害者席爾貝斯對話	Talk to Experiment Victim Hilbeth	실험 피해자 힐베스와 대화
搜尋席爾貝斯的背包	Search for Hilbeth's Backpack	힐베스의 배낭 수색
交給實驗受害者席爾貝斯	Deliver to Experiment Victim Hilbeth	실험 피해자 힐베스에게 전달
搜索倒塌的大回廊	Search the Collapsed Grand Corridor	무너진 대회랑 수색
破壞殘留在艾勒傑經堂中的實驗設施	Destroy the remaining experiment facilities at the Errzze Oratorium	에르쩨 경당에 남아있는 실험 시설 파괴
修道士的最終使命	A Monk's Last Mission	수도사의 마지막 사명
與修道士阿貝爾斯對話	Talk to Monk Abels	수도사 아벨스와 대화
在卡伊雷禮拜堂回收聖物碎片	Retrieve Holy Relic Fragments at Gaile Chapel	가일레 예배소에서 성물 파편 회수
交給修道士阿貝爾斯	Deliver to Monk Abels	수도사 아벨스에게 전달
為淨化修道院設置聖物	Prepare the relic for purifying the monastery	수도원 정화를 위해 성물 설치
向修道士阿貝爾斯報告	Report to Monk Abels	수도사 아벨스에게 보고
解救羅潔	Rescue Rose	로제 구출
追趕前往諾巴哈本院解救羅潔的愛德文多斯	Follow Edmundas Into the Novaha Institute to rescue Rose	노바하 본원으로 로제를 구하러 간 에드문다스 쫓아가기
尋找能讓裝置超載的黑色物體	Find Black Materials to overload the device	장치를 과부화 시킬 수 있는 검은 물체 찾기
收集褐色賀敏勃德的黏液	Collect Brown Hummingbird Mucus	갈색 허밍버드의 점액 수집
交給愛德文多斯	Deliver to Edmundas	에드문다스에게 전달
消滅褐色賀敏勃德並收集黏液	Defeat Brown Hummingbirds to acquire mucus	갈색 허밍버드를 처치해 점액 수집
在本館中庭與愛德文多斯對話	Talk to Edmundas in the Main Hall Atrium	본관 아트리움에서 에드문다스와 대화
破壞精神支配水晶	Destroy the Mind Control Crystals	정신지배의 수정 파괴
與梅迪艾儀典室附近的愛德文多斯對話	Talk to Edmundas nearby the Medie State Apartments	메디에 의전실 근처의 에드문다스와 대화
在基爾努瑪經堂解救羅潔	Rescue Rose at the Kilnuma Oratorium	킬누마 경당에서 로제 구출
憂心忡忡的愛德文多斯	Edmundas' Worry	에드문다스의 걱정
消滅梅迪艾儀典室的怪物	Defeat monsters at the Medie State Apartments	메디에 의전실의 몬스터 처치
向愛德文多斯報告	Report to Edmundas	에드문다스에게 보고
把情況告訴歐勒夏的法師次級大師	Relay the situation to Orsha's Wizard Submaster	오르샤의 위저드 서브 마스터에게 사정 전달
製作保護結界水晶	Craft a Protection Barrier Crystal	보호 결계 수정 제작
設置保護結界水晶	Place the Protection Barrier Crystal	보호 결계 수정 설치
消除史特拉斯禮拜堂裡的孢子培養裝置動力源	Remove the power sources of the Giant Bracken Spore Breeding Device in Sotras Chapel	소트라스 예배소 안쪽의 포자 배양 장치 동력원 제거
聽流動商人羅潔說明詳情	Listen to Rose's detailed testimony	행상인 로제에게 자세한 이야기 듣기
消滅追殺伊魯曼塔斯的追蹤者	Defeat the one who chased Irmantas	이르만타스를 쫓아온 추격자 처치
斬斷尾巴	Cutting the Tail	꼬리자르기
用信號彈引誘追蹤者並消滅他們	Lure the chasers using the signal flare and defeat them	신호탄으로 추격자를 유인하여 처치
交給團員伊魯曼塔斯	Hand them over to Irmantas	단원 이르만타스에게 전달
消滅被信號彈陷阱引誘的追蹤者	Defeat the chasers that were lured to the signal flare trap	신호탄 덫에 유인된 추격자 처치
走到了死胡同	A Dead End	막다른 곳에 다다라
從某處傳來呼喚你的聲音。	You can hear some voice calling out for you somewhere	어디선가 당신을 부르는 소리가 들립니다.
將物品交給團員伊魯曼塔斯	Hand over the goods to Irmantas	단원 이르만타스에게 물품 전달
保護團員阿爾利那	Escort Alina	단원 알리나 호위하기
請護衛團員阿爾利那，好讓她能去找團員伊魯曼塔斯	Escort Alina so she can go to Irmantas safely	단원 알리나가 단원 이르만타스에게 무사히 갈 수 있도록 호위해주세요
請消滅追蹤者	Defeat the chasers	추격자를 처치하세요
消滅追蹤者狼人	Defeat Werewolf	추격자 웨어울프 처치
和朝聖者阿卡達斯對話	Talk to Pilgrim Agatas	순례자 아가타스와 대화
收集深藍香草	Collect Black Herbs	검푸른 허브 수집
帶給魔君主哈勃克	Hand it over to Demon Lord Hauberk	마군주 하우벅에게 전달
尋找自我的旅程	The journey to find myself	나를 찾는 여정
幫朝聖者阿卡達斯解毒	Detoxify the Pilgrim Agatas	순례자 아가타스 해독
收集影子精髓	Collect the Shadow Essences	그림자 정수 수집
獲得影子精髓	Obtain Shadow Essences	그림자 정수 획득
幫助哈勃克	Help Hauberk	하우벅 도와주기
在莎娜伊斯平荒野裡幫忙哈勃克再次結合	Help the reunion of Hauberk at Silaisvin Wilderness	살라이스빈 황야에서 하우벅의 재결합 돕기
消滅德拉涪里溫	Defeat Drapeliun	드라페리운 처치
無止盡的交易	Endless Deals	끝없는 거래
和侍從沃里亞對話	Talk to Squire Williya	스콰이어 윌리야와 대화
收集藍色塗料	Collect Blue Paint	파란 도료 수집
交給寬恕者艾里卡斯	Hand them over to Pardoner Erikas	파드너 에리카스에게 전달
尋找賈伊流斯勒肯的靈魂	Look for the spirit of Gailus Legwyn	가일류스 르귄의 영혼 찾기
和賈伊流斯勒肯的靈魂對話	Talk to the spirit of Gailus Legwyn	가일류스 르귄의 영혼과 대화
收集摩奇亞原野的摩奇亞根莖	Collect Mochia Stems at Mochia Fields	모치아 들판의 모치아 줄기 수집
交給賈伊流斯勒肯的靈魂	Hand them over to Gailus Legwyn	가일류스 르귄의 영혼에게 전달
尋找勒肯家的家臣	Look for the vassals of the Legwyn Family	르귄가의 가신 찾기
勒肯家的悲劇	Tragedy of the Legwyn Family	르귄가의 비극
收集邪惡的牙齒	Collect Corrupt Fangs	부정한 이빨 수집
獲得邪惡的牙齒	Obtained Corrupt Fangs	부정한 이빨 획득
消滅卡魯塔斯的獵人	Defeat Kartas Hunter	카르타스의 사냥꾼 처치
交給侍從沃里亞	Hand it over to Squire Williya	스콰이어 윌리야에게 전달
旅程的開端	The Journey Begins	여정의 시작
消滅猛攻而來的凱帕	Defeat the swarm of Kepas	몰려드는 케파 처치
使用屬性點數	Use a Status Point	스테이터스 포인트 사용
把草葉軟膏交給移居民雷伊拉	Deliver Grass Leaf Ointment to Settler Layla	이주민 레일라에게 풀잎 연고 전달
消滅襲擊歐勒夏移居管理所的波亞塔	Defeat the Poata attacking Orsha's Migration Office	오르샤 이주 관리소를 습격한 포아타 처치
消滅竹葉蟲並收集淡紅色葉子	Defeat Leaf Bugs to obtain Red Leaves	잎방개를 처치하여 연붉은 잎사귀 수집
把淡紅色葉子交給移居民伊茲納	Deliver the Red Leaves to Settler Izna	이주민 이즈나에게 연붉은 잎사귀 전달
消滅奇奈希並收集雷姆帕勒黏液	Defeat Chinencys to obtain Rampar Mucus	치넨시를 처치하여 렘파르 점액 수집
把雷姆帕勒黏液交給移居民伊茲納	Deliver the Rampar Mucus to Settler Izna	이주민 이즈나에게 렘파르 점액 전달
點燃阿達塔街道的營火	Make a bonfire on Adata Highway	아다타 가도의 모닥불 피우기
向移居民伊茲納報告	Report to Settler Izna	이주민 이즈나에게 보고
請在阿達塔街道地木柴堆上生火	Set fire to the firewood on Adata Highway	아다타 가도의 장작더미에 불 지피기
收集還可以用的物品	Collect Useful Object	쓸 만한 물건 수집
把還可以用的物品交給移居民伊巴那猶	Deliver the useful objects to Settler Ivanayus	이주민 이바나유에게 쓸 만한 물건 전달
膜拜藍圖魯瑪休憩地的澤米娜女神像	Worship the Statue of Goddess Zemyna at the Randoluma Rest Place	란돌루마 쉼터의 제미나 여신상에 경배
消滅藍圖魯瑪休憩地的怪物	Defeat Monsters at the Randoluma Rest Place	란돌루마 쉼터의 몬스터 처치
把藍圖魯瑪休憩地的移居民帶過來	Randoluma Rest Place	란돌루마 쉼터의 이주민 데려오기
膜拜中央廣場的奧施莉奈女神像	Worship the Statue of Goddess Ausrine in the Central Plaza	중앙 광장에 있는 아우슈리네 여신상에 경배
造訪商店街的雜貨商人	Visit the Item Merchant in the Shopping District	상점가의 잡화 상인 방문
造訪飾品商人	Visit the Accessory Merchant	악세서리 상인 방문
與加橋森林的情報員潔拉希亞對話	Talk to Agent Cherasia at the Woods of the Linked Bridges	덧댄다리 숲의 정보원 체라시아와 대화
收集祭司伊魯瑪的日誌散頁	Collect Priest Irma's Journal Pages	사제 이르마의 일지 낱장 수집
交給情報員潔拉希亞	Deliver to Agent Cherasia	정보원 체라시아에게 전달
協助摩連的調查	Help Agent Moren	모렌의 조사 돕기
從冒煙的草堆中收集線索	Collect clues from the Smoking Piles of Grass	연기나는 풀더미에서 단서 수집
交給情報員摩連	Deliver to Agent Moren	정보원 모렌에게 전달
迫近的危險	Imminent Danger	다가오는 위험
調查巨石臉丘陵	Investigate the Greate Stone Face Hill	큰바위얼굴 언덕 조사
查看不明日誌的內容	Read the Unknown Diary	알 수 없는 일지 내용 확인
交給追蹤者耶烏利斯	Deliver to Chaser Ulysses	추적자 예울리스에게 전달
和帕歐皮斯渡口的追蹤者塔爾巴希對話	Talk to Chaser Talbasi at Paupys Crossing	파우피스 나루의 추적자 탈바시와 대화
消滅茲部卡後院的怪物	Defeat the monsters at the Zbuka Inner Court	즈부카 안뜰의 몬스터 처치
向情報員佩勒尼普報告	Report to Agent Pierneef	정보원 페르니프에게 보고
對怪物使用亢奮劑	Use the stimulant on the monsters	몬스터에게 광분제 사용
消滅寶嵐林間小路的怪物	Defeat the monsters at Bonan Forest Road	보난 숲길의 몬스터 처치
破壞寶嵐林間小路裡的怪物巢穴	Destroy the Monster Nest in Bonan Forest Road	보난 숲길 안쪽의 몬스터 둥지 파괴
向追蹤者拉伊堤斯報告	Report to Chaser Raitis	추적자 라이티스에게 보고
交給追蹤者塔爾巴希	Deliver to Chaser Talbasi	추적자 탈바시에게 전달
收集祭司杰利亞的紙條	Collect Priest Gelija's Memos	사제 겔리아의 쪽지 수집
搜索帕瑟蘭隱居地 	Search the Paslaptis Hideout	파슬람 은거지 수색
和查里一起搜索祭司們的殘跡	Find the priests' traces with Jolly	잘리와 함께 사제들의 흔적 수색
解救在熊蔬丘陵被魔族抓住的祭司普拉那斯	Rescue Priest Pranas from the demons at Groundsle Hill	곰취 언덕에서 마족에게 붙잡혀 있는 사제 프라나스 구출
與歐勒夏的祭司普拉那斯對話	Talk to Priest Pranas in Orsha	오르샤에 있는 사제 프라나스와 대화
向情報員歐勒溫報告	Report to Agent Orwen	정보원 오르웬에게 보고
清除不祥的魔法陣	Remove the Ominous Magic Circles	불길한 마법진 제거
消滅鹿蹄空地的怪物	Defeat the monsters at the Deer Hooves Lot	사슴발굽 공터의 몬스터 처치
確認鹿蹄空地	Check out at the Deer Hooves Lot	사슴발굽 공터 확인
消滅灰色青苔泥人	Defeat Gray Golem	회색 골렘 처치
交給情報員諾圖雷斯	Deliver to Agent Notres	정보원 노토레스에게 전달
回收追蹤者們的行李	Collect Chaser Zegaus' Belongings	추적자들의 짐 회수
交給追蹤者傑卡烏斯	Deliver to Chaser Zegaus	추적자 제가우스에게 전달
把日誌的內容交給伊內沙黑蒙戴伊	Relay the journal's contents to Inesa Hamondale	이네사 해먼데일에게 일지의 내용 전달
與祭司普拉那斯會合	Join Priest Pranas	사제 프라나스와 합류
主教烏魯波納斯的行蹤	Bishop Urbonas' Whereabouts	주교 우르보나스의 행방
確認拷問器材室	Check the Torture Material Room	고문 자재실 확인
消滅猛攻而來的魔族	Defeat the incoming demons	몰려드는 마족 처치
向祭司普拉那斯報告詛咒人偶像的事	Report to Priest Pranas on the Cursed Idol	사제 프라나스에게 저주의 우상 보고
消滅突然襲擊的魔族	Defeat the attacking demons	급습한 마족 처치
前往主教烏魯波納斯留下的地圖上所標示的地方	Go to the location marked on the map left by Bishop Urbonas	주교 우르보나스가 남긴 지도에 표시된 곳으로 이동
與主教烏魯波納斯對話	Talk to Bishop Urbonas	주교 우르보나스와 대화
消滅魔族並補充還原寶珠	Defeat demons to recharge the Orb of Return	마족을 처치하여 환원의 보주 충전
破壞拷問器材室的詛咒人偶像	Destroy the Cursed Idol in the Torture Material Room	고문 자재실의 저주의 우상 파괴
消滅藍色杜瑪洛與藍色溫迪戈並補充還原寶珠	Defeat Blue Dumaros and Blue Wendigos to recharge the Orb of Return	푸른 듀마로와 푸른 웬디고를 처치하여 환원의 보주 충전
交給追蹤者圖勒巴納	Deliver to Chaser Torvana	추적자 토르바나에게 전달
來歷不明的包袱	Unidentified Package	정체불명의 꾸러미
獲得來歷不明的包袱	Obtain Unidentified Packages	정체불명의 꾸러미 습득
收集來歷不明的包袱	Collect Unidentified Packages	정체불명의 꾸러미 수집
使用來歷不明的包袱並確認效果	Use the Unidentified Packages to see their effect	정체불명의 꾸러미를 사용하여 효과 확인
跟著祭司普拉那斯前往亞夏克地牢2層	Follow Priest Pranas into Ashaq Underground Prison 2F	아샤크 지하 감옥 2층으로 사제 프라나스 따라가기
讓詛咒人偶像吸收魔族的魔力	Absorb demon magic into the Cursed Idol	저주의 우상에 마족의 마력 흡수
用還原寶珠破壞詛咒人偶像	Destroy the Cursed Idol with the Orb of Return	환원의 보주로 저주의 우상 파괴
救出被關在單人房區域的祭司伊魯瑪	Rescue Priest Irma from the Solitary Confinement District	독방 구역에 갇혀 있는 사제 이르마 구출
消滅溫迪戈逃犯並補充還原寶珠	Defeat Wendigo Escapees and charge the Orb of Return	웬디고 탈주범을 처치하여 환원의 보주 충전
交給祭司伊魯瑪	Deliver to Priest Irma	사제 이르마에게 전달
用水晶的力量強化寶珠	Strengthen the Orb with the Crystal's Power	수정의 힘으로 보주 강화
在亞夏克地牢3層與祭司伊魯瑪對話	Talk to Priest Irma at Ashaq Underground Prison 3F	아샤크 지하 감옥 3층에서 사제 이르마와 대화
收集閃亮珍珠粉	Collect Twinkling Pearl Powder	반짝이는 진주 가루 수집
交給祭司亞烏拉那斯	Deliver to Priest Auranas	사제 아우라나스에게 전달
消滅寶珠所指向的魔族	Defeat the demons marked by the Orb	보주가 가리킨 마족 처치
消滅寶珠所指向的魔族	Defeat the demons marked by the Orb	보주가 가리키는 마족 처치
消滅特別受刑區域的怪物	Defeat the monsters in the Special Prison District	특별 수형 구역의 몬스터 처치
向祭司德拉茲尼報告	Report to Priest Draznie	사제 드라즈니에에게 보고
解放第2監視塔路上的祭壇的氣息	Release the Altar Spirit on your way to the Second Watchtower	제2 감시탑 가는 길의 제단의 기운 해방
解放祈禱室的祭壇氣息	Release the Altar Spirit in the Prayer Room	기도실의 제단 기운 해방
破壞第2監視塔的詛咒人偶像	Destroy the Cursed Idol in the Second Watchtower	제 2 감시탑의 저주의 우상 파괴
交給亞夏克地牢1層的主教烏魯波納斯	Deliver to Priest Urbonas at Ashaq Underground Prison 1F	아샤크 지하 감옥 1층의 주교 우르보나스에게 전달
返回歐勒夏與領主伊內沙黑蒙戴伊對話	Return to Orsha and talk to Inesa Hamondale	오르샤로 돌아가 영주 이네사 해먼데일과 대화
收集馬魯若斯的紋章	Collect Marnox's Insignia	마르녹스의 문양 수집
轉交給祭司杰利亞	Deliver to Priest Gelija	사제 겔리야에게 전달
回收祭司杰利亞的藥袋	Retrieve Priest Gelija's Medicine Pouch	사제 겔리야의 약 주머니 회수
用被聖水浸濕的布淨化詛咒人偶像碎片	Purify the Cursed Idol with the Holy Water Cloth	성수에 적신 천으로 저주의 우상 조각 정화
確認3層淨化裝置	Check the Purifier in 3F	3층 정화장치 확인
收集水晶的魔力	Collect Crystal Magic	수정의 마력 수집
為3層淨化裝置供給動力	Supply energy to the 3F Purifier	3층 정화장치에 동력 공급
除掉高原甜菜根莖	Remove the Plateau Sugar Beet Stems	고원 사탕무 줄기 제거
捕捉周圍的怪物	Dealing with Nearby Monsters	주변의 몬스터 사냥
向守望者莫里報告	Report to Watcher Molly	파수꾼 모리에게 보고
回收不良陷阱	Collect Faulty Traps	불량 함정 회수
把不良陷阱還給祭司特拉斯尼艾	Return the Faulty Traps to Priest Draznie	사제 드라즈니에에게 불량 함정 반납
亞夏克地牢3層的祭司杰利亞正等著某人的幫助。	Priest Gelija is waiting for help in Ashaq Underground Prison 3F	아샤크 지하 감옥 3층의 사제 겔리야가 누군가의 도움을 기다리고 있습니다.
消滅巴普	Varv Extermination	바브 박멸
向祭司杰利亞報告	Report to Priest Gelija	사제 겔리야에게 보고
收集湛藍煤炭	Collect Blue Coal	푸른 석탄 수집
將湛藍煤炭轉交給流動商人	Deliver the Blue Coal to the Merchant	행상인에게 푸른 석탄 전달
收集寶珠結晶	Collect Orb Crystals	보주 결정 수집
向追隨者巴伊杜堤斯報告	Report back to Follower Vaidutis	추종자 바이두티스에게 보고
向史學家凱佩克報告	Report back to Historian Kepeck	사학자 케펙에게 보고
史學家 葛利努斯對話	Talk to Historian Grenus	사학자 그리누스와 대화
尋找被磨損的古代文件	Find Worn Ancient Scriptures	마모된 고대 자료 찾기
向史學家 葛利努斯報告	Report back to Historian Grenus	사학자 그리누스에게 보고
與金石學者黛爾特蘭對話	Talk to Epigraphist Deltlan	금석학자 델트란과 대화
向金石學者黛爾特蘭報告	Report back to Epigraphist Deltlan	금석학자 델트란에게 보고
消滅克巴伊拉斯森林的怪物	Defeat monsters at Kvailas Forest	크바일라스 숲의 몬스터 처치
向信徒卡基斯報告	Report back to Believer Kazis	신도 카지스에게 보고
淨化被汙染的氣息	Cleansing the Defiling Energies	오염된 기운 정화
向信徒普羅紐斯報告	Report Back to Believer Bronius	신도 브로뉴스에게 보고
裂嘴菌菇獸的法杖碎片 收集	Collect Lapasape Wand Fragments	라프세이프의 지팡이 조각 수집
轉交給泰斯	Take the Fragments to Tess	테스에게 전달
乾枯的達達尼亞葉子 收集	Collect Dry Dadania Leaves	마른 다다니아 잎사귀 수집
轉交給採藥者塔拉斯	Report back to Herbalist Talas	약초꾼 탈라스에게 전달
救出被怪物吞下去的靈魂	Rescue Spirits Taken by the Monsters	몬스터에게 삼켜진 영혼 구출
向憂鬱的貓頭鷹雕像報告	Report back to the Gloomy Owl Sculpture	우울한 부엉이 조각상에게 보고
救出被吞噬的靈魂	Free the Swallowed Spirits	삼켜진 영혼 구출
微弱的貓頭鷹雕像對話	Talk to the Frail Owl Sculpture	미약한 부엉이 조각상과 대화
獲取	Retreiving Fading Spirits	미약한 영혼 거두기
轉交給微弱的貓頭鷹雕像	Return to the Frail Owl sculpture	미약한 부엉이 조각상에게 전달
和村長的孫女對話	Talk to the Elder's Granddaughter	촌장의 손녀와 대화
轉交給村長的孫女	Report Back to the Mayors' Granddaughter	촌장의 손녀에게 전달
向助手艾伊里奈報告	Report back to Assistant Airine	조수 아이리네에게 보고
開墾民羅德納斯對話	Talk to Settler Rodonas	개척민 로도나스와 대화
向開墾民羅德納斯報告	Report back to Settler Rodonas	개척민 로도나스에게 보고
無精打采的警備兵對話	Talk to the Tired Soldier	기운 빠진 경비병과 대화
獲得髒兮兮的包袱	Obtain Dirty Pouches	꼬질꼬질한 꾸러미 획득
向無精打采的警備兵報告	Report to the Tired Soldier	기운 빠진 경비병에게 보고
王陵守護者對話	Talk with the Royal Mausoleum Guardian	왕릉 수호자와 대화
拉泰露斯對話	Talk to Laterous	라테루스와 대화
掃蕩周圍的怪物	Deal with the monsters from the surrounding area	주변 몬스터 소탕
向拉泰露斯報告	Report back to Laterous	라테루스에게 보고
回收守護者的的精髓	Retrieve the Guardian's Essence	수호자의 정수 회수
向王陵守護者報告	Report back to the Royal Mausoleum Guardian	왕릉 수호자에게 보고
流浪信徒的靈魂對話	Talk to the Wandering Spirit of a Believer	떠도는 신도의 영혼과 대화
向流浪信徒的靈魂報告	Report back to the Wandering Spirit of a Believer	떠도는 신도의 영혼에게 보고
追隨者 內特爾諾斯對話	Talk to Follower Nedluss	추종자 네들러스와 대화
破壞莊園魔力裝置	Destroy the magic devices at the Manor	장원 마력장치 파괴
向追隨者 內特爾諾斯報告	Report back to Follower Nedluss	추종자 네들러스에게 보고
與追隨者比斯對話	Talk to Follower Bigs	추종자 빅스와 대화
收集濃縮的魔氣	Collect Condensed Magic	응축된 마기 수집
向追隨者比斯報告	Report back to Follower Bigs	추종자 빅스에게 보고
朝聖者 賽羅尼亞對話	Talk to Pilgrim Seronia	순례자 세로니야와 대화
向朝聖者賽羅尼亞報告	Report back to Pilgrim Seronia	순례자 세로니야에게 보고
與啟示者米歇爾對話	Talk to Revelator Mihail	계시자 미하일과 대화
消滅小豬伊米特	Defeat the Pag Emitter	페이그 이미터 처치
向啟示者米歇爾報告。	Report to Revelator Mihail	계시자 미하일에게 보고
與啟示者庫奈對話	Talk to Revelator Connor	계시자 코너와 대화
收集馬羅爾魯之草	Collect Maroulu Herbs	마롤루 풀 수집
向啟示者庫奈報告	Report back to Revelator Connor	계시자 코너에게 보고
農民戴爾琉瑪對話	Talk to Farmer Deluma	농민 델류마와 대화
被藏起來的農具收集	Collect the hidden farming tools	숨겨둔 농기구 수집
回到農民戴爾琉瑪那裡	Go back to Farmer Deluma	농민 델류마에게 돌아가기
回收祭物包袱	Retrieve the Offering Pouches	제물 꾸러미 회수
邪靈術師特拉修斯報告	Report back to Necromancer Drasius	사령술사 드라슈스에게 보고
樵夫魯爾法對話	Talk to Lumberjack Luoval	나무꾼 루오발과 대화
向樵夫魯爾法報告	Report back to Lumberjack Luoval	나무꾼 루오발에게 보고
消滅利艾斯那禮拜堂的怪物	Deal with the monsters at Leipsna Chapel Site	리엡스나 예배소 터의 몬스터 처치
祭司蘿芙莉對話	Talk to Priest Rovli	사제 로블리와 대화
教訓雪貂	Teach the Ferrets a lesson	페릿 혼내주기
向祭司蘿芙莉報告	Report back to Priest Rovli	사제 로블리에게 보고
消滅雪貂	Defeat the ferrets	페릿 처치
女信徒德蕾卡對話	Talk to Believer Dreka	여신도 드레카와 대화
採集賽伊拉葉片	Collect Ceyral Saplings	세이랄 떡잎 채집
回到女信徒德蕾卡那裡去	Return to Believer Dreka	여신도 드레카에게 돌아가기
商人托爾納斯對話	Talk to Merchant Dolonas	상인 돌로나스와 대화
向商人托爾納斯報告	Report back to Merchant Dolonas	상인 돌로나스에게 보고
與回收組員對話	Talk to the Collection Member	회수 조원과 대화
挖掘凡納莉爾碑石	Excavate Manaryll Tombstones	만나릴 비석 발굴
在帕歐皮斯渡口消滅怪物	Defeat monsters in Paupys Crossing	파우피스 나루에서 몬스터 처치하기
消滅赤紅凱帕	Defeat Red Kepas	붉은 케파 처치
消滅烏汀	Defeat Woodins	우딘 처치
攻擊劍練習台證明你的本領	Hit the Sword Pell to prove your strength	검 연습대를 공격하여 완력 증명
消滅帕歐皮斯渡口的烏汀	Defeat Woodins in Paupys Crossing	파우피스 나루의 우딘을 처치하기
取回獠牙豬的犬齒和沒被弄濕的木材	Collect Pokuborn Tusks and Dry Wood	포쿠본의 엄니와 젖지 않은 목재 구해오기
消滅波庫布與獠牙豬	Defeat Pokubus and Pokuborns	포쿠부와 포쿠본 처치
點燃聖火台	Set fire to the Flameholder	성화대 점화
在達坦森林消滅高沙盧	Defeat Gosarus in the Dadan Jungle	다단 숲에서 고사루 처치
消滅高沙盧	Defeat Gosaru	고사루 처치
在裝備盾牌的狀態下消滅達坦森林的怪物	Defeat monsters it the Dadan Jungle with a shield equipped	방패를 착용한 상태에서 다단 숲의 몬스터들을 처치
在達坦森林消滅拉普利	Defeat Rafflys at the Dadan Jungle	다단 숲에서 라플리 처치
消滅拉普利	Defeat Raffly	라플리 처치
消滅達坦森林的高沙盧	Defeat Gosarus in the Dadan Jungle	다단 숲의 고사루 처치
使用軟膏為蓮帕拉沙池塘的難民治療	Use the ointment to heal refugees at Lemprasa Pond	연고로 렘파라사 연못의 피난민들 치료
參拜歐勒夏周圍的所有女神像	Worship all Goddess Statues around Orsha	오르샤 주변의 모든 여신상 참배
收集製作膏藥的藥草	Collect herbs for the ointment	고약을 만들 약초 수집
收集材料製作邪靈祭司人偶	Collect materials and craft a Bokor Doll	재료를 모아 보코르 인형 제작
請向達坦森林的克魯莫收集金屬塊	Collect chunks of metal from Grummers at Dadan Jungle	다단 숲의 그루머에게서 금속 덩어리 모으기
交給歐勒夏鐵匠	Deliver to the Orsha Blacksmith	오르샤 대장장이에게 전달
用高地戰士的技術消滅任一怪物	Defeat monsters using Highlander techniques	하이랜더의 기술로 무작위 몬스터 처치
消滅諾巴哈別館的史潘飛行獸人	Defeat Sparnasman at the Novaha Annex	노바하 별관의 스파나스맨 처치
轉交怪物血液	Deliver the monster's blood	몬스터의 혈액을 전달
收集史潘飛行獸人的角	Collect Sparnasman's Horn	스파나스맨의 뿔 수집
交給雕刻師次級大師	Deliver to the Dievdirbys Submaster	딥디르비 서브 마스터에게 전달
收集已注入聖者大師氣息的怪物靈魂	Collect monster souls imbued with the Sadhu Master's spirit	사두 마스터의 기운을 주입한 몬스터의 영혼 수집
與魔法師梅西歐拉斯對話	Talk to Mage Melchioras	마법사 멜히오라스와 대화
使用羅盤探尋隱藏的加工品	Use the compass to search for hidden artifacts	나침반을 사용해 숨겨진 아티팩트 탐색
向魔法師梅西歐拉斯報告	Report to Mage Melchioras	마법사 멜히오라스에게 보고
消滅魔族並為晶球補充魔力	Defeat demons and charge the Magic Concentration Orbs	마족을 처치해 구슬에 마력 충전
轉交給啟示者米歇爾	Deliver to Revelator Mihail	계시자 미하일에게 전달
解除已找到物品的保護咒語	Release the objects' protection spell	찾아낸 물건의 보호 주문 해제
在魔力供給裝置周圍設置充滿魔力的晶球	Place the Magic Concentration Orbs on the Magic Power Supply Device	마력 공급 장치 주변에 마력이 충만한 구슬 설치
移動至德慕爾莊園	Go to Delmore Manor	델무어 장원으로 이동
與追隨者安德雷雅對話	Talk to Follower Andrea	추종자 안드레아와 대화
收集小豬艾普羅的情報	Collect data from Pag Amplers	페이그 앰퓰러 정보 수집
收集德慕爾城居民阿雷德爾的日記	Collect the diary of Delmore Castle resident Ardel	델무어 성 주민 아르델의 일기 수집
轉交給追隨者安德雷雅	Deliver to Follower Andrea	추종자 안드레아에게 전달
與追隨者路歐達斯對話	Talk to Follower Nuodas	추종자 누오다스와 대화
向恰庫沃克收集可用的箭	Collect arrows from Charcoal Walkers	차콜 워커에게서 쓸 만한 화살 수집
交給追隨者路歐達斯	Deliver to Follower Nuodas	추종자 누오다스에게 전달
在城壁重建區域搜索魔力供給裝置 	Search for a Magic Power Supply Device at the Rampart Reconstruction District	성벽 재건 구역에서 마력 공급 장치 수색
到被埋沒的廣場搜索魔力供給裝置	Search for a Magic Power Supply Device at the Buried Central Plaza	매몰된 광장의 마력 공급 장치 수색
在工房街搜索魔力供給裝置	Search for a Magic Power Supply Device at the Handicraft Workshop Road	공방 거리에서 마력 공급 장치 수색
阻止帕爾瑪廣場的啟示者雅奈	Stop Revelator Yane at the Palma Central Plaza	팔마 광장의 계시자 야네 저지
追趕啟示者雅奈並移動至德慕爾外城	Follow Yane into the Delmore Outskirts	계시자 야네를 쫓아 델무어 외성으로 이동
從箱堆中拆下可用的木板	Obtain Useful Wooden Boards from Box Piles	상자더미에서 쓸 만한 판자 떼어내기
與追隨者約志對話	Talk to Follower Wedge	추종자 웨지와 대화
收集針刺蘑菇	Collect Thorn Mushrooms	기시 버섯 수집
交給追隨者約志	Deliver to Follower Wedge	추종자 웨지에게 전달
收集查洛克的體液	Collect Charog Sap	차로그의 진액을 수집
追擊德慕爾城主	Chasing Lord Delmore	델무어 성주 추격
與啟示者雅奈對話	Talk to Revelator Yane	계시자 야네와 대화
要求啟示者米歇爾同行	Ask Revelator Mihail to accompany you	계시자 미하일에게 동행 요청
往外城廣場的方向追擊德慕爾魯巴因	Chase Delmore Rephaim to the Outskirts Central Plaza	외성 광장으로 델무어 르바임 추격
逃出德慕爾魯巴因的結界	Escape from Delmore Rephaim's trap	델무어 르바임의 결계 탈출
在泰吉卡岔路與啟示者雅奈一行人會合	Join Yane's group at the Tagika Crossroads	타지카 갈림길에서 계시자 야네 일행과 합류
前往官廳廢墟	Go to the Government Ruins	관청 폐허로 이동
向咒術人偶注入魔族的靈魂	Collect Demons Souls in the Shaman Doll	주술 인형에 마족의 영혼 수집
交給啟示者雅奈	Deliver to Revelator Yane	계시자 야네에게 전달
逼入絕境	Lead to a Dead-end	막다른 곳으로 몰다
前往歐達金卡斯空地追擊德慕爾魯巴因	Chase Delmore Rephaim to the Odaginkas Vacant Lot	오다깅카스 공터로 델무어 르바임 추적
前往歐達金卡斯空地追擊德慕爾魯巴因	Chase Delmore Rephaim to the Odaginkas Vacant Lot	오다깅카스 공터로 델무어 르바임 추격
保護設置炸彈的米歇爾	Protect Mihail while he sets up the bomb	폭탄을 설치하는 미하일 보호
阻止德慕爾魯巴因	Stop Delmore Rephaim	델무어 르바임 저지
破壞克魯比那備用製造裝置	Destroy all reserve Kruvina devices	크루비나 예비 제조 장치 파괴
將汙穢的魔力注入魔力供給裝置	Inject demonic power into the Supply Device	마력 공급 장치에 부정한 마력 주입
向啟示者雅奈報告	Report to Revelator Yane	계시자 야네에게 보고
向暗黑麥茲收集魔力增幅器	Collect Magic Amplifiers from Black Maizes	검은 마이즈에게서 마력 증폭기 수집
和邪靈祭司尤塔對話	Talk to Bokor Juta	보코르 유타와 대화
向邪靈祭司尤塔報告	Report to Juta	보코르 유타에게 보고
消滅周圍怪物	Defeat nearby monsters	주위 몬스터 처치
破壞亡者之棺	Destroy the coffins of the dead	망자의 관 파괴
與守墓人希奇斯對話	Talk to Grave Keeper Sigis	묘지기 시기스와 대화
將重生亡者火葬	Cremate the resurrected dead	되살아난 망자를 화장시키기
詭異的聖所	Suspicious Sanctum	수상한 성소
從守墓人的箱子裡拿出咒術人偶	Pull out the spell doll from the box of the grave keeper	묘지기의 상자에서 주술인형 꺼내오기
將守墓人的咒術人偶交給希奇斯	Hand over the Grave Keeper's Spell Doll to Sigis	묘지기의 주술인형을 시기스에게 전달
調查真理之樹教壇所製作的女神聖物	Investigate the goddess' holy relic which was created by the Order of the Tree of Truth	진리의 나무 교단이 만들었다는 여신의 성물 조사
向守墓人希奇斯報告	Report to Grave Keeper Sigis	묘지기 시기스에게 보고
調查真理之樹教壇裡製作的女神聖物	Investigate the holy relic which was created by the Order of the Tree of Truth	진리의 나무 교단에서 만든 여신의 성물 조사
調查卡拉伊爾陵墓	Investigate Carlyle's Mausoleum	칼라일 영묘 조사
與信徒金塔斯對話	Talk to Believer Gintas	신도 긴타스와 대화
將填滿的邪念石交給信徒金塔斯	Hand over the stone to Gintas	가득 채운 사념석을 신도 긴타스에게 전달
火化重生的信徒	Cremate the believers who has resurrected	되살아난 신도 화장하기
和出現的信徒靈魂對話	Talk to the Believer's Spirit that appeared	나타난 신도의 영혼과 대화
和信徒的靈魂對話	Talk to the spirit of the Believer	신도의 영혼과 대화
和馬勒奇利斯對話	Talk to Margiris	마르기리스와 대화
被金塔斯認可為教壇的一員之後，回去找馬勒奇利斯	Meet with Margiris after you are acknowledged as a member of the Order by Gintas	긴타스에게서 교단의 일원으로 인정받은 뒤 마르기리스 찾아가기
審問卡拉伊爾	Interrogate Carlyle	칼라일 심문하기
不知道為什麼卡拉伊爾拒絕與教壇對話。	Carlyle refuses to talk with the Order	칼라일은 어째서인지 교단과 대화를 거부하고 있다고 합니다.
卡拉伊爾的測試	Carlyle's Test	칼라일의 시험
和卡拉伊爾的靈魂對話	Talk to Carlyle's Spirit	칼라일의 영혼과 대화
破壞教壇的聖物	Destroy the Holy Relic of the Order	교단의 성물 파괴
消滅露出真面目的馬勒奇利斯	Defeat Margiris that has shown its true nature	본 모습을 드러낸 마르기리스 처치
收集隱藏的莊園持有者名單	Collect the list of the owners who own a hidden manor	숨겨진 장원 소유자 명단 모으기
將莊園持有者名單交給卡拉伊爾的靈魂	Hand over the lists of the manor owners to Carlyle's Spirit	칼라일의 영혼에게 장원 소유자 명단 전달
收集邪惡魔法的痕跡	Collect the traces of the evil magic	사악한 마법의 흔적 수집
燒掉莊園持有者名單	Burn the Manor Owner List	장원 소유자 명단 불태우기
和德魯伊蕾雅對話	Talk to Druid Leja	드루이드 레야와 대화
重新找回雪貂偷走的糧食	Bring back the stolen food from the ferrets	페릿이 훔쳐간 식량 되찾기
和神秘的少女相遇	Meeting with the mysterious girl	신비한 소녀와 조우
和村莊村長對話	Talk to the Village Headman	마을 촌장과 대화
破壞魔族圖騰	Destroy the demonic totem	마족 토템 파괴
和村民對話	Talk to the villager 	마을 주민과 대화
詢問村民是否有需要幫忙的地方。	Ask the villager if there's anything you can help with	마을 주민에게 도울 일이 없는지 알아보세요.
調味	Put the spices	양념 치기
和平雕像	The Sculpture of Peace	평화의 조각상
和村長孫子對話	Talk to the Elder's grandchild	촌장 손자와 대화
和雕刻師威塔斯對話	Talk to Dievdirbys Widas	딥디르비 위다스와 대화
指引的少女	The Guiding Girl	인도하는 소녀
尋找神秘少女的痕跡	Look for the traces of the mysterious girl	신비한 소녀의 흔적 찾기
消滅雪貂搜索少女的痕跡	Defeat the ferrets and find a trace of the girl	페릿을 처치하며 소녀의 흔적 수색
消失的少女	The Missing Girl	사라진 소녀
採集朦朧草	Collect the herbs	몽롱초 채집
女神的安排	The Goddess' Assignment	여신의 안배
和神秘的少女對話	Talk to the Mysterious Girl	신비한 소녀와 대화
查看女神的寶珠	Examine the Goddess' Orb	여신의 보주 살펴보기
和德魯伊貝尼斯對話	Speak with Druid Benes	드루이드 베네스와 대화
收集雪貂行動模式	Record the behaviors of the ferrets	페릿 행동양식 수집
把卷軸交給德魯伊貝尼斯	Deliver the Scroll to Druid Benes	드루이드 베네스에게 주문서 전달
了解雪貂的內心	Understanding the ferrets	페릿의 속내 알아내기
無法相信的現實	Unbelievable Reality	믿을 수 없는 현실
無法相信的現實	Unbelieveable Reality	믿을수 없는 현실
和女神拉達對話	Speak with Goddess Lada	여신 라다와 대화
和拉達女神對話	Speak with Goddess Lada	라다 여신과 대화
破壞克魯比那控制裝置	Destroy the Kruvina Suppressor	크루비나 제어장치 파괴
破壞不完整的克魯比那	Destroy Incomplete Kruvina	불완전한 크루비나 파괴
神殿復原準備	Temple Rebuilding Preparation	신전 복구 준비
和村莊祭司對話	Speak with the Village Priest	마을 사제와 대화
消滅魔族	Defeat the demons	마족 퇴치
陷入危機的奎波爾	Kupole in Danger	위기의 큐폴
到科諾特樹林跟奎波爾 梅德納對話	Talk to Kupole Medena at Khonot Forest	코노트 숲에서 큐폴 메데나와 대화
稻泰芙林 鐘乳洞第1區跟奎波爾 梅德納對話	Talk to Kupole Medena at Tevhrin Stalactite Cave Section 1	테브린 종유동 1구역의 큐폴 메데나와 대화
奎波爾 梅德納對話	Talk to Kupole Medena	큐폴 메데나와 대화
消滅襲擊泰芙林鐘乳洞的怪物	Defeat the Monsters Attacking the Cave	테브린 종유동을 습격해온 몬스터 처치
被封印的女神傳說	The Legend of the Goddess' Seal 	봉인된 여신 전설
前往移動魔法陣	Go to the Teleportation Magic Circle	이동 마법진으로 이동
奎波爾 特理亞對話	Talk to Kupole Trija	큐폴 트리아와 대화
收集破碎的魔力核碎片	Collect the Pieces of the Broken Magic Core	깨진 마력핵 조각 모으기
前往女神的安息處	To the Goddess' Refuge	여신의 안식처로
收集散落四處的魔力核	Gather the Scattered Magic	흩어진 마력 모으기
消滅綠色噗拉取得散佈四處的魔力	Defeat Green Flaks to Collect the Scattered Magic	초록 플락을 처치 해 흩어진 마력 찾기
消滅綠色噗拉	Defeat Green Flaks	초록 플락 처치
淨化魔族邪惡的精髓	Purify the Demons' Evil Essence	마족의 사악한 정수 정화
復原魔法陣的同時保護 奎波爾 特理亞	Protect Kupole Trija Restoring the Magic Circle	마법진이 복구되는 동안 큐폴 트리아 보호
不間斷的騷擾	Constant Interference	빈틈 없는 방해
朝泰芙林 鐘乳洞 第2區移動	Go to Tevhrin Stalactite Cave Section 2	테브린 종유동 2구역을 향해 이동
說服奎波爾 特理亞並帶來魔力核	Convince Kupole Trija and Get the Magic Core	큐폴 트리아를 설득하여 마력핵 가져오기
利用魔力核將被堵住的通路破壞	Use the Magic Core to Clear the Path	마력핵을 이용하여 막힌 통로 파괴
被洗腦的部族	Brainwashed Tribe	세뇌당한 부족
掌握了達拉部族的項鍊	Obtain Tala Tribe Necklaces	탈라 부족의 목걸이 습득
搶奪達拉部族的項鍊	Steal the Tala's Necklaces	탈라 부족 목걸이 빼앗기
淨化達拉部族的項鍊	Purify the Tala Necklaces	탈라 부족의 목걸이 정화
將淨化過的項鍊補充給達拉部族	Place the Purified Necklaces Back on the Tala	탈라 부족에게 정화된 목걸이 채우기
漸漸衰弱的氣息	Weakening Aura	미약해지는 기운
找尋其他的奎波爾	Look for the Other Kupole	다른 큐폴 수색
奎波爾 艾雷那對話	Talk to Kupole Alena	큐폴 알레나와 대화
又一個奎波爾	Another Kupole	또 다른 큐폴
搜尋又一個奎波爾	Search for Another Kupole	또 다른 큐폴 수색
奎波爾 賽力亞對話	Talk to Kupole Serija	큐폴 세리야와 대화
救出奎波爾	Kupole Rescue Mission	큐폴 구출
破壞束縛裝置	Destroy the Restraining Device	구속 장치 파괴
破壞第2個束縛裝置	Destroy the Second Restraining Device	두번째 구속 장치 파괴
掌握魔族的魔石	Obtain Demon Magic Stones	마족의 마석 습득
破壞第3個束縛裝置	Destroy the Third Restraining Device	세번째 구속 장치 파괴
掌握恢復的球體 	Obtain Materialized Recovery	회복의 구체 습득
移動到泰芙林 鐘乳洞 第3區去	Go to Tevhrin Stalactite Cave Section 3	테브린 종유동 3구역으로 이동
收集恢復的氣息	Gather Recovering Energy	회복의 기운 수집
恢復的球體	Materialized Recovery	회복의 구체
危險的會面	Dangerous Encounter	위험한 만남
移動至女神被封印的所在地	Go to the Goddess Seal	여신이 봉인된 장소로 이동
啟動關閉的裝置	Activate the Lockout Device	폐쇄 장치 가동
被黑暗吞噬的奎波爾	Kupole in the Darkness	어둠에 물든 큐폴
淨化被黑暗吞噬的奎波爾	Purify the Kupole in the Darkness	어둠에 물든 큐폴 정화
協助淨化奎波爾的儀式進行	Assist the Kupoles' Purification Ceremony	큐폴의 정화 의식 돕기
發瘋的女神	Deranged Goddess	미쳐버린 여신
女神達莉雅對話	Talk to Goddess Dalia	여신 달리아와 대화
採集神秘的苔蘚	Gather the Mysterious Moss	신비로운 이끼 채집
回到奎波爾 賽力亞那裡去	Return to Kupole Serija	큐폴 세리야에게 돌아가기
消滅史塔拉坎	Defeat Starlakhan	스탈라칸 처치
移動至泰芙林 鐘乳洞第4區	Go to Tevhrin Stalactite Cave Section 4	테브린 종유동 4구역으로 이동
奎波爾 席烏太對話	Talk to Kupole Siute	큐폴 시우테와 대화
補充保護魔法	Recharge the Protective Magic	보호 마법 충전
最後的機會	Before It's Too Late	더 늦기 전에
找尋女神達莉雅	Search for Goddess Dalia	여신 달리아 수색
關閉魔族的傳點	Destroy the Demon Portal	마족의 포탈 폐쇄
到底躲去哪了呢？	They Hid Her	어디에 숨겼을까
掌握綠色喬雷的核	Obtain Green Zolem Cores	초록 졸렘의 핵 습득
寶護奎波爾 賽力亞	Protect Kupole Serija	큐폴 세리야 보호
使用淨化過的喬雷的核來收集魔族的記憶	Use the Purified Zolem Cores to Collect Demon Memories	정화된 졸램의 핵 사용하여 마족의 기억 수집
往泰芙林 鐘乳洞 第5區移動	Move to Tevhrin Stalactite Cave Section 5	테브린 종유동 5구역을 향해 이동
移動至泰芙林 鐘乳洞 第5區	Go to Tevhrin Stalactite Cave Section 5	테브린 종유동 5구역으로 이동
消滅綁架女神的魔族	Defeat the Demons That Abducted the Goddess	여신을 납치한 마족 처치
借用女神的力量	With the Power of the Goddess	여신의 힘을 빌려
吸收薩勒的力量	Absorb Saule's Power	사울레의 힘 흡수
消滅綠色喬雷	Defeat Green Zolems	초록 졸렘 처치
收集邪惡符咒	Collect Evil Talismans	사악한 부적 수집
關閉魔族的傳點	Destroy the Demon Portal	마족 포탈 폐쇄
在魔王到達之前	Before the Demon King Arrives	마왕이 도착하기 전에
透過奎波爾 梅德納與女神 達莉雅對話	Speak to Goddess Dalia Through Kupole Medena	큐폴 메데나를 통해 여신 달리아와 대화
確認強大力量的身份	Find the Source of Powerful Energy	강력한 힘의 정체 확인
破壞最後邪惡的	Destroy the Last Evil Statue	마지막 사악한 우상 파괴
啟動輔助裝置	Activate the Auxiliary Devices	보조 장치 작동
啟動驅魔裝置	Start the Exorcising Device	구마 장치 작동
強力的存在	Powerful Being	강력한 존재
和魔王傑斯堤對話	Talk to Demon Queen Gesti	마왕 제스티와 대화
觀察魔王傑斯堤	Examine Demon Queen Gesti	마왕 제스티 살펴보기
女神的犧牲	The Goddess' Sacrifice	여신의 희생
阻止魔王傑斯堤	Defeat Demon Queen Gesti	마왕 제스티 저지
奎波爾 梅德納的上方	Comfort Kupole Medena	큐폴 메데나 위로
找尋散落四處的達莉雅的靈魂	Search for Dalia's Scattered Spirit	흩어진 달리아의 영혼 수색
與達莉雅的靈魂對話	Talk to Dalia's Spirit	달리아의 영혼과 대화
尋找警備兵里恩	Find Sentinel Rian	경비병 리엔 찾기
被汙染的湖水	The Corrupted Lake	오염된 호수
和村長安洛伊查斯對話	Talk to Elder Aloizard	촌장 알로이자스와 대화
調查漂浮聖地	Investigate the Wandering Sanctuary	떠도는 성소 조사
把日誌交給村長孫女	Deliver the diary to the Elder's Granddaughter	촌장 손녀에게 일지 전달
尋找村長安洛伊查斯	Search for Elder Aloizard 	촌장 알로이자스 수색
尋找老舊的圓盤所指的東西	Look for the spot signaled by the Old Disc	낡은 원판이 가리키는 것 찾기
交給村長安洛伊查斯	Deliver to Elder Aloizard	촌장 알로이자스에게 전달
與村長孫女對話	Talk to the Elder's Granddaughter	촌장 손녀와 대화
與安森塔水源地的村長安洛伊查斯對話	Talk to Elder Aloizard at the Absenta Reservoir	압셈타 수원지의 촌장 알로이자스와 대화
獻給女神的貢品	Offerings to the Goddess	여신에게 공물을
和薩斯納斯對話	Talk to Samsonas	삼소나스와 대화
收集拉札泰特波的肉	Collect Rajatadpole Meat	라자태드폴의 고기 수집
交給薩斯納斯	Deliver to Samsonas	삼소나스에게 전달
把供品獻給方尖塔	Make an offering to the Obelisk	오벨리스크에 공물 바치기
向薩斯納斯報告結果	Report the results to Samsonas	삼소나스에게 결과 보고
在德拉巴禮拜堂尋找村民	Find the Village Resident at the Drava Chapel Lot	드라바 예배당 터에서 마을 사람 수색
與那帕里斯對話	Talk to Napalis	나팔리스와 대화
消滅拉克斯頓	Defeat Rocksodon	락스돈 처치
解決汙染源	Clear the Corruption	오염원 해결
調查奈祖卡小會堂	Investigate the Nesuga Small Corridor	네주가 소회당 조사
前往水螅出沒的傑尼亞走廊	Go to the Jeneuam Corridor and find the Hydra	히드라가 나타났다는 제느암 복도로 이동
與獵人莫吉斯對話	Talk to Hunter Modis	사냥꾼 모지스와 대화
收集索伍培特的肉	Collect Sawpent Meat	소우펜트의 고기 수집
採集藍色藥草	Collect Blue Herbs	푸른 향초 채집
交給獵人莫迪斯	Deliver to Hunter Modis	사냥꾼 모디스에게 전달
與獵人莫迪斯對話	Talk to Hunter Modis	사냥꾼 모디스와 대화
引誘提魯納斯水螅	Lure Tyronas Hydra	티로나스 히드라 유인
消滅提魯納斯水螅	Defeat Tyronas Hydra	티로나스 히드라 처치
採集馬卡茲花	Collect Markazi Flowers	마카지 꽃 채집
防止再度發生	Recurrence Prevention	재발 방지
和雷那達斯對話	Talk to Lanaldas	래날다스와 대화
收集暗黑拉札波拉伊特的脂肪肉塊	Collect lard from Black Rajapearlites	검은 라자펄라이트의 지방덩어리 수집
交給雷那達斯	Deliver to Lanaldas	래날다스에게 전달
燒毀實驗室	Set fire to the laboratory	실험실 불태우기
與蘇基貝丘陵地的 安靜的貓頭鷹雕像對話	Talk to the Quiet Owl Sculpture at Susipyne Hill Areas	수지베 구릉지의 조용한 부엉이 조각상과 대화
與夏烏拉斯山谷雕刻師亞捷爾對話	Talk to Dievdirbys Asel at the Siauras Valley	샤우라스 골짜기에 있는 딥디르비 아젤과 대화
回到雕刻師亞捷爾那邊去	Go back to Dievdirbys Asel	딥디르비 아젤에게 돌아가기
確認雷拉堡礁	Check the situation of the Lemyra Sentry	레미라 보초 확인
與繼承者塔魯爾對話	Talk to Loremaster Daroul	전승자 다룰과 대화
採集藍珊瑚	Collect Blue Coral	푸른 산호 채취
轉交給繼承者塔魯爾	Hand the Blue Coral to Loremaster Daroul	전승자 다룰에게 전달
繼承者貝爾塔對話	Talk to Loremaster Verta	전승자 베르타와 대화
從克雷比爾那裡找回尤拉泰女神的祭壇	Retake the Altar to Goddess Jurate from the Crabil	크래빌로부터 유라테 여신의 제단 되찾기
與佩迪米安的 飾品商人約亞那對話	Talk to the Fedimian Accessory Merchant Joana	페디미안의 악세서리 상인 요아나와 대화
與飾品商人約亞那對話	Talk to Accessory Merchant Joana	악세서리 상인 요아나와 대화
從克蘭托沿岸的綠殼縫蟹身上收集堅硬外殼碎片	Collect Blue Gapcrab Shells at Cranto Coast	크란토 연안의 푸른껍질 틈게에게서 온전한 껍질 조각 수집
轉告給飾品商人約亞那	Deliver the Shell to Accessory Merchant Joana	악세서리 상인 요아나에게 전달
從克蘭托沿岸的縫蟹身上收集堅硬外殼碎片	Collect whole Shell from the Gap Crabs at Kranta Skerries	크란토 연안의 틈게에게서 온전한 껍질 조각 수집
消滅克靈塔暗礁群的怪物	Dealing with the monsters at Kranta Skerries	크란타 암초군의 몬스터 소탕
把破壞克靈塔暗礁群的怪物消滅	Deal with the monsters wrecking Kranta Skerries	크란타 암초군을 엉망으로 만드는 몬스터 처치
將怪物的氣息填滿塔魯爾的墜飾	Fill Daroul's Pendant with the energy of monsters	다룰의 펜던트에 몬스터의 기운 채우기
收集席納加堡礁的發出藍光的石頭	Collect the Blue Stones from Sniega Sentry	스니에가 보초의 푸른 빛이 나는 돌 수집
轉交給繼承者貝爾塔	Return and hand the stones to Loremaster Verta	전승자 베르타에게 전달
難民希達對話	Talk to Refugee Hilda	피난민 힐다와 대화
調查貝斯茲休憩地和堤貝斯空地 	Investigate Bethez Refuge and Tjibes Refuge	베스즈 쉼터와 티베스 공터 조사하기
清除帕拉茲空地的營養劑瓶	Dispose of the Supplements in Pharaz Vacant Lot	파라즈 공터에 있는 영양제 병 제거
收集羅德優凱爾的精髓	Obtain Rodejokel Essence	로데요켈의 정수 수집
收集亮晶晶粉末	Collect Glimmering Powder	반짝이는 가루 수집
與啟示者普丹對話	Speak with Revelator Pudhin	계시자 푸덴과 대화
找回失竊的物資	Retrieve the stolen supplies	도둑맞은 물자 되찾기
消滅變得凶暴的怪物	Deal with the savage monsters	흉폭해진 몬스터 퇴치
和繼承者烏克奴思對話	Speak with Loremaster Ugnius	전승자 우그뉴스와 대화
尋找繼承者奈里烏思	Find Loremaster Narius	전승자 내리우스 찾기
和繼承者奈里烏思對話	Speak with Loremaster Narius	전승자 내리우스와 대화
消滅襲擊中的怪物	Defeat the attacking monster	습격중인 몬스터 처치
消滅怪物收集藥劑	Defeat the monsters and collect the medicine 	몬스터를 처치하고 약제 모으기
這樣凝聚器就會把它加工成帶有魔力的粉末。	Escort Loremaster Ugnius	전승자 우그뉴스 호위
請確認繼承者奈里烏思的狀態。	Check on Loremaster Narius	전승자 내리우스의 상태를 확인하세요.
採集藍色珊瑚礁	Collect Blue Coral	푸른 산호초 채집
和啟示者尼奇對話	Speak with Revelator Nichi	계시자 니치와 대화
調查特拉達沙灘	Investigate Tolata Sandbank	트라타 모래톱 조사
掃蕩附近的魔族	Clear out the Demons	인근 마족 소탕
偵查被佔領的窪地	Occupied Lowlands Recon 	점령당한 저지대 정찰
把充滿魔氣的怪物肉塊放進去，獲得了帶有魔力的粉末。	Defeat the Nimrah and Varle	인근의 니므라족과 바를족 처치
這個裝置已經無法再產生帶有魔力的粉末了。	Search for the relic at the occupied lowlands	점거당한 저지대에서 성물 탐색
洗除被封印的聖物的魔力	Purifying the Sealed Relic	봉인된 성물의 마기 씻어내기
偵查被污染的沙灘	Corrupted Sandbank Recon	오염된 모래톱 정찰
消滅魔族勢力	Eradicate the demon forces	마족 세력 퇴치
破壞被污染的沙灘的可疑裝置	Destroy the corrupted sandbank's suspicious device 	오염된 모래톱의 수상한 장치 파괴
清除殘留在亞伊泰歐海岸的邪惡氣息	Clear the Aitheo Coast of the remaining evil energy	아이테오 해안에 남은 사악한 기운 제거
消滅亞伊泰歐海岸的魔族	Defeat the demons at Aitheo Coast	아이테오 해안의 마족 처치
偵查珊瑚之森丘陵	Coral Forest Hill Recon 	산호숲 언덕 정찰
消滅珊瑚之森丘陵的魔族勢力	Deal with the demon forces at Coral Forest Hill	산호숲 언덕의 마족의 세력 퇴치
調查魔族的裝置	Investigate the Demon Device	마족의 장치 조사
消滅魔族勢力	Defeat the demon forces	마족의 세력 처치
保護繼承者烏克奴思	Protect Loremaster Ugnius	전승자 우그뉴스 보호
破壞第三個魔族的裝置	Destroy the Third Demon Device	세 번째 마족의 장치 파괴
消滅保護裝置的魔族勢力	Defeat the forces protecting the device 	장치를 지키는 마족의 세력 처치
請避開魔族的陷阱破壞控制裝置	Avoid the demon's trap and destroy the suppressor	마족의 함정을 피해 제어 장치 파괴
破壞巨大克魯比那	Destroy the Massive Kruvina	거대 크루비나 파괴
和繼承者埃莫艾利斯對話	Talk with Loremaster Emmanuelis	전승자 애마누엘리스와 대화
收集魔族的裝置碎片	Collect the Demon Device Fragments	마족의 장치 파편 수집
淨化被污染的土堆	Purify the Corrupted Piles of Soil	오염된 흙더미 정화
消滅殘存魔族勢力	Eradicate the surviving demon forces	잔존 마족 세력 퇴치
消滅殘存的魔族勢力	Defeat the remaining demon forces	잔존한 마족 세력 처치
和飾品商人猶勒斯對話	Talk to Accessory Merchant Jurus	악세서리 상인 유르스와 대화
展示花樹枝飾品	Show the Flower Branch Accessory	꽃 나뭇가지 악세서리 보여주기
和羅潔對話	Talk to Rose	로제와 대화
將羅潔的信交給安妮	Deliver Rose's Letter to Anne	안네에게 로제의 편지를 전달하기
將安妮的信交給羅潔	Deliver Anne's Letter to Rose	로제에게 안네의 편지를 전달하기
修理劍練習台	Sword Pell Repair	검 연습대 수리
取得劍練習台材料	Collect Sword Pell Materials	검 연습대 재료 구하기
修理劍練習台	Repair the Sword Pell	검 연습대 수리하기
我珍貴的朋友	My Precious Friend	내 소중한 친구
和寵物商人圖拉斯對話	Talk to Companion Trader Toras	컴패니언 상인 토라스와 대화
取得食物材料	Collect Ingredients	음식 재료 구하기
將製作的食物給寵物	Give Your Food to the Companion	만든 음식을 컴패니언에게 주기
跟啟示者米歇爾訴說這段期間發生的事	Tell Revelator Mihail About Your Adventures	계시자 미하일에게 그간 있었던 일을 이야기하기
和歐勒夏領主對話	Talk to the Lord of Orsha	오르샤 영주와 대화
和迷失的靈魂對話	Talk to the Lost Spirit	헤매는 영혼과 대화
將靈魂引導至微弱的貓頭鷹雕像那裡	Bring the Lost Spirit to the Frail Owl Sculpture	영혼을 미약한 부엉이 조각상으로 인도하기
開啟罪犯們所隱藏的上鎖裝置	Open the Inmates' Hidden Locking Device	죄수들이 숨겨놓은 잠금 장치를 열기
開啟上鎖裝置	Open the Locking Device	잠금 장치를 열기
尋找友情徽章	Find the Friendship Badges	우정 뱃지 찾기
和信徒金塔斯的靈魂對話。	Talk to Believer Gintas' Spirit	신도 긴타스의 영혼과 대화
取回祭祀道具	Retrieve the Offering Tools	제사 도구 구해오기
追悼犧牲者們	Remembering the Victims	희생자들을 추모하며
和羅娜對話	Talk to Rona	로나와 대화
在諾巴哈公會所設置碑石	Set a Tombstone at the Novaha Assembly Hall	노바하 공회소에 비석 설치하기
在碑石刻上追悼犧牲者們的文字	Carve a Message to Honor the Victims	비석에 희생자들을 추모하는 글 새기기
取得藥草	Obtain the Herbs	약초 구하기
為了恢復魯西安的名譽	Restoring Lucienne's Honor	루시엔의 명예 회복
將實驗報告轉交給魯西安	Deliver the Report to Lucienne Winterspoon	루시엔에게 실험 보고서를 전달하기
轉達魯西安溫特史普恩的意思	Relay Lucienne's Promise	루시엔 윈터스푼의 의사를 전달하기
和寶箱支援商人對話	Talk to the Treasure Chest Helper	보물 상자 지원상인과 대화
燃燒著的柴火堆附近	Who would pile something that is already burning? Where am I?	불타고 있는 장작더미 근처
和尋找箱子的市民對話	Talk to the resident looking for a box	상자를 찾고 있는 시민과 대화
確認活動佈告欄	Check the Event Notice Board	이벤트 알림판 확인
請確認活動佈告欄	Please check the Event Notice Board	이벤트 알림판을 확인하시오
尋找可用的木棍	Looking for some usable Wooden Rods	쓸 만한 나무 막대 찾는 중
採集尼奧雷中	Extracting Nioles	니올레를 뽑는 중
製作肉乾中	Making Dried Jerky	육포 만드는 중
遠征隊訊息	Raid Message	레이드 메시지
作賊心虛(1)	Guilty Conscience (1)	도둑이 제 발 저린다(1)
作賊心虛(2)	Guilty Conscience (2)	도둑이 제 발 저린다(2)
作賊心虛(3)	Guilty Conscience (3)	도둑이 제 발 저린다(3)
作賊心虛(4)	Guilty Conscience (4)	도둑이 제 발 저린다(4)
夢幻弓之書(1)	The Dream Bow Book (1)	활이 꿈꾸는 책(1)
夢幻弓之書(2)	The Dream Bow Book (2)	활이 꿈꾸는 책(2)
夢幻弓之書(3)	The Dream Bow Book (3)	활이 꿈꾸는 책(3)
夢幻弓之書(4)	The Dream Bow Book (4)	활이 꿈꾸는 책(4)
花漾盾牌(1)	Shield Over Flowers (1)	꽃보다 방패(1)
花漾盾牌(2)	Shield Over Flowers (2)	꽃보다 방패(2)
盟約的義務(1)	Pledge of Duty (1)	맹약에 대한 도리(1)
盟約的義務(2)	Pledge of Duty (2)	맹약에 대한 도리(2)
為了百姓與盾牌之劍(1)	A Sword and Shield for the People (1)	국민과 방패를 위한 검(1)
為了百姓與盾牌之劍(2)	A Sword and Shield for the People (2)	국민과 방패를 위한 검(2)
為了百姓與盾牌之劍(3)	A Sword and Shield for the People (3)	국민과 방패를 위한 검(3)
為了百姓與盾牌之劍(4)	A Sword and Shield for the People (4)	국민과 방패를 위한 검(4)
飛禽的干擾(1)	Disturbance of the Winged Beast (1)	날짐승의 방해(1)
飛禽的干擾(2)	Disturbance of the Winged Beast (2)	날짐승의 방해(2)
飛禽的干擾(3)	Disturbance of the Winged Beast (3)	날짐승의 방해(3)
飛禽的干擾(4)	Disturbance of the Winged Beast (4)	날짐승의 방해(4)
佩迪米安的探詢者(1)	Fedimian's Investigator (1)	페디미안의 탐문자(1)
佩迪米安的探詢者(2)	Fedimian's Investigator (2)	페디미안의 탐문자(2)
學術上的問題	A Scholarly Question	학구적 질문
竊取歷史	A Historical Theft	사적 절취
星星的鏡片	Astral Lens	별의 렌즈
背叛者的毒	Poisonous Betrayal	배신자의 독
找回失物	Reclaiming Lost Items	분실물 되찾기
世界上不存在的書(1)	A Book Not of This World (1)	세상에 없던 책(1)
世界上不存在的書(2)	A Book Not of This World (2)	세상에 없던 책(2)
寒鐵傳說(1)	Legend of the Winter Season (1)	한철의 전설(1)
寒鐵傳說(2)	Legend of the Winter Season (2)	한철의 전설(2)
作賊心虛	Guilty Conscience	도둑이 제 발 저린다
將工兵大師給的袋子交給牧師大師。	Deliver the Pouch to the Cleric Master	클레릭 마스터에게 새퍼 마스터가 준 주머니 전달
夢幻弓之書	The Dream Bow Book	활이 꿈꾸는 책
在泰內聖堂地下 1層收集葛利查頓的堅韌皮革	Collect Tough Glizardon Leather in Tenet Church B1	테넷 성당 지하 1층에서 글리자돈의 질긴 가죽 수집
在夏奧雷伊礦山村莊的水晶礦山入口收集石頭	Collect Rocks from the Crystal Mine Entrance in Miners' Village	샤울레이 광산 마을의 수정광산 입구에서 바위 수집
花漾盾牌	Shield Over Flowers	꽃보다 방패
盟約的義務	Pledge of Duty	맹약에 대한 도리
佩迪米安的探詢者	Fedimian's Investigator	페디미안의 탐문자
消滅鬼影凱伊洛	Defeat Shadowgaler	섀도게일러를 처치
世界上不存在的書	A Book Not of This World	세상에 없던 책
寒鐵傳說	Legend of the Winter Season	한철의 전설
在水晶礦山 2層搜尋書	Crystal Mine 2F Book Investigation	수정광산 2층에서 책 탐색
美容院	Beauty Shop	뷰티샵
1人地下城	Solo Dungeon	1인 던전
隱藏的研究記錄保管所	Hidden Research Archives	숨겨진 연구 기록 보관소
都市危險的存在(1)	The City Under Threat (1)	도시의 위험한 존재(1)
都市危險的存在(2)	The City Under Threat (2)	도시의 위험한 존재(2)
詢問有沒有事	Will you be okay?	괜찮겠냐고 묻는다
都市危險的存在(3)	The City Under Threat (3)	도시의 위험한 존재(3)
詢問該如何處理回收的研究紀錄書	What are you going to do with the research papers?	회수한 연구 기록지는 어떻게 할 것인지 묻는다
尋找老舊的研究紀錄書	Finding the Old Research Papers	오래된 연구 기록지 찾기
都市危險的存在	The City Under Threat	도시의 위험한 존재
去確認剩下法師們的行蹤	Look for the Rest of the Wizards	나머지 위저드들의 행방을 확인하러 가기
請去確認剩下法師們的行蹤。	Go and find where the rest of the wizards are	나머지 위저드들의 행방을 확인하러 가세요.
和法師安妮對話	Talk to Wizard Ane	위저드 아네와 대화
消滅奎普博學者	Defeat the Quipmage	큅메이지 처치하기
尋找並消滅奎普博學者	Find and Defeat the Quipmage	큅메이지를 찾고 처치하기
和巴伊寶拉之翼對話	Talk to the Wings of Vaivora	바이보라 날개와 대화
