尤克利那斯 	Jugrinas	유그리나스
你把植物標本帶來了嗎?{nl}	Did you bring the plant samples?	식물 표본은 잘 가져오셨나요?{nl}
奎波爾 蕾妮亞	Kupole Lenja	큐폴 레냐
找到預言之書了嗎?	Did you find the Prophecy Tome?	예언의 서는 찾으셨나요?
凱都拉商團員艾達	Kedoran Alliance Merchant Alta	케도라 상단원 알타
亞奎爾拉斯	Aquilas	아퀼라스
梅坎	Mechen	메켄
傑諾納斯	Jenonhas	제노나스
造箭者大師	Fletcher Master	플레처 마스터
他將探測造箭者之箭的製作書交給你？	He gave you a recipe that will allow us to craft equipment that will help us detect the Flechette?	플레세트를 탐지 할 수 장치를 만드는 방법이 적힌 제작서를 줬단 말입니까?
只要我去世伊魯森林，就能見到拉達女神了吧？	I suppose I'll be able to meet her if I go to Seir Rainforest?	제가 세이르 숲으로 간다면 라다 여신을 만나 뵐 수 있는거겠죠?
祭司奇達斯	Priest Kidas	사제 키다스
祭司布魯納斯	Priest Brunas	사제 브루나스
好。	Ohla	올라
柯提斯	Curtis	커티스
你說這地方的難民的苦衷都聽過了？	You've listened to all of the worries of the people here?	이곳 난민들의 사정을 다 들으셨다고요?
真的嗎？	Really?	정말입니까?
亞烏雷斯	Aurlelse	아우랠스
阿爾雷克斯	Alex	알렉스
威欽斯	Wickens	위킨스
米由斯	Myuse	미유스
瑞爾	Liel	리엘
奈格爾斯	Nagles	네이글스
慧樂斯	Heres	헤르스
得雷絲	Dreis	드레이스
帕迪亞	Phadia	파디야
伊娃特	Wyatt	이와트
瓦塔斯	Waltas	왈타스
希塔斯	Ciatas	시타스
魯帕斯	Rhupas	루파스
歐得特	Ohdette	오데트
薩爾里亞	Salewya	살뤼야
丹尼爾斯	Daniels	다니엘스
看似沒有主人的狗	A Dog with no Owner	주인 없어 보이는 개
來歷不明的設施	Unidentified Facility	정체불명의 시설물
亞佳伊拉弗羅里幻影	Agailla Flurry's Spirit	아가일라 플러리 환영
亞佳伊拉弗羅里幻影	Agailla Flurry Apparition	아가일라 플러리 환영체
亞佳伊拉弗羅里幻影	Agailla Flurry Apparition	아가일라 플러러 환영체
第一 	First 	첫번째 
為何這麼慢呢？	What took you so long?	왜 이리 늦으신거죠?
躲藏的適當場所	The perfect place to hide	몸을 숨기기에 적당한 장소
請小心謹慎，千萬別被猜忌的哈勃克與野心的哈勃克發現。	Be careful so that you are not discovered by either Suspicion Hauberk nor Ambition Hauberk	의심의 하우벅과 야망의 하우벅에게 들키지 않게 조심히 움직이세요.
傭兵海藍達	Mercenary Heranda	용병 헤란다
團長基高	Commanding Officer Gigho	단장 기고
奎波爾魯吉萊	Kupole Rugile	큐폴 루길레
奎波爾沙耶	Kupole Saya	큐폴 사야
奎波爾薇塔	Kupole Ouida	큐폴 위다
奎波爾黎泰	Kupole Litae	큐폴 리테
奎波爾塔奴泰	Kupole Danute	큐폴 다누테
守護水晶怎麼樣了呢？	How's the protection crystal?	수호의 수정은 어떻게 됐나요?
奎波爾斯卡伊娃	Kupole Skywa	큐폴 스카이와
反抗軍史基爾戈意拉	Resistor Skirgaila	저항군 스키르가일라
反抗軍亞普拉奧摩斯	Resistor Abraomas	저항군 아브라오마스
雷歐納勒達斯	Leonardas	레오나르다스
反抗軍雷歐納勒達斯	Resistor Leonardas	저항군 레오나르다스
殺了我吧！	Killing me	나를 죽이라
皮蘭敏 布蘭登	Refugee Brandon	피난민 브랜든
難民 蜜莉亞	Refugee Mylija	피난민 밀리아
難民 格雷格	Refugee Greg	피난민 그렉
你會幫忙吧？	You'll help us right?	도와주시는 거죠?
領主 里烏達斯	Lord Ryudhas	영주 리우다스
誰阿這樣突然出現在我身邊？	Who are you to stand in front of me?	누군데 이렇게 불쑥 내 앞에 나타난 거지?
和優庫巴斯家的小孩爭吵的理由是？	The reason I am fighting with the Joquvas lad?	요쿠바스가의 애송이랑 싸우는 이유?
里烏達斯的護衛兵	Ryudhas Guard	리우다스의 호위병
領主 優庫巴斯	Lord Joquvas	영주 요쿠바스
優庫巴斯的護衛兵	Joquvas Guard	요쿠바스의 호위병
瑪樂寇斯	Marcus	마르커스
你說有東西要給我？	You have something for me?	제게 전해주실 것이 있다고요?
調查隊長 艾爾拉	Investigation Team Leader Ella	조사대장 엘라
調查員 凱斯柏	Investigator Gasper	조사원 개스퍼
調查員 戶萊以修	Investigator Horatio	조사원 호레이쇼
埃莫艾利斯	Emmanuelis	애마누엘리스
諾貝禮爾的傳染病	The Nobreer Epidemic	노브리어의 역병
找到傳染病的治療方法後(1)	Finding a Cure for the Epidemic (1)	역병의 치료법을 찾아서(1)
找到傳染病的治療方法後(2)	Finding a Cure for the Epidemic (2)	역병의 치료법을 찾아서(2)
找到傳染病的治療方法後(3)	Finding a Cure for the Epidemic (3)	역병의 치료법을 찾아서(3)
找到傳染病的治療方法後(4)	Finding a Cure for the Epidemic (4)	역병의 치료법을 찾아서(4)
找到傳染病的治療方法後(5)	Finding a Cure for the Epidemic (5)	역병의 치료법을 찾아서(5)
你是神遊到哪去啦	Are you completely out of your mind?	정신을 어디에 두고 다니냐고 한다
找到傳染病的治療方法後(6)	Finding a Cure for the Epidemic (6)	역병의 치료법을 찾아서(6)
傳染病的真面目(1)	The Truth Behind the Epidemic (1)	역병의 정체(1)
傳染病的真面目(2)	The Truth Behind the Epidemic (2)	역병의 정체(2)
諾貝禮爾的瘟神	Nobreer Demonic Plague	노브리어의 역귀
拉伊瑪留下的預言之書(1)	Laima's Prophecy Tome (1)	라이마가 남긴 예언의 서(1)
拉伊瑪留下的預言之書(2)	Laima's Prophecy Tome (2)	라이마가 남긴 예언의 서(2)
魔族的誓約(1)	Demon Treaty (1)	마족의 서약(1)
魔族的誓約(2)	Demon Treaty (2)	마족의 서약(2)
魔族的誓約(3)	Demon Treaty (3)	마족의 서약(3)
魔族的誓約(4)	Demon Treaty (4)	마족의 서약(4)
女神的誓約(1)	Goddess Treaty (1)	여신의 서약(1)
女神的誓約(2)	Goddess Treaty (1)	여신의 서약(2)
女神與魔族的故事(1)	A Story of Demons and Goddesses (1)	여신과 마족의 이야기(1)
女神與魔族的故事(2)	A Story of Demons and Goddesses (2)	여신과 마족의 이야기(2)
女神與魔族的故事(3)	A Story of Demons and Goddesses (3)	여신과 마족의 이야기(3)
阿爾蘭必的故事(1)	Alembique Tales(1)	알렘빅 이야기(1)
為什麼進不去	What is it? 	왜 못들어가느냐고 묻는다
詢問為什麼組成傭兵團	Why was the mercenary group formed?	용병단은 왜 꾸린 건지 물어본다
阿爾蘭必的故事(2)	Alembique Tales(2)	알렘빅 이야기(2)
阿爾蘭必的故事(3)	Alembique Tales(3)	알렘빅 이야기(3)
阿爾蘭必的故事(4)	Alembique Tales(4)	알렘빅 이야기(4)
第一位客人的角色(1)	The First Guest's Role (1)	첫 손님의 역할(1)
第一位客人的角色(2)	The First Guest's Role (2)	첫 손님의 역할(2)
轉移注意力	Change of Focus	관심돌리기
會依照計畫進行	I'll follow the plan	계획대로 하겠다고 한다
整理圖書	Organize books	도서정리
被束縛的命運(1)	Trapped Destiny (1)	틀에 갇힌 운명(1)
被束縛的命運(2)	Trapped Destiny (2)	틀에 갇힌 운명(2)
被束縛的命運(3)	Trapped Destiny (3)	틀에 갇힌 운명(3)
被束縛的命運(4)	Trapped Destiny (4)	틀에 갇힌 운명(4)
我會試著考慮	I'll think it through	고려해보겠다고 한다
前往影子底下(1)	Going Below the Shadow (1)	그림자 밑으로(1)
前往影子底下(2)	Going Below the Shadow (2)	그림자 밑으로(2)
前往影子底下(3)	Going Below the Shadow (3)	그림자 밑으로(3)
前往影子底下(4)	Going Below the Shadow (4)	그림자 밑으로(4)
前往影子底下(5)	Going Below the Shadow (5)	그림자 밑으로(5)
前往影子底下(6)	Going Below the Shadow (6)	그림자 밑으로(6)
前往影子底下(7)	Going Below the Shadow (7)	그림자 밑으로(7)
那是什麼意思？	What are you talking about?	무슨 소리냐고 한다
需要的失誤(1)	Necessary Mistake (1)	필요한 실수(1)
需要的失誤(2)	Necessary Mistake (2)	필요한 실수(2)
需要的失誤(3)	Necessary Mistake (3)	필요한 실수(3)
需要的失誤(4)	Necessary Mistake (4)	필요한 실수(4)
需要的失誤(5)	Necessary Mistake (5)	필요한 실수(5)
需要的失誤(6)	Necessary Mistake (6)	필요한 실수(6)
需要的失誤(7)	Necessary Mistake (7)	필요한 실수(7)
需要的失誤(8)	Necessary Mistake (8)	필요한 실수(8)
沒有記錄的歷史(1)	The History that Will Not Be Recorded (1)	기록되지 않을 역사(1)
沒有記錄的歷史(2)	The History that Will Not Be Recorded (2)	기록되지 않을 역사(2)
沒有記錄的歷史(3)	The History that Will Not Be Recorded (3)	기록되지 않을 역사(3)
沒有記錄的歷史(4)	The History that Will Not Be Recorded (4)	기록되지 않을 역사(4)
沒有記錄的歷史(5)	The History that Will Not Be Recorded (5)	기록되지 않을 역사(5)
沒有記錄的歷史(6)	The History that Will Not Be Recorded (6)	기록되지 않을 역사(6)
沒有記錄的歷史(7)	The History that Will Not Be Recorded (7)	기록되지 않을 역사(7)
沒有記錄的歷史(8)	The History that Will Not Be Recorded (8)	기록되지 않을 역사(8)
沒有記錄的歷史(9)	The History that Will Not Be Recorded (9)	기록되지 않을 역사(9)
黑翼的影子(1)	Shadow of the Black Wing (1)	검은 날개의 그림자(1)
黑翼的影子(2)	Shadow of the Black Wing (2)	검은 날개의 그림자(2)
黑翼的影子(3)	Shadow of the Black Wing (3)	검은 날개의 그림자(3)
黑翼的影子(4)	Shadow of the Black Wing (4)	검은 날개의 그림자(4)
黑翼的影子(5)	Shadow of the Black Wing (5)	검은 날개의 그림자(5)
黑翼的影子(6)	Shadow of the Black Wing (6)	검은 날개의 그림자(6)
阻止入侵	Stop the Invasion	침공 저지
未識別記錄次數	Retrieve Unidentified Records	미식별 기록 회수
阿爾蘭必的故事(5)	Alembique Tales(5)	알렘빅 이야기(5)
阿爾蘭必的故事(6)	Alembique Tales(6)	알렘빅 이야기(6)
阿爾蘭必的故事(7)	Alembique Tales(7)	알렘빅 이야기(7)
阿爾蘭必的故事(8)	Alembique Tales(8)	알렘빅 이야기(8)
傳說的真相	A Legend's Reality	전설의 실체
性命的價值	The price of life	목숨값
腳得先動起來	Legs must work properly	우선 다리가 움직여야
好好躲起來的話會沒事的	Say that it will be safe enough	몸을 잘 숨기고 있으면 별 일 없을거라 한다
取出藥草中	Giving herbs	약초를 건네는 중
接二連三的陷阱(1)	Trap after trap(1)	연이은 함정(1)
接二連三的陷阱(2)	Trap after trap(2)	연이은 함정(2)
在毒面前沒有所謂壯士	Poison will be strong enough	독 앞에는 장사없다
究竟能幫助我嗎	I don't know if it will be useful	과연 날 도울 수 있을까
無論是什麼試驗都沒有問題	Say that you are prepared to face any challenge	어떤 시험이든 문제없다고 한다
我不想和複雜的事糾纏	Say that you do not want to be involved in anything complicated	복잡한 일에는 얽히기 싫다고 한다
詢問怪獸的真面目	Ask about the beast's identity	괴수의 정체에 대해 묻는다
繁複的準備過程(1)	Complicated Preparations(1)	까다로운 준비 과정(1)
是什麼樣的材料	Ask what ingredients are needed	어떤 재료인지는 묻는다
繁複的準備過程(2)	Complicated Preparations(2)	까다로운 준비 과정(2)
直接去準備看起來也沒什麼問題	Say that you will be fine on your own	직접 돌아다녀도 지장없어 보인다고 한다
繁複的準備過程(3)	Complicated Preparations(3)	까다로운 준비 과정(3)
把怪獸趕往陷阱(1)	To trap a beast(1)	괴수를 함정으로 몰아넣기(1)
把怪獸趕往陷阱(2)	To trap a beast(2)	괴수를 함정으로 몰아넣기(2)
與怪獸的最後決戰(1)	Beast's End(1)	괴수와의 마지막 결전(1)
與怪獸的最後決戰(2)	Beast's End(2)	괴수와의 마지막 결전(2)
難民用餐準備	Prepare food for the refugees	피난민의 식사준비
我會去收集來給你	Say that you will collect it	모아다 주겠다고 한다
若太忙就拒絕吧	Refuse as you are too busy	갈길이 바쁘다며 거절한다
自己的身體要顧好	So that they will be able to protect themselves	자기 몸은 지킬 수 있도록
若變得太危急就逃吧	Say that they should run if it is too dangerous	위급해지면 그냥 도망가라고 한다
協商家	Negotiator	협상가
我會試試看	Say that you will try to do so	시도해 보겠다고 한다
我沒有自信說服他	Say that you are not feeling too confident	설득할 자신이 없다고 한다
說服里烏達斯領主(1)	Convincing Lord Ryudhas(1)	리우다스 영주 설득하기(1)
建議與優庫巴斯領主談談看	Propose talking to Lord Joquvas	요쿠바스 영주와 대화해 볼 것을 권한다
若覺得抱歉就退開	Apologies for the intrusion and step away	실례했다며 그 앞에서 물러난다
兩位領主為何會在這爭吵	Ask why the two lords are fighting here	두 영주가 이 곳에서 왜 싸우는지 묻는다
說服里烏達斯領主(2)	Convincing Lord Ryudhas(2)	리우다스 영주 설득하기(2)
那麼我會交給領主的部下	Say that you will leave it to his men	그럼 영주의 부하에게 맡기겠다고 한다
說服里烏達斯領主(3)	Convincing Lord Ryudhas(3)	리우다스 영주 설득하기(3)
我很願意去幫你找	Say that you are more than willing to help	기꺼이 찾아 주겠다고 한다
那種事就叫部下做吧	Tell him to make his men do it	그 정도는 부하들을 시키라고 한다
說服優庫巴斯領主(1)	Convincing Lord Joquvas(1)	요쿠바스 영주 설득하기(1)
等一等聽我說吧	Ask him to hear your tale	잠시만 이야기를 들어달라고 한다
什麼都不說地離開	Step back without saying anything	말 없이 물러난다
說服優庫巴斯領主(2)	Convincing Lord Joquvas(2)	요쿠바스 영주 설득하기(2)
我會去除掉怪物	Say that you will deal with the monsters	몬스터를 해치우겠다고 한다
條件講清楚之前是不會答應的	Refuse to do so until he listens to you	용건부터 밝히겠다며 거절한다
說服優庫巴斯領主(3)	Convincing Lord Joquvas(3)	요쿠바스 영주 설득하기(3)
詢問要找甚麼東西	Ask what you need to look for	어떤 물건을 찾으면 되는지 묻는다
在那之前先好好談談吧	Say that he must make a promise before you agree to do anything	그 전에 대화 약속이 우선이라고 한다
說服優庫巴斯領主(4)	Convincing Lord Joquvas(4)	요쿠바스 영주 설득하기(4)
知道了那麼就出發吧	Agree to the terms	알았다며 가자고 한다
這樣就夠了接著進行協議吧	Say that he should keep his end of the promise	이 정도면 되었으니 대화 약속을 요구한다
油與水	Oil and water	물과 기름
不是個好對付的對手	It was not an easy opponent	쉬운 상대가 아니었다
依照啟示者的建議	As the Revelator proposed	계시자의 제안대로
和優庫巴斯領主提出重劃新的國界的建議。	Propose that a new boundary should be set with Lord Joquvas	요쿠바스 영주와 새로운 경계를 정할 것을 제안한다
考慮看看其他方法	Think of another solution	다른 방법을 고민한다
庫凱利禁區	Kugheri Restricted Area	쿠게리 금지구역
很抱歉我很忙沒時間理你	Refuse as you are too busy	미안하지만 갈길이 바쁘다며 거절한다
為了大義	For the greater good	대의를 위해서
害怕為了偉大事業犧牲自我	Say that you feel a bit overwhelmed	거창한 일에 나서기는 꺼려진다고 한다
關於拉明將軍的命令	About General Lhamin's Orders	라민장군의 명령에 대해서
魔族的命令書	Demon Orders	마족의 명령서
推算敵人的陰謀	Going through enemy plans	적의 계획 파헤치기
爽快答應要收集	Say that you will gladly help	기꺼이 모아다 주겠다고 한다
收集再多也無法找到解答的	Say that you doubt more information will help	더 모은다고 해석이 될 것 같지 않다고 한다
不是魔族的對手	Say that you are not able to face the demons	마족을 직접 상대하는 것은 무리라고 한다
王家樹林	Trees of the Royal Family	왕가의 나무들
這件事也太不明不白了	Say that the task is too abstract	너무 막연한 일 같다고 한다
王與時間之縫	The gap between King and time	왕과 시간의 틈
一起出發吧	Say that you should go together	함께 가자고 한다
坦尼爾時2世的王稜	Taniel the Second's Royal Mausoleum	타니엘 2세의 왕릉
血的證明	Proof by blood	피의 증명
用庫凱利的靈魂填補紋章吧	Propose filling the seal with Kugheri souls	쿠게리의 영혼을 대신 문장에 채워보자고 한다
自己也沒有適合的辦法	Say that you don't any ideas	자신도 마땅한 방법이 없다고 한다
取出魔石中	Handing the magic stone	마석을 건네는 중
再藏起來	Hiding once more	다시 감춰두기
詢問可以幫忙甚麼	Ask if there is anything else you can help with	무엇을 더 도우면 좋을지 묻는다
找到入口了我的任務就到此為止囉	Say that your job is done since the entrance has been located	입구를 발견했으니 자신의 역할은 끝났다고 한다
他們無法自己完成的	Say that they must not know	그들이 알아서는 안된다
要消滅牠們	Say that you will deal with them	그들을 처치하겠다고 한다
再封印完成了可以收工啦	Say that all loose ends must be covered since you have come this far	재봉인까지 했으니 일을 마무리짓자고 한다
賭上人質的交易	Trading with Hostage at Stake	인질을 내건 거래
休憩地的水晶石	Crystal Stone at the Rest Place	쉼터의 수정석
空地的水晶石	Crystal Stone at the Lot	공터의 수정석
調查水晶石中	Investigating the Crystal Stone	수정석을 조사 중
交叉路的水晶石(1)	Crystal Stone at the Crossroad (1)	교차로의 수정석(1)
交叉路的水晶石(2)	Crystal Stone at the Crossroad (2)	교차로의 수정석(2)
交叉路的水晶石(3)	Crystal Stone at the Crossroad (3)	교차로의 수정석(3)
沒有現身的魔君主	The Hidden Demon Lord	드러내지 않는 마군주
補給品消滅作戰	Supply Removal Operation	보급품 제거 작전
去拜託其他人吧。	Can you ask someone else to do it?	다른 사람에게 부탁하라고 한다.
調查基普卡斯交叉路光態	Investigation on Zibukas Crossroad's Ecosystem	지부카스 교차로 생태 조사
搬移前燒毀吧！	Burning Before Moving	옮기기 전에 태워버리자
為了能更順利進行調查	For Fluid Investigation	원활한 조사를 위해서
新人在哪裡(1)	Where is the Recruit? (1)	신입은 어디에(1)
新人在哪裡(2)	Where is the Recruit? (2)	신입은 어디에(2)
新人在哪裡(3)	Where is the Recruit? (3)	신입은 어디에(3)
藍光引導的地方	Where the Blue Light Leads	푸른 빛이 인도하는 곳
雙重交易	Double Cross Trading	이중 거래
正在交談中	Telling the story	이야기를 해주는 중
後院的水晶石	Crystal Stone in the Courtyard	안뜰의 수정석
正在確認水晶中	Checking the crystal stone	수정석을 확인해보는 중
庭院的水晶石(1)	Crystal Stone in the Garden (1)	정원의 수정석(1)
庭院的水晶石(2)	Crystal Stone in the Garden (2)	정원의 수정석(2)
為了完美的清除	For Perfect Removal	완벽한 제거를 위해
啟動自爆裝置中	Activating self-destruction	자폭 장치를 작동시키는 중
難以理解的結尾	Conclusion with Different Interests	이해가 얽힌 결말
食用湖水長大的葉子	A Leaf Grown by the Lake	호수의 물을 먹고 자란 잎
提升效果的材料	Ingredient for Maximizing the Effect	효과를 높여주는 재료
蘊含湖水靈氣的樹液	Spiritually Infused Lakeland Sap	호수의 정기를 담은 수액
神奇樹液的效果	Sap of Wonders	신통한 수액의 효과
無論如何都要降低	Reducing as Much as Possible	조금이라도 줄여야
傳說的證據(1)	Marks of a legend(1)	전설의 흔적(1)
會幫助你請告訴我你要找的東西	Ask him to tell you since you are willing to help	일을 도와줄테니 무슨 일인지 말해보라고 한다
自己慢慢找吧	Tell him to obtain them himself	알아서 구하라고 한다
傳說的證據(2)	Marks of a legend(2)	전설의 흔적(2)
會幫你尋找造箭者之箭	Say that you will assist in finding the Flechette	플레세트를 찾는 일을 도와주겠다고 한다
希望能找到要找的東西啊	Wish him the best in finding what he is looking for	찾고 있는 것을 꼭 찾길 바란다고 말한다
傳說的證據(3)	Marks of a legend(3)	전설의 흔적(3)
會幫忙找到比爾卡斯的毛	Agree to find Vilkas fur	빌카스의 털을 구해주겠다고 한다
小心仔細找啊	Say that you wish him the best of luck	조심히 찾으라고 한다
傳說的證據(4)	Marks of a legend(4)	전설의 흔적(4)
一起去尋找吧	Agree to search together	같이 수색하겠다고 한다
自己會去找	Say that he is on his own	알아서 수색하라고 한다
傳說的證據(5)	Marks of a legend(5)	전설의 흔적(5)
到傑諾納斯那裡去	Go to Jenonhas	제노나스에게 간다
以後再去啦	Say that you will go there later	나중에 찾아가보겠다고 한다
傳說的證據(6)	Marks of a legend(6)	전설의 흔적(6)
跟隨傑諾納斯	Follow Jenonhas	제노나스를 따라간다
放著不管	Leave him alone	내버려둔다
傳說的證據(7)	Marks of a legend(7)	전설의 흔적(7)
我去造箭者大師那裡看看吧	Say that you will go to the Fletcher Master instead	그럼 내가 플레쳐 마스터에게 가보겠다고 한다
派遣其他人過去	Tell him to send someone else	다른 사람을 보내라고 한다
訴說有關梅的事情	Talking about Mechen	메켄과 관련된 이야기를 하는 중
當梅坎吐露出隱情後，就處置他，並且把造箭者之箭帶來	Agree to defeat Mechen and bring the Flechette if he tries to do something	메켄이 속내를 드러낼 시 그를 처치해 플레세트를 가져오겠다고 한다
正把事情告訴造箭者大師	Telling Mechen about what was discussed between you and the Fletcher Master	플레쳐 마스터와 한 이야기를 전하는 중
傳說的證據(8)	Marks of a legend(8)	전설의 흔적(8)
去尋找魔族的魔力	Go to retrieve demon magic	마족의 마력을 구하러 간다
使喚你的徒弟就好啦	Tell him to make his apprentices get it	제자들을 시키라고 한다
傳說的證據(9)	Marks of a legend(9)	전설의 흔적(9)
要去尋找比爾卡斯的精髓	Go and retrieve Vilkas essence	빌카스의 정수를 구하러 간다
傳說的證據(10)	Marks of a legend(10)	전설의 흔적(10)
願意幫你找啦	Agree to help search around	찾는데 동참하겠다고 한다
仔細找啊！	Wish them the best of luck	잘 찾아보라고 한다
傳說的證據(12)	Marks of a legend(12)	전설의 흔적(12)
去轉交造箭者大師	Agree to take it to the Fletcher Master	플레쳐 마스터에게 가서 전해주고 오겠다고 한다
正再取出造箭者之箭	Giving the Flechette	플레세트를 건네 주는 중
梅伊班的遺願(1)	Maven's Wishes(1)	메이번의 유지(1)
梅伊班的遺願(2)	Maven's Wishes(2)	메이번의 유지(2)
梅伊班的遺願(3)	Maven's Wishes(3)	메이번의 유지(3)
要去找紀念碑	Agree to go and find the Monument	기념비를 찾으러 가자고 한다
以後再幫你啦	Say that you will help later	나중에 일을 돕겠다고 한다
梅伊班的遺願(5)	Maven's Wishes(5)	메이번의 유지(5)
要跟林塔斯一起尋找紀念碑	Go with Priest Lintas to find the Monument	린타스와 함께 기념비를 찾으러 간다
一個人去尋找	Leave him to go and find the Monument on his own	혼자 찾으러 가게 한다
梅伊班的遺願(6)	Maven's Wishes(6)	메이번의 유지(6)
要取尋找美泰爾藥草	Agree to gather Mittelly Herbs	미탤리 약초를 구해 오겠다고 한다
這不是我該做的事情	Say that you don't think it's your place to help	내가 할 일이 아닌 것 같다고 한다
正在轉交美泰爾藥草	Giving Mittelly Herbs	미탤리 약초 전달 중
梅伊班的遺願(7)	Maven's Wishes(7)	메이번의 유지(7)
梅伊班的遺願(8)	Maven's Wishes(8)	메이번의 유지(8)
要再去找找看	Agree to search the area	대신 찾아보겠다고 한다
等等再出發吧	Say that you will search a bit later	조금 있다가 찾겠다고 한다
梅伊班的遺願(9)	Maven's Wishes(9)	메이번의 유지(9)
那麼詢問該怎麼辦吧	Ask how you should help	그러면 어떻게 해야 하느냐고 묻는다
除草作業(1)	Weeding(1)	제초 작업(1)
要去取得比爾卡斯的唾液腺	Agree to gather Vilkas salivary glands	빌카스의 침샘을 구하러 가겠다고 한다
除草作業(2)	Weeding(2)	제초 작업(2)
要去尋找祭司布魯納斯	Agree to search for Priest Brunas	사제 브루나스를 찾으러 가겠다고 한다
再等一下就會來了吧	Say that he will come if you wait here	기다리면 올 거라고 한다
梅伊班的遺願(4)	Maven's Wishes(4)	메이번의 유지(4)
跟在後面	Follow him	뒤따라 간다
自己想辦法去找好嗎	Tell him he is on his own	알아서 찾아가라고 한다
未來的計畫	Future plans	앞으로의 계획
詢問未來的計畫	Ask about future plans	앞으로의 계획을 묻는다
除草作業(3)	Weeding(3)	제초 작업(3)
等著瞧吧	Wait and see	지켜본다
傳說的證據(11)	Marks of a legend(11)	전설의 흔적(11)
消失的孩子	Missing Child	사라진 아이
修理帳棚所需要的東西	Things needed to repair the tent	천막을 수리하는데 필요한 물건
我會幫助你的，但是請告訴我要怎麼找到縫補帳篷的線。	How could I get the thread?	도와줄테니 그 천막 꿰맬 실은 어떻게 구하는지 묻는다
米雪勘森林的難民們(1)	Refugees of Mishekan Forest(1)	미쉐칸 숲의 난민들(1)
問問看有沒有要幫忙的事情	What can I do for you?	도울 일이 없느냐고 묻는다
米雪勘森林的難民們(2)	Refugees of Mishekan Forest(2)	미쉐칸 숲의 난민들(2)
有其他方法能取得修理柵欄用的木材嗎？	How do I secure the lumbers for fences?	방책 수리용 목재를 구할 방법을 묻는다
米雪勘森林的難民們(3)	Refugees of Mishekan Forest(3)	미쉐칸 숲의 난민들(3)
米雪勘森林的難民們(4)	Refugees of Mishekan Forest(4)	미쉐칸 숲의 난민들(4)
米雪勘森林的難民們(5)	Refugees of Mishekan Forest(5)	미쉐칸 숲의 난민들(5)
米雪勘森林的難民們(6)	Refugees of Mishekan Forest(6)	미쉐칸 숲의 난민들(6)
米雪勘森林的難民們(7)	Refugees of Mishekan Forest(7)	미쉐칸 숲의 난민들(7)
被遺忘的難民們	Forgotten Refugees	잊혀진 피난민들
傳達米雪勘森林的狀況	Explaining the situation of Mishekan Forest	미쉐칸 숲의 상황을 알리는 중
正在說明已經轉達給柯拉佩達的烏斯卡知道了	Informing news was delivered to Uska	클라페다의 우스카에게 전달했다고 이야기하는 중
聽見你的歌聲(1)	I Can Hear You Singing (1)	너의 노래소리가 들려(1)
聽見你的歌聲(2)	I Can Hear You Singing (2)	너의 노래소리가 들려(2)
詢問是哪一個怪物的黃色汁液。	From which monster is the yellow juice from?	어떤 몬스터의 노란색 즙액인지 묻는다
聽見你的歌聲(3)	I Can Hear You Singing (3)	너의 노래소리가 들려(3)
聽見你的歌聲(4)	I Can Hear You Singing (4)	너의 노래소리가 들려(4)
聽見你的歌聲(5)	I Can Hear You Singing (5)	너의 노래소리가 들려(5)
聽見你的歌聲(6)	I Can Hear You Singing (6)	너의 노래소리가 들려(6)
聽見你的歌聲(7)	I Can Hear You Singing (7)	너의 노래소리가 들려(7)
聽見你的歌聲(8)	I Can Hear You Singing (8)	너의 노래소리가 들려(8)
聽見你的歌聲(10)	I Can Hear You Singing (10)	너의 노래소리가 들려(10)
聽見你的歌聲(11)	I Can Hear You Singing (11)	너의 노래소리가 들려(11)
在泰凱爾避難地徘徊的狗	A Dog Wandering Tekel Shelter	테켈 피난지를 배회하는 개
亂戰當中	Into a Dogfight	난전 속으로
全神貫注(1)	Creating Distractions (1)	이목 집중(1)
全神貫注(2)	Creating Distractions (2)	이목 집중(2)
全神貫注(3)	Creating Distractions (3)	이목 집중(3)
全神貫注(4)	Creating Distractions (4)	이목 집중(4)
全神貫注(5)	Creating Distractions (5)	이목 집중(5)
前往伊祖兒拉恰高原	To Izoliacjia Plateau	이졸라챠 고원으로
那魯巴斯寺院的防禦裝置(1)	Narvas Temple's Barrier (1)	나르바스 사원의 방어막(1)
那魯巴斯寺院的防禦裝置(2)	Narvas Temple's Barrier (2)	나르바스 사원의 방어막(2)
那魯巴斯寺院的防禦裝置(3)	Narvas Temple's Barrier (3)	나르바스 사원의 방어막(3)
那魯巴斯寺院的防禦裝置(4)	Narvas Temple's Barrier (4)	나르바스 사원의 방어막(4)
那魯巴斯寺院的防禦裝置(5)	Narvas Temple's Barrier (5)	나르바스 사원의 방어막(5)
詢問該怎麼做	What do you need me to do?	어떻게 해야 하냐고 묻는다
那魯巴斯寺院的防禦裝置(6)	Narvas Temple's Barrier (6)	나르바스 사원의 방어막(6)
那魯巴斯寺院的防禦裝置(7)	Narvas Temple's Barrier (7)	나르바스 사원의 방어막(7)
那魯巴斯寺院的防禦裝置(8)	Narvas Temple's Barrier (8)	나르바스 사원의 방어막(8)
那魯巴斯寺院的防禦裝置(9)	Narvas Temple's Barrier (9)	나르바스 사원의 방어막(9)
獅子的嘴裡(1)	In to the Lion's Mouth (1)	사자의 입 속으로(1)
獅子的嘴裡(2)	In to the Lion's Mouth (2)	사자의 입 속으로(2)
魔族會不會發現呢？	Won't the demons notice us?	마족이 눈치채지 않을 거냐고 묻는다
獅子的嘴裡(3)	In to the Lion's Mouth (3)	사자의 입 속으로(3)
獅子的嘴裡(4)	In to the Lion's Mouth (4)	사자의 입 속으로(4)
獅子的嘴裡(5)	In to the Lion's Mouth (5)	사자의 입 속으로(5)
你是指誰呢？	Who are you talking about?	누구를 말하는거냐고 묻는다
獅子的嘴裡(6)	In to the Lion's Mouth (6)	사자의 입 속으로(6)
停止靈魂加工裝置中	Stopping the spirit transformation device	영혼 가공 장치 정지시키는 중
獅子的嘴裡(7)	In to the Lion's Mouth (7)	사자의 입 속으로(7)
獅子的嘴裡(8)	In to the Lion's Mouth (8)	사자의 입 속으로(8)
放入幻影再生器中	Placing the Apparition Generator	환영의 재생구 넣는 중
獅子的嘴裡(9)	In to the Lion's Mouth (9)	사자의 입 속으로(9)
獅子的嘴裡(10)	In to the Lion's Mouth (10)	사자의 입 속으로(10)
一個個依照順序	One by One	하나씩 차례대로
隱密與偉大(1)	Suspiciously Secretive (1)	은밀하고 위대하게(1)
該怎麼找呢？	How shall I conduct the search?	어떻게 찾아야 하냐고 묻는다
隱密與偉大(2)	Suspiciously Secretive (2)	은밀하고 위대하게(2)
加入黑色霍亨歐班肉片當中	Placing the flesh of Black Hohen Olben	검은 호헨 올벤의 살접 집어넣는 중
隱密與偉大(3)	Suspiciously Secretive (3)	은밀하고 위대하게(3)
加入巨錘王的血當中	Placing King Hammer's Blood	킹 해머의 피를 넣는 중
已經加入巨錘王的血了	Placed King Hammer's Blood	킹 해머의 피를 집어 넣었습니다
隱密與偉大(4)	Suspiciously Secretive (4)	은밀하고 위대하게(4)
隱密與偉大(5)	Suspiciously Secretive (5)	은밀하고 위대하게(5)
隱密與偉大(6)	Suspiciously Secretive (6)	은밀하고 위대하게(6)
隱密與偉大(7)	Suspiciously Secretive (7)	은밀하고 위대하게(7)
你打算怎麼做呢？	How would you like to do this?	어떻게 할 것이냐고 묻는다
隱密與偉大(8)	Suspiciously Secretive (8)	은밀하고 위대하게(8)
加入黑色哈路卡爾的精髓中	Placing essence of Black Harugal	검은 하루갈의 정수를 넣는 중
隱密與偉大(9)	Suspiciously Secretive (9)	은밀하고 위대하게(9)
隱密與偉大(10)	Suspiciously Secretive (10)	은밀하고 위대하게(10)
隱密與偉大(11)	Suspiciously Secretive (11)	은밀하고 위대하게(11)
再次啟動那魯巴斯寺院	Reactivating Narvas Temple	나르바스 사원 재 가동
那魯巴斯寺院的長夢(1)	Long Dreams Are Dreamt at Narvas Temple (1)	긴 꿈은 나르바스 사원에서 지고(1)
使用傳點中	Using the portal	포탈 사용 중
那魯巴斯寺院的長夢(2)	Long Dreams Are Dreamt at Narvas Temple (2)	긴 꿈은 나르바스 사원에서 지고(2)
聽見你的歌聲(9)	I Can Hear You Singing (9)	너의 노래소리가 들려(9)
與瘟疫醫生尤克利那斯對話	Talk to Plague Doctor Jugrinas	플레이그 닥터 유그리나스와 대화
服用緊急用諾貝禮爾傳染病治療劑 	Take the Medicine Against the Nobreer Epidemic	임시 노브리어 역병 치료제 복용
與尤克利那斯對話	Talk to Jugrinas	유그리나스와 대화
去找傳染病的治療方法	Finding a Cure for the Epidemic	역병의 치료법을 찾아서
回收尤克利那斯的	Retrieve Jugrinas' Testing Solution	유그리나스의 시험액 회수
轉交給尤克利那斯	Deliver to Jugrinas	유그리나스에게 전달
在諾貝禮爾十字路口安裝傳染病感應石	Set the Epidemic Detectors on Nobreer Intersection	노브리어 사거리에 역병 감지석 설치
向尤克利那斯報告	Report to Jugrinas	유그리나스에게 보고
在下層運輸地那裏尋找植物標本採集道具	Find the Sample Collecting Tools at the Lower Shipping Station	하부 운송지에서 식물 표본채집 도구 찾기
到諾貝禮爾瀑布去採集植物標本吧!	Collect Plant Samples at Nobreer Falls	노브리어 폭포에서 식물 표본 채집
到神樹石橋去尋找希凱斯用過的工具	Find Cicas' Tools at Big Tree Footbridge	거목 징검다리에서 시카스가 사용하던 도구 찾기
使用特殊溶液消滅怪物	Spray Monsters with the Special Solution and Defeat Them	특수 용액 사용 후 몬스터 처치
傳染病的真面目	The Truth Behind the Epidemic	역병의 정체
到諾貝禮爾十字路口確認傳染病感應石	Check the Epidemic Detectors in Nobreer Intersection	노브리어 사거리에서 역병 감지석 확인
回收諾貝禮爾十字路口的傳染病感應石	Collect the Epidemic Detectors at Nobreer Intersection	노브리어 사거리에서 역병 감지석 회수
前往不祥的氣息圍繞著的避難營	Check the Evac Route for Ominous Energy	불길한 기운이 느껴졌던 피난로로 가기
消滅格林利波	Defeat the Grim Reaper	그림 리퍼 처치
拉伊瑪留下的預言之書	Laima's Prophecy Tome	라이마가 남긴 예언의 서
與奎波爾蕾妮亞對話	Talk to Kupole Lenja	큐폴 레냐와 대화
確認預言石塔	Attest to the Prophecy Pagodas	예언의 석탑 확인
從命運的寶珠吸取命運的力量	Receive the Power of Fate from the Orb of Fate	운명의 보주에서 운명의 힘 흡수
魔族的誓約	Demon Treaty	마족의 서약
確認誓約的封印	Check the Treaty Seal	서약의 봉인 확인
封印的光換成其他顏色	Change the Colors of the Treaty Lights	봉인의 빛을 서로 다른 색으로 바꾸기
解除守護誓約的封印的保護	Disable the Magic Protecting the Treaty Seal	서약의 봉인을 지키는 보호 마법 해제
消滅怪物獲得尤德伊安的邪惡的血	Defeat Monsters to Obtain the Impure Blood of Yudejan	몬스터를 처치해서 유데이안의 부정한 피 획득
用魔族的氣息填滿尤德伊安的邪惡的血	Imbue the Impure Blood of Yudejan with Demon Energy	유데이안의 부정한 피에 마족의 기운 채우기
回收坦索斯依凱提瑪的魔族的誓約	Retrieve the Demon Treaty in Tamsus Ikeitimas	탐소스 이케이티마스에서 마족의 서약 회수
回收魔族的誓約	Retrieve the Demon Treaty	마족의 서약 회수
女神的誓約	Goddess Treaty	여신의 서약
解除被束縛在誓約封印的魔族的封印	Release the Demon Seal Connected to the Treaty Seal	서약의 봉인에 걸린 마족의 봉인 해제
尋找女神的信賴石	Find the Goddess' Stone of Faith	여신의 신뢰석 찾기
用女神的信賴石來閱讀碑石上的筆跡可解除封印	Use the Goddess' Stone of Faith to Read the Tombstone and Release the Seal	여신의 신뢰석으로 비석의 글귀를 읽고 모든 봉인 해제
獲得女神的誓約	Obtain the Goddess Treaty	여신의 서약 획득
女神與魔族的故事	A Story of Demons and Goddesses	여신과 마족의 이야기
解除誓約的封印	Release the Treaty Seal	서약의 봉인 해제
尋找裝有誓約的石板的保管箱	Find the Box Containing the Treaty Slate	서약의 석판이 들어있는 보관함 찾기
利用尤德伊安的祭壇確認誓約的內容	Use the Yudejan Altar to Read the Treaty	유데이안의 제단을 이용해서 서약의 내용 확인
阿爾蘭必的事情	Alembique Tales	알렘빅 이야기
和凱都拉商團成員愛爾塔對話	Talk to Kedoran Alliance Merchant Alta	케도라 상단원 알타와 대화
尋找基高傭兵團	Find the Gigho Mercenaries	기고 용병단 찾기
和傭兵海藍達對話	Talk to Mercenary Heranda	용병 헤란다와 대화
去跟看起來很不安的傭兵海藍達對話吧！	Talk to nervous Mercenary Heranda	불안해 보이는 용병 헤란다와 대화하세요
去見聖水祭司 謝爾貝卡	Go to Priest Celvica	프리스트 셀베카 찾아가기
前往傭兵黑蘭塔告訴你的地方，找祭司賽貝卡吧。	Find Priest Celvica in the area told by Mercenary Heranda	용병 헤란다가 알려준 지역으로 이동하여 사제 셀베카를 찾으세요
回到傭兵海藍達那裡去	Return to Mercenary Heranda	용병 헤란다에게 돌아가기
尋找傭兵海藍達的下落	Find Traces of Mercenary Heranda	용병 헤란다의 흔적 찾기
和聖水祭司謝爾貝卡對話	Talk with Priest Celvica	프리스트 셀베카와 대화
尋找團長一行人	Find the officer group	단장 일행 찾기
與團長基高對話	Talk to Commanding Officer Gigho	단장 기고와 대화
回收傭兵團解毒劑	Retrieve Mecenary Company Antidote	용병단 해독제 회수
回到團長基高那裡	Return to Commanding Officer Gigho	단장 기고에 돌아가기
回到聖水祭司 謝爾貝卡那裡	Return to Priest Celvica	프리스트 셀베카에게 돌아가기
尋找埃德林的下落	Find Traces of Edeline	에델린의 흔적 찾기
聖水祭司賽貝卡懇求你前往團長基高所告知的地方，把艾德林找回來。	Priest Celvica begs you to find Edeline in the area told by Commanding Officer Gigho	프리스트 셀베카는 단장 기고가 알려준 곳으로 가서 에델린을 찾아달라고 간청했습니다
去跟聖水祭司謝爾貝卡對話吧！	Talk to Priest Celvica	프리스트 셀베카와 대화하세요
去見凱都拉 商團成員 愛爾塔	Find Kedoran Alliance Merchant Alta	케도라 상단원 알타 찾아가기
尋找阿爾蘭必 洞窟的紀錄	Find the Alembique Cave Scriptures	알렘빅 동굴 기록 찾기
收集鐘乳石塊 	Collect Stalactite Chunks	종유석 덩어리 수집
清除謎樣的魔族裝置	Remove the Mysterious Demon Device	수수께끼의 마족장치 제거
消滅洞穴毒妖花	Defeat Cave Ravinelarva	동굴 러바인러바 처치
第一位客人的角色	First Guest's Role	첫 손님의 역할
和奈凌卡交談	Talk to Neringa	네링가와 대화
進入幻想圖書館	Enter Fantasy Library	환상도서관 진입
和巴伊寶拉女神對話	Talk to Goddess Vaivora	여신 바이보라와 대화
消滅入侵的魔族	Defeat the demons who have infiltrated the place	침입한 마족 처치
消滅周邊的魔族	Defeat the demons in the area	주변 마족 처치
收集四散的記錄紙	Collect Scattered Records	흩어진 기록지 수집
被束縛的命運	Nailed Down Destiny	틀에 갇힌 운명
破壞魔族的奎波爾陷阱	Remove demons' Kupole traps	마족의 큐폴 덫 제거
與奎波爾魯吉萊對話	Talk to Kupole Rugile	큐폴 루길레와 대화
破壞魔族進攻地點	Remove the demons' points of invasion	마족 침공지점 제거
前往影子底下	Going Below the Shadow	그림자 밑으로
破壞被污染的水晶	Destroy the corrupted crystals	오염된 수정 파괴
和奎波爾沙耶交談	Talk to Kupole Saya	큐폴 사야와 대화
奎波爾沙耶在沙烏席斯10館等你。	Kupole Saya is waiting for you in Sausis Room 10	사우시스 10관에서 큐폴 사야가 당신을 기다리고 있습니다
收集特拉休姆碎片	Collect Trasium Pieces	트라시움 조각 수집
破壞魔力牢獄	Deactivate the Magic Prison	마력 감옥 해제
和奎波爾薇塔交談	Talk to Kupole Ouida	큐폴 위다와 대화
和觀看者碰面	Face to Face with the Beholder	주시자와 대면
需要的失誤	Necessary Mistake	필요한 실수
和奎波爾黎泰交談	Talk to Kupole Litae	큐폴 리테와 대화
補充魔力裝置	Recharge the Magic Device	마력장치 충전
收集諾伯烈奈動力	Collect Nobrenal Powers	노브레날 동력 수집
和奎波爾塔奴泰交談	Talk to Kupole Danute	큐폴 다누테와 대화
收集維持魔力裝置所需要的工具	Collect the necessary tools for maintaining the magic device	마력장치 유지를 위한 도구 수집
保護守護水晶	Protect the Protection Crystal	수호의 수정 지키기
封印儀式專用祭壇	Sealing Altar	봉인 의식용 제단
沒有記錄的歷史	The History that Will Not Be Recorded	기록되지 않을 역사
保護普洛諾德崩壞裝置	Protect the Bluenode Collapsing Device	블로노드 붕괴장치 보호
收集巨大魔力源	Collect Monumental Magic Sources	거대 마력원 수집
啟動普利西德崩壞裝置	Activate the Flicid Collapsing Device	플리시드 붕괴장치 가동
和奎波爾斯卡伊娃交談	Talk to Kupole Scaia	큐폴 스카이아와 대화
啟動巴蘭達爾崩壞裝置	Activate the Ballandans Collapsing Device	발란디르 붕괴장치 활성화
消滅魔君魯希	Defeat Demon Lord Lucy	마군주 루시 처치
黑翼的影子	Shadow of the Black Wing	검은 날개의 그림자
破壞魔族次元門	Destroy Demon Dimensional Door	마족 차원문 파괴
追蹤吉特涅	Track down Giltine	길티네 추적
對抗魔神吉特涅	Confront Demon Goddess Giltine	마신 길티네에게 맞서기
消滅具備魔力信號的魔族	Defeat the demons carrying Magic Signals	마력 신호를 지닌 마족 처치
與難民布蘭登對話	Talk to Refugee Brandon	피난민 브랜든과 대화
到圖拉斯空地去收集白尾草	Collect Whitetailed Grass from Turas Lot	튜라스 공터에서 흰꼬리풀을 수집
連續陷阱	Traps and more traps	연이은 함정
消滅被陷阱困住的怪物	Deal with the trapped monsters	함정에 같이 갇힌 몬스터 처치
消滅變得殘暴的怪物	Deal with the violent monsters	난폭해진 몬스터 처치
從陷阱逃出	Getting out of the trap	함정에서 빠져나오기
與謎樣獵人的對話	Talk to the Mysterious Hunter	수수께끼 사냥꾼과의 대화
追蹤謎樣的獵人	Track the mysterious hunter	수수께끼의 사냥꾼을 추적하기
跟蹤謎樣的獵人	Track the mysterious hunter	수수께끼의 사냥꾼의 뒤를 쫓기
與謎樣的獵人對話	Talk with the mysterious hunter	수수께끼의 사냥꾼과 대화
和比爾黑爾馬斯對話	Talk to Vilhelmas	빌헬마스와 대화
消滅比爾黑爾馬斯指定的怪物	Defeat the monsters indicated by Vilhelmas	빌헬마스가 지정한 몬스터 처치
消滅附近的庫凱利	Defeat the Kugheri in the surrounding area	주변의 쿠게리 처치
繁複的準備過程	Complicated Preparations	까다로운 준비 과정
從庫凱利托特身上收集被刺激的毒袋子	Collect stimulated poison sacks from Kugheri Tots	쿠게리 토트에게서 자극받은 독주머니 수집
從比爾黑爾馬斯身上引誘出黃色烏頭花	Lead Vilhelmas to the Yellow Wolfsbane	빌헬마스를 노란 투구꽃으로 인도
從庫凱利蘇米身上收集麻醉藥	Collect paralysis poison from Kugheri Somys	쿠게리 소미에게서 마비약 모으기
將怪物趕到陷阱裡	To trap a beast	괴수를 함정으로 몰아넣기
在路口設置陷阱	Setting the trap	길목에 함정 설치
等待怪物	Waiting for the beast	괴수를 기다리기
跟在怪物後面	Pursuing the beast	괴수의 뒤를 쫓기
與怪獸的最後決戰	The Beast's Final Stand	괴수와의 마지막 결전
對怪物施加暴撃	Critically Wounding the Beast	괴수에게 치명상입히기
消滅怪物	Defeat the beast	괴수를 처치
和難民蜜莉亞對話	Talk to Refugee Mylija	피난민 밀리아와 대화
獲得葉豆精的果實豆	Obtain Leafnut Tailfruits	리프넛의 꼬리열매 획득
與難民克雷格對話	Talk to Refugee Greg	피난민 그렉과 대화
收集堅硬木棍	Collect Hard Wooden Sticks	단단한 나무막대 수집
接受兩位領主的協議內容	Getting the two lords to agree to talk	두 영주의 대화약속 받아내기
說服里烏達斯領主	Persuading Lord Ryudhas	리우다스 영주 설득하기
與領主里烏達斯對話	Talk to Lord Ryudhas	영주 리우다스와 대화
挖掘帕里堤斯草的根	Dig up Pystis Grass Roots	피스티스 풀의 뿌리 캐기
收集橘色克魯莫的腿	Collect Orange Grummer legs	주황 그루머의 다리 수집
在受雙傷的樹木下挖掘玩具箱子	Dig up the Toy Box from beneath the marked tree	상처있는 나무에서 장난감 상자 파내기
說服優庫巴斯領主	Persuade Lord Joquvas	요쿠바스 영주 설득하기
和領主優庫巴斯對話	Talk to Lord Joquvas	영주 요쿠바스와 대화
和羅貝勒塔對話	Talk to Roberta	로베르타와 대화
消滅紅色曼陀花獸	Defeat the Red Colimen	붉은 콜리멘 처치
到阿克梅尼斯湖邊的廢墟尋找盾牌	Search the ruins at Arcmnys Lake for the shield	아크메니스 호숫가의 폐허에서 방패 찾기
跟羅貝勒塔一起確認紀念碑	Go and check the Monument with Roberta	로베르타와 함께 기념비 확인
前往兩位領主間的會面場所	Go to where the two lords are having a conversation	두 영주 간의 회합장소로 찾아가기
跟隨兩位領主	Follow the two lords	두 영주의 뒤를 쫓기
把兩位領主從怪物手中救出	Save the two lords from the monsters	두 영주를 몬스터로부터 구하기
消滅威脅領主性命的怪物	Defeat the monsters attacking the two lords	영주들을 위협하는 몬스터 처치
與印德拉雅對話	Talk to Indraja	인드라야와 대화
收集席拉蒲公英的露水	Collect dew from Slya Dandelions	실라 민들레의 이슬 수집
消滅庫凱利扎巴與庫凱利奏伊尼	Defeat Kugheri Zeuni and Kugheri Zabbi in the surrounding area	쿠게리 자비와 쿠게리 저이니 처치
消滅庫凱利奏伊尼跟庫凱利扎巴	Defeat the Kugheri Zabbi and Zeuni	쿠게리 저이니와 쿠게리 자비 처치
從庫凱利扎巴掌握住魔族的指令書	Obtain more demon orders from the Kugheri Zabbi	쿠게리 자비로부터 마족의 지령서를 습득
消滅魔族巴爾泰力斯後回收王稜的箱子	Defeat Vhalterris and retrieve the Royal Mausoleum's chest	마족 발테리스를 처치하고 왕릉의 상자 회수
找出被魔法下咒的樹木啟動紋章的反應	Find the trees and see how the seal reacts	마법걸린 나무들을 찾아 문장 반응시키기
調查拉伊卡斯交叉路	Investigate Lykhas Crossroads	라이카스 교차로를 조사
靜候裝置反應	Observe the device's reaction	장치의 반응을 지켜보기
利用王家之紋章吸收 庫凱利的靈魂	Absorb Kugheri souls with the Royal Seal	왕가의 문장에 쿠게리의 영혼 흡수시키기
收集庫凱利努瑪尼的魔杖	Collect Kugheri Numani Staffs	쿠게리 누마니의 지팡이 수집
消滅庫凱利部族	Deal with the Kugheri Tribe	쿠게리 부족을 처치
消滅庫凱利部族	Deal with the Kugheri Tribe	쿠게리 부족 처치
與史基爾戈意拉對話	Talk to Skirgaila	스키르가일라와 대화
與觀看者交談	Talk to the Beholder	주시자와 대화
吸收暮色雙手劍休憩地的水晶石的魔力	Absorb magic from a Crystal stone in Prieblanda Rest Place	프리에블란다 쉼터의 수정석의 마력을 흡수
吸收萊堤斯空地水晶石的魔力	Absorb magic from a Crystal Stone in Lemtis Lot	렘티스 공터 수정석의 마력을 흡수
調查萊堤斯空地的水晶石	Investigate the Crystal Stone in Lemtis Lot	렘티스 공터의 수정석 조사하기
交叉路的水晶石	Crystal Stone in the crossroad	교차로의 수정석
吸收基普卡斯交叉路水晶石的魔力	Absorb magic from the Crystal Stone in Zibukas Crossroad	지부카스 교차로 수정석의 마력을 흡수
吸收魔法無效化工具的魔力	Absorb magic with a Magic Nullifying Tool	마법 무효화 도구에 마력 흡수
觀察交叉路的周圍	Investigate the area around the crossroad	교차로 주변을 살피기
消滅奇襲的怪物	Defeat ambushing demons	기습한 몬스터들 처치
和魔君蘇科姆戰鬥	Battle with Demon Lord Solcomm	마군주 솔콤과 전투
燒毀補給品寶箱	Burn the Supply Boxes	보급품 상자 태우기
調查基普卡斯交叉路	Investigate Zibukas Crossroad	지부카스 교차로 조사
焚燒交叉路上的補給品推車	Burn the supplies wagon at the crossroad	교차로에 있던 보급품 수레 소각
消滅藍扣 26水域一帶的魔族	Defeat demons around Lanko 26 Waters	란코 26수역 일대 마족들 처치
新人在哪裡	Where is the Recruit?	신입은 어디에
和亞普拉奧摩斯對話	Talk to Abraomas	아브라오마스와 대화
尋找新人的痕跡	Track down the recruit	신입의 흔적 찾기
尋找新人的行蹤	Look for the recruit	신입의 행방 찾기
尋找新人的線索	Looking for clues on the recruit	신입의 단서 찾기
和雷歐納勒達斯對話	Talk to Leonardas	레오나르다스와 대화
找出逃跑的蘇科姆	Find Solcomm	도망간 솔콤을 찾아내기
和魔君蘇科姆交談	Talk to Demon Lord Solcomm	마군주 솔콤과 대화
破壞那吉魯斯後院的水晶石	Destroy the crystal stone in Negilus Inner Court	네길루스 안뜰의 수정석 파괴
庭院的水晶石	Crystal stone in the garden	정원의 수정석
製作魔法消除炸彈	Craft a Magic Nullification Bomb	마법 제거 폭탄 제작
魔法消除炸彈	Magic Nullification Bomb	마법 제거 폭탄
破壞奧羅庭園的水晶石	Destroy the crystal stone in Oro Garden	오로 정원의 수정석 파괴
和蘇科姆交談	Talk to Solcomm	솔콤과 대화
啟動德雷格納思空地的自爆裝置	Activate the self-destruction device in Dregnas Lot	드래그나스 공터의 자폭 장치 작동
和蘇科姆戰鬥	Battle with Solcomm	솔콤과 전투
收集零件	Collect ingredients	부속물 모아오기
在倉庫尋找催化劑	Find catalysts from the storage	창고에서 촉매제 찾기
在箱子裡尋找魔法效果催化劑	Found a Magic Catalyst inside the box	상자 속에서 마법 효과 촉매제 찾기
組合蘊含湖水靈氣的樹液	Combine the Sap with the Lakeland Spirits	호수의 정기를 담은 수액 조합
向怪物確認樹液反應	Testing the sap on monsters	몬스터에게서 수액 반응 확인
消滅周圍的魔族與怪物	Defeat the surrounding demons and monsters	주변의 마족 및 몬스터 처치
傳說的證據	Marks of a Legend	전설의 흔적
和亞奎爾拉斯對話	Talk to Aquilas	아퀼라스와 대화
去跟亞奎爾拉斯對話吧！	Talk to Aquilas	아퀼라스와 대화하세요
採集周圍的植物	Gather vegetation from the surrounding area	주변 식물들 구하기
請幫助亞奎爾拉斯採集周圍的植物吧	Help Aquilas by gathering vegetation from the surrounding area	아퀼라스를 도와 주변에 있는 식물들을 채집하세요
與梅坎對話	Talk to Mechen	메켄과 대화
請與梅坎對話	Talk to Mechen	메켄과 대화하세요
和烏格尼斯對話	Talk to Woognis	우그니스와 대화
去跟烏格尼斯對話吧！	Talk to Woognis	우그니스와 대화하세요
取得比爾卡斯的發出臭味的毛	Gather foul smelling Vilkas fur	빌카스의 냄새 나는 털 구하기
搜索比爾卡斯的 棲息地	Search the Vilkas nest	빌카스의 서식지 수색
到凱依內渡口去找傑諾納斯	Find Jenonhas at Kainen Crossing	카이넨 나루터에서 제노나스 찾기
和傑諾納斯對話	Talk to Jenonhas	제노나스와 대화
去跟傑諾納斯對話吧！	Talk to Jenonhas	제노나스와 대화하세요
前往梅坎的營地去看看	Return to Mechen's camp	메켄의 캠프로 가보기
到梅坎的營地去阻止傑諾納斯吧！	Return to Mechen's camp and stop Jenonhas	메켄의 캠프로 가 제노나스를 말리세요
去跟造箭者大師對話吧！	Talk to the Fletcher Master	플레쳐 마스터와 대화하세요
取得洛姆貝爾努卡的魔力精髓	Obtain Romplenuka magic essence	롬펠누카의 마력 정수 구하기
取得比爾卡斯的 精髓	Obtain Vilkas essence	빌카스의 정수 구하기
利用造箭者之箭探測裝置取得造箭者之箭	Find the Flechette by using the Flechette Detection Device	플레세트 탐색 장치로 플레세트 찾기
請用完成的造箭者之箭探索裝置，尋找造箭者之箭吧	Find the Flechette with the Flechette Detection Device	완성된 플레세트 탐색 장치로 플레세트를 찾으세요
梅伊班的遺願	Maven's Wishes	메이번의 유지
和祭司林塔斯對話	Talk to Priest Lintas	사제 린타스와 대화
去跟祭司林塔斯對話	Talk to Priest Lintas	사제 린타스와 대화하세요
找尋變身魔法解除文件	Find the documents on dispelling transformation magic	변형 마법 해제 문서 찾아오기
請依怪物找回分散的解除變形魔法文件。	Retrieve the documents that have been scattered due to the monsters	몬스터에 의해서 흩어진 변형 마법 해제 문서를 되찾아오세요.
利用活力之球去取得寶珠	Find the Orb by using the Orb of Vigor	활력의 구로 활용해 보주 찾기
跟隨祭司林塔斯	Follow Priest Lintas	사제 린타스를 따라가기
與祭司林塔斯一起尋找卡杜梅爾國王	Find King Kadumel's Monument with Priest Lintas	사제 린타스와 함께 카듀멜 국왕의 기념비를 찾기
找尋美泰爾藥草	Gather Mittelly Herbs	미탤리 약초 구하기
取得比爾卡斯的閃亮亮皮膚	Obtain Vilkas's dry skin	빌카스의 바짝 마른 피부 구하기
燃燒蕨葉	Burn the bracken	고사리들 불태우기
利用探測器尋找卡杜梅爾國王的紀念碑	Find King Kadumel's Monument with the detector	탐지기로 카듀멜 국왕의 기념비를 찾기
去跟祭司林塔斯對話吧！	Talk to Priest Lintas	사레 린타스와 대화하세요
尋找卡杜梅爾國王第3個紀念碑碎片	Find fragmenst from King Kadumel's third Monument	카듀멜 국왕의 세번째 기념비 파편 찾기
除草作業	Weeding	제초 작업
與祭司奇達斯對話	Talk to Priest Kidas	사제 키다스와 대화
去跟與祭司奇達斯對話吧！	Talk to Priest Kidas	사제 키다스와 대화하세요
取得比爾卡斯的唾液腺	Gather Vilkas salivary glands	빌카스의 침샘 구하기
去見祭司布魯納斯	Find Priest Brunas	사제 브루나스 찾기
祭司布魯納斯對話	Talk to Priest Brunas	사제 브루나스와 대화
去跟祭司布魯納斯對話吧！	Talk to Priest Brunas	사제 브루나스와 대화하세요
回收造箭者之箭	Retrieve the Flechette	플레세트 회수하기
去回收造箭者之箭吧！	Retrieve the Flechette	플레세트를 회수하세요
與奧爾拉對話	Talk to Ohla	올라와 대화
去跟奧爾拉對話吧！	Talk to Ohla	올라와 대화하세요
去見里耶爾	Find Liel	리엘 찾기
尋找白樹林飛蛾的蟲蛹	Find White Tree Forest Moth Cacoons	흰나무숲 나방의 고치 찾기
把白樹林飛蛾的蟲蛹轉交給奧爾拉	Hand the Forest Moth Cocoons to Ohla	올라에게 흰나무숲 나방의 고치 전달
和柯提斯對話	Talk to Curtis	커티스와 대화
去跟柯提斯對話吧！	Talk to Curtis	커티스와 대화하세요
利用糧食來取得實用的物品	Find edible objects	식량으로 쓸만한 것 구해다 주기
製作柵欄修理工具需要的木材	Make the lumbers to reapir the stack stockades	방책 수리도구에 필요한 목재 만들기
修理柵欄	Repairing the barricade	방책 수리하기
取得普羅雷比的皮革	Gather Flowlon Leather	플로론의 가죽 구하기
取得蘭朵林草	Gather Randulin Grass	란둘린 초 구하기
回收零件布袋	Retrieve the Sacks of Cable Car Spare Parts	부품 자루 회수하기
消謬農耕地裡的怪物	Defeat monsters in the farm	농경지 안에 있는 몬스터 처치하기
聽見你的歌聲	I Can Hear You Singing	너의 노래소리가 들려
尋找隱約聽見的聲音	Follow the faint sound	어렴풋이 들리는 소리를 찾아가기
尋找知道該歌聲的人	Find someone who knows the song	노래소리를 알 법한 사람을 찾아가기
跟隨茵德蕾雅	Follow Indrea	인드레아 따라가기
和茵德蕾雅交談	Talk to Indrea	인드레아와 대화하기
收集亞迪的黃色汁液	Collect Atti Yellow Juice	아띠의 노란 즙액을 모으기
使用亞迪的黃色汁液取得泰雷希花粉	Use Yellow Juice to gather Teresh Pollen	아띠의 노란 즙액을 사용해 테레쉬 꽃가루 구하기
傾聽樹木發出的聲音	Listen to the sound from the tree	나무에서 들리는 소리를 듣기
跟隨茵德蕾雅	Follow Indrea	인드레아를 따라가기
製作樹梅汁	Craft Raspberry Juice	라즈베리 즙을 만들어서 구하기
使用散發樹梅香的樹枝引誘星星螢火蟲	Attract Starlights to the branches with the raspberry scent	라즈베리 향이 나는 나뭇가지로 별반딧불이 유인하기
和茵德蕾雅一起傾聽歌聲	Listen to the song with Indrea	인드레아와 함께 노래 소리를 듣기
依照歌詞行動	Do as the lyrics say	노래의 가사대로 행동하기
消滅出現的遠古石龜獸	Defeat Rocktortuga	나타난 락토르투가를 처치하기
思考歌詞後再行動	Follow the song's lyrics	노래 가사를 생각해 행동하기
請與茵德蕾雅交談。	Talk to Indrea	인드레아와 대화하세요.
和看似沒有主人的狗交談	Talk to the dog with no owner	주인 없는 보이는 개와 대화하기
跟著狗一起走	Follow the dog	개를 따라가기
前往那魯巴斯寺院	Go to Narvas Temple	나르바스 사원으로 가기
全神貫注	Creating Distractions	이목 집중
閱讀紙條	Read the instruction	메모지를 읽어 보기
取得思波勒奇莫花	Collect Sporgimo flowers	스포르기모 꽃 구하기
放置思波勒奇莫花	Place Sporgimo flowers	스포르기모 꽃 놓기
點燃思波勒奇莫花	Burn the placed Sporgimo flowers	스포르기모 꽃 불 태우기
移動到適合躲藏的地方	Go find a place to hide	몸 숨기기 좋은 장소로 이동하기
前往那魯巴斯寺院	Go to Narvas Temple	나르바스 사원으로 이동하기
突破魔族的防線	Go through the demons' defense line	마족들의 방어선 뚫기
消滅妨礙前往那魯巴斯寺院的怪物	Defeat monsters who are on your way	나르바스 사원으로 이동을 방해하는 몬스터를 처치
那魯巴斯寺院的防禦裝置	Narvas Temple's barrier	나르바스 사원의 방어막
與修道士艾斯堤司交談	Talk to Monk Aistis	수도사 아이스티스와 대화
收集魔族的精髓	Gather Demonic Essence	마족의 정수를 구하기
電氣竄流的石頭	Break the auxiliary detector system	보조 감지 시설 작동 중지 시키기
將零件帶去附近的防禦設施	Bring the parts from a destroyed defensive system nearby	근처에 파괴된 방어시설에게 부품 가져오기
收集流出的能量	Collect the leaked energy	빠져나오는 에너지를 모으기
回收的能量注入防禦設施	Inject the gathered energy into the defensive system	수거한 에너지를 방어시설에 넣기
確認防禦設施正常運作	Check how the defensive system is working	방어 시설이 제대로 작동하는 것을 확인하기
消滅企圖進入那魯巴斯寺院的魔族	Defeat demons who are entering Narvas temple	나르바스 사원으로 진입하려는 마족 처치하기
獅子的嘴裡	Into the Lion's Mouth	사자의 입 속으로
消滅猜忌哈勃克的追隨魔族	Defeat followers of Suspicion Hauberk	의심의 하우벅 추종 마족 처치하기
消滅企圖破壞弗羅里設施的哈勃克追隨者	Defeat followers of Suspicion Hauberk who are trying to destroy Flurry's equipment	플러리의 시설을 파괴하려는 하우벅 추종자들을 처치하기
收集魔族的強力精髓	Gather Strong Essence of Demon	마족의 강력한 정수 구하기
收集黑色霍亨博學者的血	Collect Black Hohen Mage's blood	검은 호헨 메이지의 피를 구하기
收集混雜魔族之血的聖水	Collect Holy water mixed with demonic blood	마족의 피가 섞인 성수 수집하기
偷聽野心的哈勃克和他的追隨魔族交談的內容	Eavesdrop on Ambition Hauberk and his followers	야망의 하우벅과 그의 추종 마족이 하는 이야기를 엿듣기
請和修道士艾斯堤司交談	Talk to Aistis	수도사 아이스티스와 대호하세요
消滅正在加工修道士靈魂的魔族	Defeat the demons who are transforming monks' spirits	수도사들의 영혼을 가공하고 있는 마족 처치
請停止靈魂加工設施的運作。	Break the spirit altering device	영혼 가공 시설 작동 중지시키세요
收集魔力結晶	Collect Magic Crystals	마력 결정 모으기
觀察來歷不明的設施	Look around the unidentified facility	정체불명의 시설을 살펴보기
在上鎖設施中獲得幻影再生器	Retrieve the Apparition Generator from the locked system	잠금시설에서 환영의 재생구 획득하기
將上鎖設施中取得的零件放入來歷不明的設施中	Place the parts in the unidentified facility	잠금시설에서 가져온 부품을 정체불명의 시설에 넣기
和亞佳伊拉弗羅里的幻影交談	Talk to Agailla Flurry Apparition	아가일라 플러리의 환영체와 대화
將魔力結晶交給修道士艾斯堤司	Give the magic crystal to Aistis	수도사 아이스티스에게 마력 결정을 전달하기
接近欺瞞的哈勃克	Approach Deception Hauberk	기만의 하우벅에게 접근하기
隱密與偉大	Suspiciously Secretive	은밀하고 위대하게
亞佳伊拉弗羅里的設施零件	Agailla Flurry's equipment	아가일라 플러리의 시설 부품
收集魔族的肉塊	Gather Demon's Flesh	마족의 살점 구하기
消滅猜忌哈勃克的核心追隨者	Defeat a core follower of Suspicion Hauberk	의심의 하우벅 핵심 추종자 처치하기
接近猜忌的哈勃克	Approach Suspicion Hauberk	의심의 하우벅에게 접근하기
讓契約信物變形	Alter the Contract Token	계약의 증표 변형시키기
將契約信物交給猜忌的哈勃克	Give the Contract Token to Suspicion Hauberk	의심의 하우벅에게 계약의 증표 전달하기
修改記錄寶珠的內容	Alter the Registry Orb	기록의 보주 내용 수정하기
收集精銳哈勃克追隨者的精髓	Find the essence of an elite follower of Hauberk	정예 하우벅 추종자의 정수 구하기
觀察野心哈勃克的情況	Observe Ambition Hauberk's situation	야망의 하우벅의 상황 살피기
將零件交給修道士艾斯堤司	Give the parts to Monk Aistis	수도사 아이스티스에게 부품 전달하기
修理中央控制裝置	Repair the Central Control Terminal	중앙 제어 장치 수리하기
那魯巴斯寺院的長夢	Long Dreams Are Dreamt at Narvas Temple	긴 꿈은 나프탈리 수도원에서 지고
使用傳點裝置	Use the Warp Device	워프 장치를 이용하기
消滅合為一體的哈勃克	Defeat the united Hauberk	하나가 된 하우벅을 처치하기
回收散落四處的文件	Retrieve the scattered documents	흩어진 문서를 회수하는 중
已獲得文件	You have retrieved some documents	문서를 획득했습니다
戴利亞貝利斯	Teliavelis	테리아베리스
貝爾庫波的盔甲(1)	Velcoffer Armor (1)	벨코퍼의 갑주(1)
貝爾庫波的盔甲(2)	Velcoffer Armor (2)	벨코퍼의 갑주(2)
貝爾庫波的盔甲	Velcoffer Armor	벨코퍼의 갑주
消滅貝爾庫波	Defeat Velcoffer	벨코퍼를 처치하기
和戴利亞貝利斯對話	Talk to Teliavelis	테리아베리스와 대화
奧維尼亞狄爾班	Owynia Dilben	오위니아 딜벤
奧古斯特杜邦	Auguste Dupin	오귀스트 뒤팽
警備兵貝伊斯	Watch Guard Bace	경비경 베이스
書記官	Secretary	서기관
警備兵貝伊斯	Watch Guard Bace	경비병 베이스
村莊乞丐	Town Beggar	마을 거지
凱利	Kelly	켈리
畫家	Artist	화가
法師尼迪亞	Wizard Nidia	위저드 니디아
法師亞爾多尼	Wizard Aldoni	위저드 알도니
法師安妮	Wizard Ane	위저드 아네
拉穆迪	Ramute	라무티
尼柯波爾利斯警備兵	Nicopolis Guard	니코폴리스 경비병
尼柯波爾利斯警備兵	Nicopolis Guard	니코폴리스 경비원
你是新來的移居民嗎？	Are you a new settler?	새로 온 이주민입니까?
你問怎麼能放任這麼惡質的迪斯佩特？	Why don't we do anything about him?	그런 악질 틸스펙터를 가만 놔두고 있냐고요?
狄斯佩托怎麼樣了？	What happened to the Teal Specter?	틸스팩터는 어떻게 됐나요?
時空法師拉穆迪	Chronomancer Ramute	크로노맨서 라무티
首先，可以請你先擊退1次控制室裡的魔族，解除防禦裝置嗎？	Could you defeat the demons in the First Control Room and shut down the Defensive Device there?	우선 1차 제어실에 있는 마족들을 물리치고 방어 장치를 해제해주시겠습니까?
醫療團員	Medic	의무담당 단원
長老阿達育斯	Elder Adaux	장로 아다욱스
能否請你去確認那個地方是否有可疑的東西呢？	Could you perhaps look for any anomalies in the area?	그 장소에 혹시 수상한 것이 있지 않은지 확인해주지 않겠는가.
長老拉穆羅斯	Elder Ramunas	장로 라무나스
周圍看見的魔族和怪物都消滅了嗎?	Did you clear the area of demons and monsters?	주변에 보이는 마족과 몬스터를 모두 처치하셨나요?
你說這是大師給我的嗎?	The Master wanted me to have this?	마스터께서 전해주셨다고요?
弱小的逃亡者(1)	The Vulnerable Fugitive (1)	유약한 도망자(1)
弱小的逃亡者(2)	The Vulnerable Fugitive (2)	유약한 도망자(2)
弱小的逃亡者(3)	The Vulnerable Fugitive (3)	유약한 도망자(3)
弱小的逃亡者(4)	The Vulnerable Fugitive (4)	유약한 도망자(4)
弱小的逃亡者(5)	The Vulnerable Fugitive (5)	유약한 도망자(5)
弱小的逃亡者(6)	The Vulnerable Fugitive (6)	유약한 도망자(6)
弱小的逃亡者(7)	The Vulnerable Fugitive (7)	유약한 도망자(7)
生存的必須要素	The Essentials for Survival	생존의 필수요소
回想記憶	Think Back	기억을 되돌려
最壞情況(1)	The Downward Spiral (1)	상황은 최악으로(1)
最壞情況(2)	The Downward Spiral (2)	상황은 최악으로(2)
最壞情況(3)	The Downward Spiral (3)	상황은 최악으로(3)
最壞情況(4)	The Downward Spiral (4)	상황은 최악으로(4)
最壞情況(5)	The Downward Spiral (5)	상황은 최악으로(5)
最壞情況(6)	The Downward Spiral (6)	상황은 최악으로(6)
最壞情況(7)	The Downward Spiral (7)	상황은 최악으로(7)
最壞情況(8)	The Downward Spiral (8)	상황은 최악으로(8)
逃亡者的夢(1)	The Fugitive's Dream (1)	도망자의 꿈(1)
逃亡者的夢(2)	The Fugitive's Dream (2)	도망자의 꿈(2)
逃亡者的夢(3)	The Fugitive's Dream (3)	도망자의 꿈(3)
逃亡者的夢(4)	The Fugitive's Dream (4)	도망자의 꿈(4)
逃亡者的夢(5)	The Fugitive's Dream (5)	도망자의 꿈(5)
逃亡者的夢(6)	The Fugitive's Dream (6)	도망자의 꿈(6)
逃亡者的夢(7)	The Fugitive's Dream (7)	도망자의 꿈(7)
逃亡者的夢(8)	The Fugitive's Dream (8)	도망자의 꿈(8)
逃亡者的夢(9)	The Fugitive's Dream (9)	도망자의 꿈(9)
建構陣地	Prepare Camp	진지 구축
傳點調查(1)	Portal Investigation (1)	포탈 조사(1)
說去找其他反抗軍團員做。	Why don't you get a Resistance member to do it?	다른 저항군 단원에게 시키라고 한다.
傳點調查(2)	Portal Investigation (2)	포탈 조사(2)
傳點調查(3)	Portal Investigation (3)	포탈 조사(3)
解除防禦裝置(1)	Disarming the Defense System (1)	방어 장치 해제(1)
解除防禦裝置(2)	Disarming the Defense System (2)	방어 장치 해제(2)
解除防禦裝置(3)	Disarming the Defense System (3)	방어 장치 해제(3)
解除防禦裝置(4)	Disarming the Defense System (4)	방어 장치 해제(4)
偵查1次控制室	Investigate the First Control Room	1차 제어실 정찰
奪回1次控制室	Take back the First Control Room	1차 제어실 탈환
防禦裝置拉桿確保(1)	Obtaining the Defensive Device Lever (1)	방어 장치 레버 확보(1)
防禦裝置拉桿確保(2)	Obtaining the Defensive Device Lever (2)	방어 장치 레버 확보(2)
奪回2次控制室	Take Back the Second Control Room	2차 제어실 탈환
前往第12層(1)	To 12F (1)	12층으로(1)
前往第12層(2)	To 12F (2)	12층으로(2)
前往第12層(3)	To 12F (3)	12층으로(3)
中毒的團員們	The Poisoned Soldiers	중독된 단원들
可疑的交易(1)	Suspicious Bargain (1)	수상한 거래(1)
可疑的交易(2)	Suspicious Bargain (2)	수상한 거래(2)
可疑的交易(3)	Suspicious Bargain (3)	수상한 거래(3)
可疑的交易(4)	Suspicious Bargain (4)	수상한 거래(4)
搜索剩餘的場所	Search the Remaining Area	남겨진 장소 수색
越過牆	Across the Barrier	벽 너머로
第2次解除防禦裝置	Disarming the Second Defensive Device	2차 방어 장치 해제
前往20層	To 20F	20층으로
開始建築(1)	Building Initiation (1)	구축 개시(1)
開始建築(2)	Building Initiation (2)	구축 개시(2)
說請派其他的反抗軍們	Can't you get Resistance soldiers to do the job?	다른 저항군들을 이용하라고 한다
開始建築(3)	Building Initiation (3)	구축 개시(3)
解除保護裝置中	Undoing the Protective Device	보호 장치를 해제하는 중
開始建築(4)	Building Initiation (4)	구축 개시(4)
開始建築(5)	Building Initiation (5)	구축 개시(5)
開始建築(6)	Building Initiation (6)	구축 개시(6)
開始建築(7)	Building Initiation (7)	구축 개시(7)
開始建築(8)	Building Initiation (8)	구축 개시(8)
最後一位長老	The Last Elder	마지막 장로
朝向依克拉斯	To Ignas	이그나스를 향해
扺抗的完結(1)	The Final Battle (1)	저항의 결착(1)
扺抗的完結(2)	The Final Battle (2)	저항의 결착(2)
扺抗的完結(3)	The Final Battle (3)	저항의 결착(3)
扺抗的完結(4)	The Final Battle (4)	저항의 결착(4)
扺抗的完結(5)	The Final Battle (5)	저항의 결착(5)
扺抗的完結(6)	The Final Battle (6)	저항의 결착(6)
扺抗的完結(7)	The Final Battle (7)	저항의 결착(7)
準備階段(1)	Preparations (1)	준비 단계(1)
準備階段(2)	Preparations (2)	준비 단계(2)
關於反抗軍	About the Resistance	저항군에 대해
整理湖邊	Cleaning Up the Lake	호수길 정리
妨礙的東西	Hindrance	방해되는 것들
確認汙染度	Check the Pollution Levels	오염도 확인하기
偵察兵的下落	The Whereabouts of the Scout	정찰병의 행방
湖水的秘密(1)	The Secret of the Lake (1)	호수의 비밀(1)
湖水的秘密(2)	The Secret of the Lake (2)	호수의 비밀(2)
湖水的秘密(3)	The Secret of the Lake (3)	호수의 비밀(3)
湖水的秘密(4)	The Secret of the Lake (4)	호수의 비밀(4)
具有邪惡氣息的怪物(1)	The Evil Monster (1)	사악한 기운을 가진 몬스터(1)
具有邪惡氣息的怪物(3)	The Evil Monster (3)	사악한 기운을 가진 몬스터(3)
克倫的信賴	Kron's Trust	크론의 신뢰
致命的草(1)	The Fatal Grass (1)	치명적인 풀(1)
致命的草(2)	The Fatal Grass (2)	치명적인 풀(2)
具有邪惡氣息的怪物(2)	The Evil Monster (2)	사악한 기운을 가진 몬스터(2)
後方搗亂(1)	Covert Operation (1)	후방 교란(1)
後方搗亂(2)	Covert Operation (2)	후방 교란(2)
後方搗亂(3)	Covert Operation (3)	후방 교란(3)
後方搗亂(4)	Covert Operation (4)	후방 교란(4)
敵人的急襲(1)	Enemy Ambush (1)	적의 급습(1)
敵人的急襲(2)	Enemy Ambush (2)	적의 급습(2)
敵人的急襲(3)	Enemy Ambush (3)	적의 급습(3)
隱藏的魔法陣	The Hidden Magic Circle	숨겨진 마법진
利迪亞夏班的安排(1)	Lydia Schaffen's Relic (1)	리디아 샤펜의 안배(1)
利迪亞夏班的安排(2)	Lydia Schaffen's Relic (2)	리디아 샤펜의 안배(2)
利迪亞夏班的安排(3)	Lydia Schaffen's Relic (3)	리디아 샤펜의 안배(3)
利迪亞夏班的安排(4)	Lydia Schaffen's Relic (4)	리디아 샤펜의 안배(4)
利迪亞夏班的安排(5)	Lydia Schafeen's Relic (5)	리디아 샤펜의 안배(5)
利迪亞夏班的安排(6)	Lydia Schaffen's Relic (6)	리디아 샤펜의 안배(6)
利迪亞夏班的安排(7)	Lydia Schaffen's Relic (7)	리디아 샤펜의 안배(7)
利迪亞夏班的安排(8)	Lydia Schaffen's Relic (8)	리디아 샤펜의 안배(8)
利迪亞夏班的安排(9)	Lydia Schaffen's Relic (9)	리디아 샤펜의 안배(9)
利迪亞夏班的安排(10)	Lydia Schaffen's Relic (10)	리디아 샤펜의 안배(10)
水盤設施重新啟動(1)	Reactivating the Water Facility (1)	수반시설 재가동(1)
水盤設施重新啟動(2)	Reactivating the Water Facility (2)	수반시설 재가동(2)
水盤設施重新啟動(3)	Reactivating the Water Facility (3)	수반시설 재가동(3)
勸誘敵軍	Conciliating the Enemy	적군 회유
整理周圍	Housekeeping	주변 정리
為了確實的勝利(1)	For an Assured Victory (1)	확실한 승리를 위해(1)
為了確實的勝利(2)	For an Assured Victory (2)	확실한 승리를 위해(2)
強力的箭矢(1)	A Powerful Arrow (1)	강력한 화살(1)
強力的箭矢(2)	A Powerful Arrow (2)	강력한 화살(2)
詢問弟子在哪裡。	Where is the apprentice?	제자가 어디있는지 묻는다.
強力的箭矢(3)	A Powerful Arrow (3)	강력한 화살(3)
強力的箭矢(4)	A Powerful Arrow (4)	강력한 화살(4)
小心再小心(1)	Extra Extra Careful (1)	조심 또 조심(1)
小心再小心(2)	Building Initiation (2)	조심 또 조심(2)
選擇的結果(1)	The Outcome of Choice (1)	선택의 결과(1)
選擇的結果(2)	The Outcome of Choice (2)	선택의 결과(2)
選擇的結果(3)	The Outcome of Choice (3)	선택의 결과(3)
選擇的結果(4)	The Outcome of Choice (4)	선택의 결과(4)
選擇的結果(5)	The Outcome of Choice (5)	선택의 결과(5)
製作食用水	Make Drinking Water	식수 만들기
奇怪的雕塑(1)	Strange Sculpture (1)	이상한 조형물(1)
奇怪的雕塑(2)	Strange Sculture (2)	이상한 조형물(2)
魔法商店街的雕塑	The Sculpture in Magic Shop District	마법 상점가의 조형물
史達里小廣場的雕塑(2)	The Sculpture in Starry Town Square (2)	스타리 소광장의 조형물(2)
瑪之亞空地的雕塑	The Sculpture in Magija Empty Lot	마지아 공터의 조형물
思洛烏普三岔路的雕塑(2)	The Sculpture in Slove Intersection (2)	슬로우브 삼거리의 조형물(2)
雷普雷吉豪斯街的雕塑	The Sculpture in Represijos Street	레프레지호스 거리의 조형물
過去的殘骸	Remnants of the Past	과거의 잔재
銀河階梯	Starry Stairs	은하수 계단
史達里小廣場的雕塑(1)	The Sculpture in Starry Town Square (1)	스타리 소광장의 조형물(1)
使用魔力控制卷軸中	Using the Scroll of Magic Block	마력 제어 주문서를 사용 중
思洛烏普三岔路的雕塑(1)	The Sculpture in Slove Intersection (1)	슬로우브 삼거리의 조형물(1)
貝拉因小鎮事件(1)	The Feline Post Town Case (1)	펠라인 포스트 타운 사건(1)
貝拉因小鎮事件(2)	The Feline Post Town Case (2)	펠라인 포스트 타운 사건(2)
為進行調查，索求入住紀錄書。	May I borrow the Resident Logs for an investigation?	조사를 위해 입주 기록지를 달라고 한다
貝拉因小鎮事件(3)	The Feline Post Town Case (3)	펠라인 포스트 타운 사건(3)
貝拉因小鎮事件(4)	The Feline Post Town Case (4)	펠라인 포스트 타운 사건(4)
貝拉因小鎮事件(5)	The Feline Post Town Case (5)	펠라인 포스트 타운 사건(5)
貝拉因小鎮事件(6)	The Feline Post Town Case (6)	펠라인 포스트 타운 사건(6)
貝拉因小鎮事件(7)	The Feline Post Town Case (7)	펠라인 포스트 타운 사건(7)
去找英雷迪粉末	I'll go looking for Ingredy Powder	잉레디 가루를 구하러 간다
縮小的搜索範圍(1)	The Closing Dragnet (1)	좁혀지는 수사망(1)
縮小的搜索範圍(2)	The Closing Dragnet (2)	좁혀지는 수사망(2)
縮小的搜索範圍(3)	The Closing Dragnet (3)	좁혀지는 수사망(3)
縮小的搜索範圍(4)	The Closing Dragnet (4)	좁혀지는 수사망(4)
縮小的搜索範圍(5)	The Closing Dragnet (5)	좁혀지는 수사망(5)
監視裝置錄到的內容(1)	What was in the storage device (1)	감시 장치에 담긴 것(1)
監視裝置錄到的內容(2)	What was in the storage device (2)	감시 장치에 담긴 것(2)
恐怖的研究紀錄	The Frightening Research Papers	무서운 연구 기록
住所街的研究紀錄保管所	Research Archives on Main Street	주거지 거리의 연구 기록 보관소
確認是否有老舊的研究紀錄書	Check to See if the Old Research Papers are Here	오래된 연구 기록지가 있는지 확인하기
堤里馬依空地研究紀錄保管所	Research Archives in Tyrimai Empty Lot	티리마이 공터 연구 기록 보관소
確認裝置	Check the device	장치를 확인하기
瑪之亞斯洛普的研究紀錄保管所(1)	Research Archives in Magija Slove (1)	마지아 슬로브의 연구 기록 보관소(1)
瑪之亞斯洛普的研究紀錄保管所(2)	Research Archives in Magija Slove (2)	마지아 슬로브의 연구 기록 보관소(2)
詢問是什麼	What is it?	뭐냐고 묻는다
弱小的逃亡者	The Vulnerable Fugitive	유약한 도망자
搜索巴爾堤內紀念區	Search the Baltinel Memorial	발티넬 기념구 수색
與奎波爾克利西亞對話	Talk to Kupole Grisia	큐폴 그리시아와 대화
收集巴爾堤內教區的聖物	Collect the Holy Relics of Baltinel Parish	발티넬 교구의 성물 수집
清除還原的陷阱 	Remove the Kupole Traps	환원의 덫 제거
消滅帕卡爾小市場的魔族	Defeat the Demons in Pagal Market	파갈 소시장의 마족 처치
消滅在帕卡爾小市場持有還原的陷阱的魔族	Defeat the Demons Carrying the Traps in Pagal Market	파갈 소시장에 있는 환원의 덫을 소지한 마족 처치
拯救陷入還原的陷阱裡的奎波爾	Rescue the Trapped Kupoles	환원의 덫에 걸린 큐폴 구출
搜查奎波爾茲莎伊亞	Search for Kupole Zsaia	큐폴 즈사이아 수색
與被救的奎波爾對話	Talk to the rescued Kupole	구조된 큐폴과 대화
回收被拯救的奎波爾的持有品	Retrieve the Rescued Kupoles' Belongings	구조된 큐폴의 소지품 회수
最壞情況	The Downward Spiral	상황은 최악으로
救助生存的奎波爾	Rescue the Surviving Kupoles	생존 큐폴 구조
消滅持有還原的陷阱的魔族	Defeat the Demons in Possession of Traps	환원의 덫을 소지한 마족 처치
追擊奎波爾茲莎伊亞	Chase Kupole Zsaia	큐폴 즈사이아 추격
與奎波爾茲莎伊亞對話	Talk to Kupole Zsaia	큐폴 즈사이아와 대화
拯救茲莎伊亞	Rescue Kupole Zsaia	즈사이아 구출
請與奎波爾克利西亞對話	Talk to Kupole Grisia	큐폴 그리시아와 대화하세요
逃亡者的夢	The Fugitive's Dream	도망자의 꿈
拯救陷入陷阱裡的奎波爾	Rescue the Captured Kupoles	덫에 걸린 큐폴 구출
尋找奎波爾佛拉德	Look for Kupole Velad	큐폴 블라드 찾기
和奎波爾佛拉德對話	Talk to Kupole Velad	큐폴 블라드와 대화
請和奎波爾佛拉德對話	Talk to Kupole Velad	큐폴 블라드와 대화하세요
收集無力化寶珠	Collect the Neutralizing Orbs	무력화 보주 수집
將騙術的信物交給奎波爾佛拉德	Deliver the Fake Keepsake to Kupole Velad	큐폴 블라드에게 속임수 증표 전달
打倒魔族BOSS	Defeat the Demon Boss	마족 보스 처치
交給奎波爾佛拉德	Find Kupole Velad	큐폴 블라드에게 전달
和抗軍副司令官克倫對話	Talk to Resistance Deputy Commander Kron	저항군 부사령관 크론과 대화
傳點調查	Portal Investigation	포탈 조사
調查1層動力室的傳點	Investigate the Portals in 1F Engine Room	1층 동력실의 포탈을 조사
在傳點附近設置傳點生成抑制器	Install the Portal Suppressors Near the Portals	포탈 인근에 포탈 생성 억제기 설치
使用炸彈破壞傳點	Use the Explosive to Destroy the Portals	폭탄을 이용해 포탈을 파괴
解除防禦裝置	Disarming the Defensive Device	방어 장치 해제
打倒周遭魔族及確認1層指揮室	Defeat the demons in the area and investigate the 1F Command Room	주변 마족 처치 및 1층 지휘실 확인
打倒魔族，收集魔石碎片	Defeat the Demons to Collect Magic Stones	마족을 처치하여 마석 조각 수집
使1層指揮室的防禦裝置停下	Shut off the Defensive Device in the Control Room on 1F	1층 지휘실의 방어 장치의 작동을 정지
往4層移動後，和巴伊爾對話	Move to 4F and Talk to Byle	4층으로 이동 후 바일과 대화
和抗軍總司令官巴伊爾對話	Talk to Resistance Commander Byle	저항군 총사령관 바일과 대화
打倒往第1控制室路上的魔族	Defeat the Demons on the Way to the First Control Room	1차 제어실로 가는 길목의 주변 마족 처치
往第1控制室移動並偵查內部	Move to the First Control Room and Investigate	1차 제어실로 이동하여 내부 정찰
使第1防禦裝置停下	Shut Down the First Defensive Device	1차 방어 장치의 작동을 정지
防禦裝置拉桿確保	Obtaining the Defensive Device Lever	방어 장치 레버 확보
從魔族身上收集可當作線索的物品	Collect any Objects That May Be a Clue	마족들에게서 단서가 될만한 물건 수집
在物流倉庫中獲得第2防禦裝置控制桿	Find the Second Device Lever from the Storage Room	물류 창고에서 2차 방어 장치 레버 획득
往第2控制室移動	Move to the Second Control Room	2차 제어실로 이동
使第2防禦裝置停下	Shut Down the Second Defensive Device	2차 방어 장치의 작동을 정지
前往第12層	To 12F	12층으로
打倒通往集合地點路上的魔族	Defeat the Demons on the Way to the Rendezvous Point	합류 지점으로 가는 길목의 마족 처치
打倒擋住路口的怪物	Defeat the Monsters in the Way	길목을 막는 몬스터 처치
往集合地點移動	Move to the Rendezvous Point	합류 지점으로 이동
和醫療團員對話	Talk to the Medic	의무 담당 단원과 대화
收集夏班史達的備用藥	Collect the Schaffenstar Emergency Meds	샤펜스타의 비상약 수집
可疑的交易	Suspicious Bargain	수상한 거래
移動前往第12層	To 12F	12층으로 이동
控制裝置手把	Control Device Handle	제어 장치 핸들
停第1防禦裝置停下	Stop the First Defensive Device	1차 방어 장치의 작동 정지
打倒四周的魔族後，調查透明牆	Defeat the Demons in the Area and Investigate the Invisible Barrier	주변 마족 처치 후 투명한 벽을 조사
搜索控制透明牆的裝置	Search for the Device that Controls the Invisible Wall	투명한 벽을 제어하는 장치 수색
調查雕像	Investigate the Sculpture	조각상을 조사
往透明牆移動	Go to the invisible barrier	투명한 벽으로 이동
和長老阿達育斯對話	Talk to Elder Adaux	장로 아다욱스와 대화
開始建築	Building Initiation	구축 개시
打倒奇襲的怪物	Defeat the Ambushing Monsters	기습한 몬스터 처치
打倒四周怪物及讓保護裝置停下	Defeat Nearby Monsters and Stop the Protective Device	주변 몬스터 처치 및 보호 장치의 작동 정지
使用可疑的卷軸除去隱藏的魔力源	Use the Suspicious Scrolls to Find and Remove the Magic Source	수상한 스크롤을 이용하여 숨겨진 마력원 제거
使保護裝置停下	Shut Down the Protective Device	보호 장치의 작동을 정지
調查住處4號室的保護裝置	Investigate the Protective Device in Lodge 4	숙소 4호실의 보호 장치를 조사
使住處4號室的保護裝置停下	Shut Down the Protective Device in Lodge 4	숙소 4호실의 보호 장치의 작동 정지
打倒看守防禦裝置的守護者	Defeat the Guardian Protecting the Defensive Device	방어 장치를 지키는 수호자 처치
使防禦裝置停下	Shut Down the Defensive Device	방어 장치의 작동 정지
往20層中央管理室移動	Head to the General Office on 20F	20층 중앙 관리실을 향해 이동
從20層中央管理室的魔族身上獲得第一把管理室鑰匙	Get the First Key from the Demons in the General Office on 20F	20층 중앙 관리실의 마족에게서 관리실의 첫 번째 열쇠 획득
使用管理者鑰匙，搜尋其他鑰匙	Use the Key You Found to Search for the Second key	관리자 열쇠를 이용하여 다른 열쇠 탐색
打退長老賽拉禮斯，獲得鑰匙	Obtain the key by defeating Elder Cezaris	장로 세자리스를 물리치고 열쇠 획득
用巴伊爾給你鑰匙啟動升降機管理裝置	Use the Keys to Activate the Elevator Control Device	바일이 준 열쇠들로 승강기 관리 장치를 작동
扺抗的完結	The Final Battle	저항의 결착
打倒鄰近四周的魔族	Defeat Nearby Demons	인근 주변의 마족 처치
收集魔力殘留物	Collect the Magic Residue	마력 잔류물 수집
破壞依克拉斯設置的魔族裝置	Destroy Ignas' Transforming Device	이그나스가 설치한 마족의 장치 파괴
打倒擋住往第1展望台路上的魔族	Defeat the Demons on the Way to the First Observatory	제1 전망대로 가는 길을 막는 마족 처치
和夏班史達團長依克拉斯戰鬥	Defeat the Head of the Schaffenstar Ignas	샤펜스타 단장 이그나스와 전투
調查第1展望台的望遠鏡	Investigate the First Observatory Telescope	제1 전망대의 망원경 조사
和抗軍馬伊特對話	Talk to the Resistance Soldier Mait	저항군 마이트와 대화
和抗軍副官貝稜對話	Talk to Resistance Adjutant Bern	저항군 부관 베른과 대화
除去湖水路周邊的苔癬	Remove the Moss from the Lake	호수길 주변 이끼 제거
與抗軍莫蘭對話	Talk to Resistance Soldier Molan	저항군 몰란과 대화
除去周遭的魔族與怪物	Defeat the Demons and the Monsters in the Area	주변의 마족과 몬스터 제거
採集湖水魚	Collect the Lake Fish	호수 물고기 채집하기
找尋偵察兵的下落	Look for the Missing Scout	정찰병의 행방 찾기
收集可用的魔法石	Collect Good Magic Stones	쓸만한 마법석 수집
往水盤設施所在的場所移動	Go to the Water Facility	수반시설이 있는 장소로 이동하기
啟動水盤控制裝置	Reactivate the Water Controller	수반 제어장치 활성화
啟動水盤設施保護魔法陣	Activate the Magic Circle of Protection for the Water Facility	수반시설 보호 마법진 활성화
往巨大怪物所在的地方移動	Move to Where the Giant Monster Is	거대 몬스터가 있는 곳으로 이동
採集里亞斯草	Collect the Rias Weeds	리아스 풀 채집
打倒出現里亞斯草精煉粉末效果的魔族	Defeat the Demons Affected by the Refined Rias Weed Powder	리아스 풀 정제가루의 효과가 나타나는 마족 처치
在水盤附近裝淨化之水	Bring Purified Water From the Water Point	수반 근처에서 정화된 물 담아오기
和抵抗軍雷特對話	Talk to Resistance Soldier Rett	저항군 레트와 대화
和長老拉穆羅斯對話	Talk to Elder Ramunas	장로 라무나스와 대화
和抗軍副官泰勒對話	Talk to the Resistance Adjutant Taylor	저항군 부관 테일러와 대화
除去陷阱	Remove the Traps	함정 제거
和抗軍副官勒溫對話	Talk to Resistance Adjutant Lehon	저항군 부관 르온과 대화
攏絡有中立傾向的夏班史達團員	Convince the Neutral Schaffenstar Members	중립 성향을 가진 샤펜스타 단원 회유
對補給物資灑毒	Poison the Supplies	보급 물자에 독 뿌리기
往後勤補給地區移動	Go to the Rear Supply Area	후방 보급지역으로 이동
破壞隱藏的移動魔法陣	Destroy the Hidden Teleportation Magic Circle	숨겨진 이동마법진 파괴
確認老舊的碑石	Investigate the Old Tombstone	오래된 비석 확인
往祭壇移動	Go to the Altar	제단으로 이동 하기
往帕托庫斯休憩地移動	Go to Patogus Shelter	파토구스 쉼터로 이동하기
在祭壇上放上古代圓盤	Place the Ancient Disc on the Altar	제단에 고대 원판 올려놓기
確認拉伊瑪女神的預言	Listen to Goddess Laima's Prophecy	라이마 여신의 예언 확인
埋藏洞悉真相的寶珠	Bury the Revealing Orbs	진실을 꿰뚫는 보주 매설
引誘敵人的指揮官到寶珠埋藏的區域	Lure the Enemy Commander to Where the Orbs are Buried	적의 지휘관을 보주가 매설된 지역으로 유인
收集蘊含湖水氣息之石	Collect the Stones with Lake Energy	호수의 기운이 깃든 돌 수집
確認水盤	Check the Water Point	수반 확인
攏絡動搖的夏班史達團員	Convince the Agitated Schaffenstar Members	동요하는 샤펜스타 단원 회유
打倒周遭的魔族與怪物	Defeat the Demons and Monsters in the Area	주변에 있는 마족과 몬스터 처치
往巴林威爾87水域移動	Go to Barynwell 87 Waters	바린웰 87수역으로 이동
和遊俠莫爾比歐對話	Talk to Ranger Morvio	레인저 모르비오와 대화
吸收及破壞控制魔法石的邪惡氣息	Absorb the Evil Energy of the Stones of Constraint	제어 마법석의 사악한 기운 흡수 및 파괴
和造箭者大師對話	Talk to the Fletcher Master	플레처 마스터와 대화
和造箭者弗雷塔對話	Talk to Fletcher Voleta	플레처 볼레타와 대화
收集天然的黑曜石	Collect Natural Obsidian	천연 흑요석 수집
收集賀敏公爵的羽毛	Collect Humming Duke Feathers	허밍 듀크의 깃털 수집
和獵人奧爾特對話	Talk to Hunter Oort	헌터 오르트와 대화
收集吉普利特草	Collect Ziburyte Weeds	지부리트 풀 수집
設置陷阱	Set the Traps	함정 설치
往弗貝塔所在的區域移動	Go to Where Pbeta Is	프베타가 있는 지역으로 이동
打倒弗貝塔	Defeat Pbeta	프베타 처치
打倒魔族弗貝塔	Defeat the Demon Pbeta	마족 프베타 처치
等待遊俠莫爾比歐	Wait for Ranger Morvio	레인저 모르비오 기다리기
收集肉片	Collect Meat	고기 수집
收集帕斯圖水草	Collect the Pasto Water Plants	파스토 수초 수집
長遠的夢從那魯巴斯寺院開始	A Dream of Narvas Temple	긴 꿈은 나르바스 사원에서 지고
奇怪的雕塑	Strange Sculpture	이상한 조형물
和奧維尼亞狄爾班對話	Talk to Owynia Dilben	오위니아 딜벤과 대화
對史達里小鎮的雕塑使用魔力控制卷軸	Use the Magic Block on the Sculptures in Starry Town	스타리 타운의 조형물에 마력 제어 주문서 사용하기
對雕塑使用魔力控制卷軸	Use the Magic Block on the Sculptures	조형물에 마력 제어 주문서 사용하기
對魔法商店街的雕塑使用魔力控制卷軸	Use the Magic Block on the Sculptures in the Magic Shop District	마법 상점가의 조형물에 마력 제어 스크롤 사용하기
打倒怪物並使用魔力控制卷軸	Defeat the monsters and use the Magic Block	몬스터를 처치하고 마력 제어 스크롤 사용하기
對史達里小廣場的雕塑使用魔力控制卷軸	Use the Magic Block on the Sculptures in the Starry Town Square	스타리 소광장의 조형물에 마력 제어 주문서 사용하기
對瑪之亞空地的雕塑使用魔力控制卷軸	Use the Magic Block on the Sculptures in the Magija Empty Lot	마지아 공터의 조형물에 마력 제어 주문서 사용하기
使裝置停下，然後對雕塑使用魔力控制卷軸	Stop the Device and Use the Magic Block on the Sculptures	장치를 정지시켜 조형물에 마력 제어 주문서 사용하기
對思洛烏普三岔路的雕塑使用魔力控制卷軸	Use the Magic Block on the Sculptures in the Slove Intersection	슬로우브 삼거리의 조형물에 마력 제어 주문서 사용하기
解鎖上鎖的裝置並啟用，然後對雕塑使用魔力控制卷軸	Unlock the Devices to Turn Them Off and Use the Magic Block	장치의 잠금을 풀어 조작해 조형물에 마력 제어 주문서 사용하기
和奧維尼亞狄爾班對話	Talk to Owynia Dilben	오위니아 딜벤과 대화하기
對雷普雷吉豪斯街的雕塑使用魔力控制卷軸	Use the Magic Block on the Sculptures on Represijos Street	레프레지호스 거리의 조형물에 마력 제어 주문서 사용하기
調查史達里鐘塔廣場的雕塑	Investigate the Sculptures in Starry Clock Tower Square	스타리 시계 탑 광장에 있는 조형물 조사하기
打倒波貝依丁女王	Defeat the Pervading Queen	퍼베이딩 퀸 처치
和拉穆迪對話	Talk to Ramute	라무티와 대화하기
收集構成銀河階梯的物質	Collect the Materials That Make Up the Starry Stairs	은하수 계단을 이루는 물질 수집하기
和警備兵對話	Talk to the Guard	경비병과 대화하기
打倒周遭的怪物	Defeat Nearby Monsters	주변에 있는 몬스터를 처치하기
打倒史達里小鎮的怪物	Defeat the Monsters in Starry Town	스타리 타운에 있는 몬스터 처치
對史達里小廣場的雕塑使用魔力控制卷軸	Use the Magic Block on the Sculptures in Starry Town Square	스타리 소광장의 조형물에 마력 제어 스크롤 사용하기
尋找可以使裝置停下的方法	Find a Way to Turn Off the Device	장치를 끌 수 있는 방법 찾기
確認雕塑	Investigate the Sculpture	조형물을 확인하기
確認周圍	Investigate the Area	주변을 확인하기
貝拉因小鎮事件	The Feline Post Town Case	펠라인 포스트 타운 사건
與奧古斯特杜邦對話	Talk to Auguste Dupin	오귀스트 뒤팽과 대화
和書記官對話	Talk to the Secretary	서기관과 대화
打倒怪物，取得入住紀錄書	Defeat the Monsters to Retrieve the Resident Logs	몬스터를 처치해 입주 기록지 구하기
確認入住紀錄書	Check the Resident Logs	입주 기록지 확인하기
搜索周圍	Search the Area	주변을 수색하기
搜索拉克塔斯三岔路	Search the Raktas Intersection	라크타스 삼거리 수색하기
尋找事件的蛛絲馬跡	Search for Clues	사건의 실마리를 찾기
確認被火燻黑的衣服	Investigate Burnt Clothes	불에 그을린 옷 확인하기
與奧古斯特杜邦對話	Talk to Auguste Dupin	오귀스트 뒤팽과 대화하기
打倒米摩萊並獲取英雷迪粉末	Defeat the Mimorats to Obtain Ingredy Powder	미모랫을 처치해  잉레디 가루 구하기
縮小的搜索範圍	The Closing Dragnet	좁혀지는 수사망
跟著奧古斯特杜邦	Follow Auguste Dupin	오귀스트 뒤팽을 따라가기
與藥師對話	Talk to the Chemist	약재사와 대화
在凱爾里與畫家中，對其中一人使用附身判別用溶液	Use the Detecting Solution on Either Kelly or the Artist	켈리와 화가 둘 중 1명에게 빙의 판별용 용액 사용
在畫家的家附近設置驅魔魔法陣	Install the Exorcising Magic Circle Around the Artist's House	화가의 집 근처에 구마 마법진 설치하기
請和奧古斯特杜邦對話	Talk to Auguste Dupin	오귀스트 뒤팽과 대화하세요
追趕逃跑的畫家	Chase the Artist	도망친 화가를 쫓아가기
打倒從畫家身上冒出的迪斯佩特	Defeat the Teal Specter that Escaped the Artist's Body	화가의 몸에서 나온 틸스펙터 처치
監視裝置錄到的內容	What Was in the Surveillance Device	감시 장치에 담긴 것
與法師亞爾多尼對話	Talk to Wizard Aldoni	위저드 알도니와 대화
確認監視裝置	Check the Surveillance Device	감시 장치 확인하기
打倒怪物	Defeat the Monsters	몬스터를 처치하기
確認監視裝置	Check the Surveillance Device	감시 장치를 확인하기
與法師尼迪亞對話	Talk to Wizard Nidia	위저드 니디아와 대화
使用微魔力探知器	Use the Micro Magic Detector	미세 마력 탐지기를 사용하기
確認老舊的研究紀錄書所在的場所	Investigate the Area Where Old Research Papers May Be Stored	오래된 연구 기록지가 있는 장소 확인하기
確認老舊的研究紀錄書所在的場所	Investigate the Area Where Old Research Papers May Be Stored	오래된 연구 기록지가 있는 장소 확인
解除裝置的上鎖狀態	Unlock the Device	장치의 잠금을 풀기
調換老舊的研究紀錄書	Switch the Old Research Papers With the Forged Papers	오래된 연구 기록지를 바꾸기
瑪之亞斯洛普的研究記錄保管所	Research Paper Archives in Magija Slove	마지아 슬로브의 연구 기록 보관소
接受法師尼迪亞幫助	Get Help From Wizard Nidia	위저드 니디아에게 도움 받기
和法師尼迪亞對話	Talk to Wizard Nidia	위자드 니디아와 대화
使用重力磁場卷軸	Use the Scroll of Gravity	그라비티 주문서를 사용하기
獲得老舊的研究紀錄書	Obtain the Old Research Papers	오래된 연구 기록지를 획득하기
狄斯佩托怎麼樣了？	What happened to the Teal Specter?	틸스펙터는 어떻게 됐나요?
有什麼話要說嗎？	Do you want something?	하실 말씀이 있습니까?
消滅水螅了嗎？	Did you defeat the Hydra?	히드라를 처치하셨습니까?
啟示者您能幫忙把那些陷阱解除嗎？	Would you help dismantle and remove the traps?	계시자님께서 그 함정들을 대신 해체해 주시겠습니까?
亞烏特羅內	Audrone	아우드로네
詢問弟子在哪裡。	Where is the apprentice?	제자가 어디 있는지 묻는다.
調查魔法實驗區域	Investigate the Magic Research Facility	마법 실험 구역 조사
憎恨帶來的結果	Fruit of Vengeance	증오가 낳은 결과
和尼柯波爾利斯居民對話	Talk to a Nicopolis Resident	니코폴리스 주민과 대화
消滅亞西歐梅吉	Defeat the Asiomage	아시오 메이지 처치
和尼柯波爾利斯居民對話	Talk to a Nicopolis Resident	니코폴리스 주민과 대화하기
