攻擊	Attack	공격
基本一般攻擊	Basic Normal Attack	베이직 일반 공격
攻擊2	Attack 2	공격2
技能	Skills	스킬
大爆發	Large explosion	대폭발
火焰之壁	Wall of Flame	화염의 벽
地雷爆炸	Mine explosion	지뢰 폭발
猛毒爆炸	Toxic explosion	맹독 폭발
克雷摩亞爆炸	Claymore explosion	크레모아 폭발
跳躍攻擊	Jump Attack	점프공격
生命流動	Life Stream	생명의 흐름
冰河臨風	Glacier Wedge	빙하 쐐기
種子爆炸	Seed explosion	씨앗 폭발
火山爆發	Flame explosion	살불 폭발
暴風雪	Snowstorm	눈보라
流星強打	Meteor Bang	유성 강타
劈擊	Smack Down	내려찍기
飛彈攻擊	Missile attack	미사일공격
治癒	Heal	힐
螺旋箭	Spiral Arrow	스파이럴 애로우
劇毒之箭	Poisonous Arrow	맹독 화살
體積縮小	Shrink Body	크기 축소
攻擊加快	Quicken	퀴큰
多重射擊	Multi Shot	멀티샷
石化咒詛	Stone Curse	스톤커스
魔法飛彈	Magic Missile	매직 미사일
聯合懲罰	Joint Penalty	조인트 페널티
死亡宣告	Death Sentence	죽음의 선고
錐箭	Bodkin Point	보드킨 포인트
障壁	Barrier	배리어
金鐘罩	Golden Bell Shield	금종조
狂風	Gust	거스트
奮起	Gung Ho	겅호
三連發	Triple Arrow	트리플 애로우
爪擊	Scratch	할퀴기
劈砍	Slash	가르기
狂野氣息	Wild Breath	와일드 브레스
咆哮	Warcry	포효
[聖殿十字軍大師] 一般攻擊	[Paladin Master] Normal attack	[팔라딘 마스터] 일반 공격
[聖水祭司大師] 一般攻擊	[Priest Master] Normal attack	[프리스트 마스터] 일반 공격
[獵人大師] 一般攻擊	[Hunter Master] Normal attack	[헌터 마스터] 일반 공격
[聖火祭司大師] 一般攻擊	[Krivis Master] Normal attack	[크리비 마스터] 일반 공격
[野蠻人大師] 一般攻擊	[Barbarian Master] Normal attack	[바바리안 마스터] 일반 공격
[鎖鏈法師大師] 一般攻擊	[Linker Master] Normal attack	[링커 마스터] 일반 공격
[巫蠱師大師] 一般攻擊	[Wugushi Master] Normal attack	[무고사 마스터] 일반 공격
[聖者大師] 一般攻擊	[Sadhu Master] Normal attack	[사두 마스터] 일반 공격
[圓盾劍士大師] 一般攻擊	[Rodelero Master] Normal attack	[로델레로 마스터] 일반 공격
[斥候大師] 一般攻擊	[Scout Master] Normal attack	[스카우트 마스터] 일반 공격
[流氓大師] 一般攻擊	[Rogue Master] Normal attack	[로그 마스터] 일반 공격
[武僧大師] 一般攻擊	[Monk Master] Normal attack	[몽크 마스터] 일반 공격
[神諭師大師] 一般攻擊	[Oracle Master] Normal attack	[오라클 마스터] 일반 공격
[德魯伊大師] 一般攻擊	[Druid Master] Normal attack	[드루이드 마스터] 일반 공격
碎擊大地	Break Tiles	장판깨트리기
碎擊大地	Break Tiles	장판 깨트리기
基本攻擊	Basic Attack	기본 공격
弓箭右手(雙手弓專用)	Right-hand Bow (Two-handed Bow only)	보우 오른손(투핸드보우 전용)
對近距離的敵人攻擊(戰士雙手劍專用)	Attack an enemy from a short distance(Warrior's Two-handed Sword only)	근거리의 적에게 공격을 합니다(전사 양손검 전용)
短劍刺擊	Dagger Pierce	단검 찌르기
夢想家	Dream Song	몽왕가
黑影雨傘	Shadow Umbrella	섀도엄브렐러 
開發中	In development	개발중
道具技能	Item skill	아이템 스킬
再次攻擊	Dash Attack	대시 공격
基本攻擊的突擊版本	This is the dash version of the base attack	기본공격의 대시버전입니다
落雷	Zaibas	자이바스
基本攻擊2	Basic Attack 2	기본 공격2
弓箭左手	Bow Left hand	보우 왼손
弓箭右手(十字弓專用)	Right-hand Bow (Crossbow only)	보우 오른손(크로스보우 전용)
手槍右手(手槍專用)	Right-handed Pistol (Pistol Only)	권총 오른손(권총 전용)
權杖攻擊	Staff Attack	스태프 공격
攻擊遠距離的敵人	Attack a distant enemy	원거리의 적을 공격 합니다
砲擊攻擊	Cannon Attack	캐논 공격
雙槍攻擊	Double Pistol Attack	쌍권총 공격
紅絨布反擊	Muleta counter attack	물레타 반격
雷電之手基本攻擊	Lightning Hands Basic Attack	라이트닝 핸즈 기본 공격
雷電之手	Lightning Hands	라이트닝 핸즈
泰拳攻擊	Nak Muay Attack	낙무아이 공격
火槍攻擊	Musket Attack	머스킷 공격
基本	Basic	기본
鐵鏟開挖	Shovelling	삽질
金屬探測	Detect metal	금속탐지
噴水器	Water spray	물뿌리개
採礦	Mining	채광
派對吹笛	Party Horn	풍선 피리
放煙火	Fireworks	불꽃놀이
暖暖包	Hot Pack	핫 팩
綠色煙火	Fireworks Green	불꽃놀이 녹색
共用_測試1	Public_Test 1	공용_테스트1
火熱1	Mischief 1	화끈1
共用_測試2	Public_Test 2	공용_테스트2
火熱2	Mischief 2	화끈2
共用_測試3	Public_Test 3	공용_테스트3
火熱3	Mischief 3	화끈3
共用_測試4	Public_Test 4	공용_테스트4
火熱4	Mischief 4	화끈4
共用_測試5	Public_Test 5	공용_테스트5
火熱5	Mischief 5	화끈5
重裝步兵	Hoplite	하플라이트
開發進行中	In development	개발 진행 중
防守	Guard	가드
以盾牌擋下敵人的攻擊。[防守點數150]	Block enemy attack with shield [Guard Point 150]	방패로 적의 공격을 막아냅니다. [가드포인트 150]
[青苔泥人卡片] 物理無屬性打擊	[Golem Card] Physical Non-Property Strike	[골렘 카드] 물리 무속성 타격
[蘑菇卡利亞卡片] 物理毒屬性打擊	[Mushcaria Card] Physical Poison Property Strike	[머슈카리아 카드] 물리 독속성 타격
[遠古石龜獸卡片] 物理無屬性打擊	[Rocktortuga Card] Physical Non-Property Strike	[락토르투가 카드] 물리 무속성 타격
[波亞塔卡片] 物理暗屬性魔法	[Poata Card] Physical Dark Property Magic	[포아타 카드] 물리 암속성 마법
[毒魔蛙圖圖卡片] 物理毒屬性斬擊	[Tutu Card] Physical Poison Property Slash	[투투 카드] 물리 독속성 베기
[布貝鬥士卡片] 物理無屬性打擊	[Vubbe Fighter Card] Physical Non-Property Strike	[부베 투사 카드] 물리 무속성 타격
[赤紅布貝鬥士卡片] 物理無屬性刺擊	[Red Vubbe Fighter Card] Physical Non-Property Pierce	[붉은 부베 투사 카드] 물리 무속성 찌르기
[查伊波卡片] 物理毒屬性魔法	[Chafer Card] Physical Poison Property Magic	[체이퍼 카드] 물리 독속성 마법
[葛雷斯墨爾卡片] 物理無屬性刺擊	[Glass_Mole Card] Physical Non-Property Pierce	[글래스몰 카드] 물리 무속성 찌르기
[樹精卡] 物理無屬性魔法	[Woodspirit Card] Physical Non-Property Magic	[우드스피릿 카드] 물리 무속성 마법
[獨眼巨人卡片] 物理暗屬性打擊	[Cyclops Card] Physical Dark Property Strike	[사이클롭스 카드] 물리 암속성 타격
[火焰蜥蜴王卡片] 魔法火屬性魔法	[Salamander Card] Magic Fire Property Magic	[샐러맨더 카드] 매직 화속성 마법
[貝亞卡拉斯卡片] 物理無屬性魔法	[Bearkaras Card] Physical Non-Property Magic	[베아카라스 카드] 물리 무속성 마법
[蠱惑惡靈卡片] 魔法暗屬性打擊	[Dazzled Specter Card] Magic Dark Property Strike	[현혹의 스펙터 카드] 매직 암속성 타격
[石鯨怪卡片] 魔法無屬性打擊	[Stone_Whale Card] Magic Non-Property Strike	[석화고래 카드] 매직 무속성 타격
[奇葛拉斯卡片] 物理火屬性打擊	[Ginklas Card] Physical Fire Property Strike	[긴클라스 카드] 물리 화속성 타격
[蓋洛貝斯寄居蟹卡片] 物理無屬性打擊	[Carapace Card] Physical Non-Property Strike	[캐러페이스 카드] 물리 무속성 타격
[惡靈君主卡片] 魔法暗屬性魔法	[Specter Monarch Card] Magic Dark Property Magic	[스펙터 군주 카드] 매직 암속성 마법
[尼多普巴伊卡片] 物理暗屬性 刺擊	[Netherbovine Card] Physical Dark Property Pierce	[네더보바인 카드] 물리 암속성 찌르기
[米爾堤斯卡片] 魔法暗屬性 斬擊	[Mirtis Card] Magic Dark Property Slash	[미르티스 카드] 매직 암속성 베기
[賽夸伊亞卡片] 物理火屬性魔法	[Sequoia Card] Physical Fire Property Magic	[세콰이아 카드] 물리 화속성 마법
[利卡烏斯卡片] 物理暗屬性 斬擊	[Rikaus Card] Physical Dark Property Slash	[리카우스 카드] 물리 암속성 베기
[狼人卡片] 物理暗屬性魔法	[Werewolf Card] Physical Dark Property Magic	[웨어울프 카드] 물리 암속성 마법
[鬼影凱伊洛卡片] 魔法暗屬性 斬擊	[Shadowgaler Card] Magic Dark Property Slash	[섀도게일러 카드] 매직 암속성 베기
[魔花卡諾波卡片] 物理毒屬性魔法	[Carnivore Card] Physical Poison Property Magic	[카너버 카드] 물리 독속성 마법
[米諾牛頭怪卡片] 魔法火屬性魔法	[Minotaur Card] Magic Fire Property Magic	[미노타우로스 카드] 매직 화속성 마법
[王座大蜘蛛卡片] 魔法毒屬性打擊	[Throneweaver Card] Magic Poison Property Strike	[쓰론위버 카드] 매직 독속성 타격
[比特雷巨蜂卡片] 物理無屬性 刺擊	[Biteregina Card] Physical Non-Property Pierce	[비테리지나 카드] 물리 무속성 찌르기
[死靈查普利卡片] 魔法暗屬性魔法	[Chapparition Card] Magic Dark Property Magic	[채퍼리션 카드] 매직 암속성 마법
[木乃伊賈西特卡片] 物理暗屬性魔法	[Mummyghast Card] Physical Dark Property Magic	[머미가스트 카드] 물리 암속성 마법
冰雪吐息	Ice Breath	아이스브레스
[鋼鐵巴溫卡片] 物理火屬性打擊	[Ironbaum Card] Physical Fire Property Strike	[아이언바움 카드] 물리 화속성 타격
[庫勒坤魔牛卡片] 魔法暗屬性刺擊	[Gorgon Card] Magic Dark Property Pierce	[고르곤 카드] 매직 암속성 찌르기
[德拉涪里溫卡片] 物理暗屬性刺擊	[Drapeliun Card] Physical Dark Property Pierce	[드라페리운 카드] 물리 암속성 찌르기
[獨角獸卡片] 魔法暗屬性斬擊	[Unicorn Card] Magic Dark Property Slash	[유니콘 카드] 매직 암속성 베기
[魔地獸卡片] 魔法毒屬性魔法	[Moldyhorn Card] Magic Poison Property Magic	[몰디혼 카드] 매직 독속성 마법
[霸王食人花卡片] 魔法毒屬性刺擊	[Rytaswort Card] Magic Poison Property Pierce	[리타스워트 카드] 매직 독속성 찌르기
[夏勒琵雅卡片] 物理電氣屬性斬擊	[Harpeia Card] Physical Lightning Property Slash	[하르피아 카드] 물리 전기속성 베기
[魔斯怪怪卡] 物理電氣屬性刺擊	[Mothstem Card] Physical Lightning Property Pierce	[모스템 카드] 물리 전기속성 찌르기
[摩吉卡片] 物理無屬性斬擊	[Merge Card] Physical Non-Property Slash	[머지 카드] 물리 무속성 베기
[女妖克萊默卡片] 物理毒屬性打擊	[Clymen Card] Physical Poison Property Strike	[클라이멘 카드] 물리 독속성 타격
[惡魔葛洛夫卡片] 魔法電氣屬性打擊	[Devilglove Card] Magic Lightning Property Strike	[데블글로브 카드] 매직 전기속성 타격
[地獄亡靈卡片] 魔法暗屬性魔法	[Necroventer Card] Magic Dark Property Magic	[네크로벤터 카드] 매직 암속성 마법
[莫雷克卡片] 物理暗屬性打擊	[Molich Card] Physical Dark Property Strike	[몰렉 카드] 물리 암속성 타격
[約納喬雷卡片] 魔法無屬性打擊	[Yonazolem Card] Magic Non-Property Strike	[요나졸렘 카드] 매직 무속성 타격
[鐵甲殘魔卡片] 物理暗屬性斬擊	[Abomination Card] Physical Dark Property Slash	[어보미네이션 카드] 물리 암속성 베기
[機角卡洛斯卡片] 物理暗屬性刺擊	[Ellaganos Card] Physical Dark Property Pierce	[엘라가노스 카드] 물리 암속성 찌르기
[亞崑卡片] 物理火屬性打擊	[Archon Card] Physical Fire Property Strike	[아콘 카드] 물리 화속성 타격
[魔龍凱拉斯卡片] 物理火屬性魔法	[Gaigalas Card] Physical Fire Property Magic	[가이갈라스 카드] 물리 화속성 마법
[佛朗布卡片] 魔法暗屬性打擊	[Bramble Card] Magic Dark Property Strike	[브람블 카드] 매직 암속성 타격
[鬼眼蜘蛛卡片] 物理毒屬性打擊	[Honeypin Card] Physical Poison Property Strike	[허니핀 카드] 물리 독속성 타격
[火暴地鼠獸卡片] 物理電氣屬性打擊	[Bebraspion Card] Physical Lightning Property Strike	[베브라스피온 카드] 물리 전기속성 타격
[樹林巨獸] 魔法火屬性魔法	[Giant Red Wood Goblin Card] Magic Fire Property Magic	[자이언트 레드 우드 카드] 매직 화속성 마법
[樹林巨獸卡片] 魔法無屬性魔法	[Giant Wood Goblin Card] Magic Non-Property Magic	[자이언트 우드 고블린 카드] 매직 무속성 마법
[奇魯毛蟲獸卡片] 物理毒屬性刺擊	[Kirmelich Card] Physical Poison Property Pierce	[키르멜리치 카드] 물리 독속성 찌르기
[火山龜獸] 物理火屬性魔法	[Magbug] Physical Fire Property Magic	[매그버크] 물리 화속성 마법
[克帕奇樹妖卡片] 物理毒屬性打擊	[Kepachieftain Card] Physical Poison Property Strike	[케파치프틴 카드] 물리 독속성 타격
[艾哈特卡片] 魔法無屬性魔法	[Achat Card] Magic Non-Property Magic	[에하트 카드] 매직 무속성 마법
[虛拿因卡片] 魔法電氣屬性魔法	[Shnayim Card] Magic Lightning Property Magic	[쉬나임 카드] 매직 전기속성 마법
[鎖鏈羅德卡片] 魔法暗屬性魔法	[Tomb Lord Card] Magic Dark Property Magic	[툼로드 카드] 매직 암속성 마법
[巨眼丹提卡片] 魔法電氣屬性 斬擊	[Denoptic Card] Magic Lightning Property Slash	[덴옵틱 카드] 매직 전기속성 베기
[伊提斯大嘴獸卡片] 物理毒屬性魔法	[Iltiswort Card] Physical Poison Property Magic	[일티스워트 카드] 물리 독속성 마법
[巨魔蠍卡片] 物理毒屬性刺擊	[Scorpio Card] Physical Poison Property Pierce	[스콜피오 카드] 물리 독속성 찌르기
[強化毒] 魔法毒屬性魔法	[Enchant Poison] Magic Poison Property	[인챈트포이즌] 매직 독속성 마법
[尖角皮德蟲卡片] 物理毒屬性打擊	[Ravinepede Card] Physical Poison Property Strike	[라바인피드 카드] 물리 독속성 타격
[拉查托特卡片] 物理水屬性魔法	[Rajatoad Card] Physical Water Property Magic	[라자토드 카드] 물리 수속성 마법
[邪惡寶箱怪卡片] 物理暗屬性打擊	[Unknocker Card] Physical Dark Property Strike	[언낙커 카드] 물리 암속성 타격
[薩爾提斯托卡片] 物理水屬性打擊	[Saltistter Card] Physical Water Property Strike	[살티스터 카드] 물리 수속성 타격
[鐵甲殭屍卡片] 物理無屬性斬擊	[Deadborn Card] Physical Non-Property Slash	[데드본 카드] 물리 무속성 베기
[克洛提德卡片] 魔法神聖屬性魔法	[Corrupted Card] Magic Holy Property Magic	[코럽티드 카드] 매직 신성속성 마법
[瑪爾雷飛龍卡片] 魔法無屬性打擊	[Mallet Wyvern Card] Magic Non-Property Strike	[말렛와이번 카드] 매직 무속성 타격
[莫亞班羅喀卡片] 物理無屬性打擊	[Moyabruka Card] Physical Non-Property Strike	[모야브루카 카드] 물리 무속성 타격
[柯里曼希亞卡片] 物理水屬性打擊	[Colimencia Card] Physical Water Property Strike	[콜리멘시아 카드] 물리 수속성 타격
[魔鬼鰩卡片] 魔法水屬性打擊	[Rajapearl Card] Magic Water Property Strike	[라자펄 카드] 매직 수속성 타격
[蘑菇沃特卡片] 魔法毒屬性魔法	[Mushwort Card] Magic Poison Property Magic	[머쉬워트 카드] 매직 독속성 마법
[雷普斯卡片] 物理水屬性刺擊	[Lepus Card] Physical Water Property Pierce	[레푸스 카드] 물리 수속성 찌르기
[斯帕勒那絲卡片] 物理電氣屬性魔法	[Sparnas Card] Physical Lightning Property Magic	[스파르나스 카드] 물리 전기속성 마법
[仙人掌妖精卡片] 物理毒屬性魔法	[Cactusvel Card] Physical Poison Property Magic	[캑터스벨 카드] 물리 독속성 마법
[丟擲] 物理無屬性打擊	[Throw] Physical Non-Property Strike	[던지기] 물리 무속성 타격
[貝洛查德卡片] 魔法毒屬性魔法	[Velorchard Card] Magic Poison Property Magic	[벨로차드 카드] 매직 독속성 마법
[魯托普士卡片] 物理無屬性刺擊	[Luropus Card] Physical Non-Property Pierce	[루토푸스 카드] 물리 무속성 찌르기
[迪歐尼亞卡片] 魔法無屬性魔法	[Dionia Card] Magic Non-Property Magic	[디오니아 카드] 마법 무속성 매직
[凱吉青苔泥人卡片] 物理火屬性打擊	[Gazing Golem Card] Physical Fire Property Strike	[게이징 골렘 카드] 물리 화속성 타격
[樹葉召喚] 魔法無屬性魔法	[Summon Leaves] Non-Property Magic	[나뭇잎 소환] 매직 무속성 마법
[希德拉卡片] 物理水屬性魔法	[Hydra Card] Physical Water Property Magic	[히드라 카드] 물리 수속성 마법
[莫厄卡片] 物理無屬性打擊	[Moa Card] Physical Non-Property Strike	[모아 카드] 물리 무속성 타격
[南瓜燈籠怪卡片] 魔法火屬性刺擊	[Jack O'Lantern Card] Magic Fire Property Pierce	[잭오랜턴 카드] 매직 화속성 찌르기
[孟堤肯卡片] 物理無屬性魔法	[Manticen Card] Physical Non-Property Magic	[맨티켄 카드] 물리 무속성 마법
[瑪因洛德卡片] 物理電氣屬性魔法	[Mineloader Card] Physical Lightning Property Magic	[마인로더 카드] 물리 전기속성 마법
[克萊獰怪卡片] 魔法火屬性魔法	[Grinender Card] Magic Fire Property Magic	[그라이넨더 카드] 매직 화속성 마법
[赫嘉塞露卡片] 物理暗屬性斬擊	[Helgasercle Card] Physical Dark Property Slash	[헬가세르클 카드] 물리 암속성 베기
[耶庫卡片] 魔法暗屬性打擊	[Yekub Card] Magic Dark Property Strike	[예쿱 카드] 매직 암속성 타격
[物理盾牌] 魔法無屬性魔法	[Physical Shield] Non-Property Magic	[물리 실드] 매직 무속성 마법
[史潘飛行獸人卡片] 物理無屬性魔法	[Sparnasman Card] Physical Non-Property Magic	[스파나스맨 카드] 물리 무속성 마법
增加HP、SP恢復力	Increase HP & SP Recovery	HP, SP 회복력 증가
屬性增加	Increased Stats	스탯 증가
增加所有屬性能力值。	Increased All Stats	모든 스탯 능력치가 증가합니다.
冷卻時間減少	Decrease Cooldown Time	재사용 대기시간 감소
減少技能冷卻時間	Decreases Skill Cooldown Time	스킬 재사용 대기시간이 감소합니다
攻擊力增加	Increased Attack	공격력 증가
防禦力增加	Increase defense	방어력 증가
增加經驗值獲得量	Increased EXP Rate	경험치 획득량 증가
火柱	Fire Pillar	파이어 필라
純白新娘捧花	Pure White Wedding Bouquet	순백의 신부 부케
新娘捧花	May Wedding Bouquet	5월의 신부 부케
扇子	Fan	부채
火焰彈	Flame	화염 탄
對敵人發射火焰彈	Shoot Flame to enemy	적에게 화염 탄을 발사합니다
電氣彈	Lightning	전기 탄
對敵人發射雷彈	Shoot Lightning to enemy	적에게 뇌 탄을 발사합니다
寒氣彈	Chill	냉기 탄
對敵人發射寒氣彈	Shoot Chill to enemy	적에게 냉기 탄을 발사합니다
亞卡利歐基本攻擊	Creepy Klaipeda Basic Attack	아가리오 기본 공격
糖果疾走	Candy Dash	캔디 대쉬
亞卡利歐基本攻擊2	Creepy Klaipeda Basic Attack2	아가리오 기본 공격2
亞卡利歐基本攻擊3	Creepy Klaipeda Basic Attack3	아가리오 기본 공격3
亞卡利歐基本攻擊4	Creepy Klaipeda Basic Attack4	아가리오 기본 공격4
雪人玩具	Magical Snowman Wand	눈사람 장난감
聖誕鐘玩具	Christmas Handbell	크리스마스 종 장난감
突刺	Thrust	쓰러스트
痛擊	Bash	배쉬
專注	Concentrate	콘센트레이트
苦痛屏障	Pain Barrier	페인 배리어
抑制	Restrain	리스트레인
劍柄打擊	Pommel Beat	포멀비트
二重斬	Double Slash	더블슬래쉬
盾心打擊	Umbo Blow	엄보블로
盾緣敲擊	Rim Blow	림블로
敲盾挑釁	Swash Buckling	스워시 버클링
盾牌投擲	Shield Lob	실드랍
高級守護	High Guard	하이가드
蝴蝶	Butterfly	버터플라이
盾心突刺	Umbo Thrust	엄보 쓰러스트
長刺	Langort	랑고르트
車輪斬	Wagon Wheel	수레바퀴
蓄力一擊	Cartar Stroke	카타스트로크
擊頭	Crown	크라운
十字守護	Cross Guard	크로스 가드
連續斬	Moulinet	뮬리넷
骷髏搖擺	Skull Swing	스컬 스윙
破空斬	Skyliner	스카이라이너
十字斬擊	Crosscut	크로스컷
垂直斬	Vertical Slash	버티컬 슬래쉬
刺擊	Stabbing	스태빙
貫穿擊	Pierce	피어스
瞄準隙缝	Finestra	피네스트라
雙手突刺	Synchro Thrusting	양손찌르기
長驅直入	Long Stride	롱스트라이드
長矛投擲	Spear Throw	투창
長矛刺擊	Spear Lunge	스피어 런지
開腸剖肚	Embowel	임바우얼
侵略者	Aggressor	어그레서
野蠻人	Savagery	새비지리
踐踏	Stomping Kick	스톰핑 킥
戰鬥怒吼	Warcry	워크라이
狂怒	Frenzy	프렌지
大車輪	Giant Swing	자이언트 스윙
突襲	Pouncing	파운싱
破顱斬	Helm Chopper	헬름쵸퍼
地裂斬	Seism	사이즘
劈斬	Cleave	클리브
盾牌衝鋒	Shield Charge	실드 챠지
蒙塔諾	Montano	몬타노
盾牌碎擊	Targe Smash	타지스매쉬
盾牌推擊	Shield Push	실드푸시
迴避移動	Slithering	회피이동
盾牌猛擊	Shield Shoving	실드셔빙
盾牌痛擊	Shield Bash	실드배쉬
上段踢	High Kick	하이킥
穿刺	Impaler	임패일러
地動波	Earth Wave	어스 웨이브
疾行	Trot	트롯
騎乘衝鋒	Steed Charge	스티드 챠지
毀滅刺擊	Doom Spike	둠 스파이크
突擊	Rush	돌격
死亡牽引	Dragging Death	드래깅 데쓰
特技騎乘	Acrobatic Mount	아크로바틱 마운트
武器整修	Weapon Maintenance	무기 손질
防具整修	Armor Maintenance	방어구 손질
維修	Repair	리페어
捕縛	Arrest	포박
設置營地	Base Camp	베이스 캠프 설치
設置餐台	Refreshment Table	배식대 설치
按技能等級增加飲食效能。	Increases food effectiveness with each skill level	스킬 레벨별로 음식의 효능 증가
懲罰減少	Penalty Reduction	페널티 감소
死亡連擊	Deadly Combo	데들리 콤보
海賊旗	Jolly Roger	졸리로저
鐵鉤	Iron Hook	아이언 후크
龍骨拖引	Keel Hauling	킬 홀링
開箱	Unlock Chest	언락 체스트
雙手猛攻	Double Weapon Assault	쌍수맹공
掠奪	Pillaging	약탈
塵捲風	Dust Devil	더스트 데블
毀滅連擊	Hexen Dropper	헥슨드롭퍼
迅捷槍殺	Quick and Dead	퀵 앤드 데드
刺穿匕首	Impale Dagger	임페일 대거
徵召	Conscript	컨스크립트
方陣	Phalanx	팔랑크스
大方陣	Tercio	테르시오
鶴翼陣	Winged Formation	학익진
楔形陣	Wedge Formation	웨지 포메이션
密集方陣	Schiltron Formation	스킬트론
龜甲陣	Testudo	테스튜도
方向轉換	Change Direction	방향전환
爭鬥者	Skirmisher	스커미셔
特戰隊型	Special Formation	특전대형
召喚馬車	Summon Carriage	마차 소환
英勇行動	Deeds of Valor	디드 오브 밸러
擊殺	Mordschlag	살격
雙酬	Double Pay Earn	더블페이언
折磨	Punish	퍼니쉬
旋風斬	Cyclone	사이클론
會心一擊	Zornhau	존하우
迴旋斬擊	Redel	레델
側邊揮擊	Zucken	츠켄
旋斬	Zwerchhau	즈버크하우
怨捶斬	Sturtzhau	슈트루츠하우
連續擊刺	Attaque Composee	아따끄 꽁뽀제
弓步刺擊	Lunge	런지
七星擊	Sept Etoiles	세테뚜와르
護手攻擊	Attaque Coquille	아따끄 꼬끼유
閃避刺擊	Esquive Toucher	에스뀌브 뚜슈
準備姿勢	Preparation	프레파라시옹
滑劍刺擊	Flanconnade	플랑코나드
迅猛刺擊	Balestra Fente	발레스트라 팡트
武器擊落	Attaque au Fer	아따끄 오 페르
爆猛刺擊	Fleche	플레쉬
微塵忍術	Mijin no Jutsu	인법 미진술
影分身忍術	Bunshin no Jutsu	인법 분신술
木遁忍術	Mokuton no Jutsu	인법 목둔술
火遁忍術	Katon no Jutsu	인법 화둔술
御璽頭具	Cassis Crista	어인 투구
狂傲斬擊	Frenzied Slash	프렌지드 슬래쉬
 迴避刺擊	Evade Thrust	이베이드 쓰러스트
頭擊	Headbutt	헤드버트
報復痛擊	Take Down	테이크 다운
狂傲猛踢	Frenzied Shoot	프렌지드 슛
飛盾	Scutum Hit	스큐텀 힛
盾牌衝擊	Shield Train	실드 트레인
疾奔	Sprint	스프린트
龍牙	Dragontooth	드래곤투스
蛇咬之舞	Serpentine	서펜틴
穿刺之矛	Gae Bulg	게이불그
昇龍之勢	Dragon Soar	드래곤소어
驅趕	Dethrone	디쓰론
神隱龍	Dragon Dive	드래곤 다이브
龍墜	Dragon Fall	드래곤 폴
召喚公會成員	Summon Guild Member	길드원 소환
移動至公會成員	Warp To Guild Member	길드원에게 이동
移動至所選擇的公會成員的位置	Warp To Specific Guild Member's Location	선택한 길드원의 위치로 이동
公會塔	Build Guild Tower	길드 타워
提升公會塔功能	Improve Guild Tower Features	길드 타워 기능 향상
減少製作時間	Reduce Craft Time	제작시간 감소
戰鬥命令	Battle Orders	배틀 오더스
索命斬擊	Mortal Slash	모탈 슬래쉬
BUFF共享	Buff Share	버프 공유
不可侵犯的領域	Non-Invasive Area	불가침 영역
粉碎一擊	Crush	크러쉬
頭部襲擊	Head Strike	헤드 스트라이크
沉默刺擊	Joust	자우스트
落馬攻擊	Unhorsing	낙마 공격
正中標靶	Quintain	퀸테인
開始	Initiate	개시
預防	Prevent	프리벤트
隆格米安特	Rhongomiant	롱고미안트
紅布挑釁	Capote	카포티
紅絨布	Muleta	물레타
連續劈刺	Faena	파에나
歡呼	Ole	올레
鬥牛舞	Paso Doble	파소 도블레
滑行迴避	Back Slide	백 슬라이드
泰拳搏擊	Ram Muay	람무아이
掃踢	Te Kha	때카
肘擊	Sok Chiang	쏙콴
上段正踢	Te Trong	때트롱
膝擊	Khao Loi	카오로이
能量箭	Energy Bolt	에너지 볼트
虛弱	Lethargy	레써지
催眠	Sleep	슬리프
魔法護盾	Magic Shield	매직 실드
地震	Earthquake	어스퀘이크
超級詠唱	Surespell	슈어스펠
快速施法	Quick Cast	퀵 캐스트
火球	Fireball	파이어볼
火牆	Fire Wall	파이어월
火焰附魔	Enchant Fire	인챈트 파이어
烈焰	Flare	플레어
地獄氣息	Hell Breath	헬브레스
烈焰大地	Flame Ground	플레임 그라운드
冰箭	Ice Bolt	아이스볼트
冰槍	Ice Pike	아이스파이크
冰爆術	Ice Blast	아이스 블래스트
滾動雪球	Snow Rolling	스노우 롤링
冰柱	Frost Pillar	프로스트필라
靈能壓力	Psychic Pressure	사이킥 프레셔
念動力	Telekinesis	텔레키네시스
位置互換	Swap	스왑
瞬間移動	Teleportation	텔레포테이션
磁力	Magnetic Force	마그네틱 포스
浮空	Raise	레이즈
重力磁場	Gravity Pole	그라비티 폴
強力重力	Heavy Gravity	헤비 그라비티
解除鏈結	Unbind	언바인드
物理鏈結	Physical Link	피지컬링크
絞首鏈	Hangman's Knot	행맨스 낫
精神鏈結	Spiritual Chain	스피리추얼 체인
生命線	Lifeline	생명줄
精神衝擊	Spirit Shock	스피릿 쇼크
左臂強化	Swell Left Arm	왼팔 강화
體積變大	Swell Body	크기 확대
能力調換	Transpose	트랜스포스
法陣反轉	Reversi	리버시
右臂強化	Swell Right Arm	오른팔 강화
大腦強化	Swell Brain	스웰 브레인
電擊	Electrocute	일렉트로큐트
冰雹	Hail	헤일
紅焰	Prominence	홍염
隕石	Meteor	메테오
雨水	Rain	레인
冰球	Freezing Sphere	프리징 스피어
冰霜之雲	Frost Cloud	프로스트 클라우드
礫石暴風	Storm Dust	스톰 더스트
召喚惡魔	Summoning	서모닝
召魔：指定攻擊	Attack Ground	지정 공격
召魔：騎乘	Riding	탑승
可以使用惡魔的技能。	Enables use of the devil's skills	악마의 스킬 사용 가능
召魔：變異	Morph	변이
變形為登錄在魔法上的{nl}其它惡魔型BUSS	Transform to another Devil-type boss that is added to the Grimoire	그리모어에 등록한{nl}또 다른 악마형 보스로 변이
召魔：待命	Hold	홀드
召喚使役魔	Summon Familiar	사역마 소환
召喚薩拉米恩	Summon Salamion	살라미온 소환
召喚僕人	Summon Servant	서번트 소환
召喚邪靈	Evocation	이보케이션
重生	Reincarnate	환생
停止	Stop	스톱
緩速	Slow	슬로우
移動加快	Haste	헤이스트
時間倒轉	Backmasking	백마스킹
縮時	Pass	패스
屍塊收集	Gather Corpse	게더 콥스
製造修格斯	Create Shoggoth	쇼고스 만들기
屍塊砲擊	Flesh Cannon	플래쉬 캐논
屍塊護環	Flesh Hoop	플래쉬 후프
土牆	Dirty Wall	더티 월
屍塊挖掘	Disinter	디신터
污穢之柱	Dirty Pole	더티 폴
死者甦醒	Raise Dead	레이즈 데드
屍塊襲擊	Flesh Strike	플래쉬 스트라이크
召喚骸骨弓箭手	Raise Skull Archer	레이즈 스컬아처
燃燒	Combustion	컴버스천
挖掘	Dig	디그
製作寶石	Gem Roasting	젬 로스팅
熔合	Briquetting	브리케팅
製作藥劑	Tincturing	팅크쳐링
透過配方製作藥水	Create a potion through a recipe	레시피를 통해 포션 제작
究極煉成	Magnum Opus	마그눔 오푸스
道具喚醒	Item Awakening	아이템 어웨이크닝
鍊金術士 飛彈	Alchemistic Missile	알케미스틱 미사일
血浴	Blood Bath	블러드배쓰
骨頭指點	Bone Pointing	본 포인팅
腐敗骨刺	Ngadhundi	은가둔디
死亡步伐	Kurdaitcha	커다이챠
昆德拉斬擊	Kundela Slash	쿤델라 슬래쉬
反重力	Levitation	레비테이션
血之詛咒	Blood Curse	블러드 커스
衰弱	Enervation	에너베이션
苦痛之柱	Pole of Agony	폴 오브 아고니
惡靈召喚	Invocation	인보케이션
惡意	Mastema	마스테마
惡靈獻祭	Evil Sacrifice	이블 새크리파이스
精神耗盡	Drain	드레인
安息日	Ghastly Trail	사바쓰
惡魔爪擊	Demon Scratch	데몬 스크래치
破壞符文	Rune of Destruction	파괴의 룬
寒水符文	Rune of Ice	얼음의 룬
巨人符文	Rune of Giants	거인의 룬
正義符文	Rune of Justice	정의의 룬
保護符文	Rune of Protection	보호의 룬
出發到好友那邊	Warp to Friend	친구에게 이동
出發道已選擇的好友那邊	Warp to Specific Friend's Location	선택한 친구의 위치로 이동
粒子空間	Micro Dimension	마이크로 디멘션
終極空間	Ultimate Dimension	얼티밋 디멘션
瞬間幻影	Blink	블링크
驚恐	Maze	메이즈
縮小魔法陣	Magic Circle Reduction	마법진 축소
飛彈	Missile Hole	미사일 홀
傳送商店	Portal Shop	포탈 상점
傳點可開啟次數3次	Up to 3 saved locations may be used	포탈 개시 가능 수 3회
空間壓縮	Dimension Compression	디멘션 컴프레션
恍惚	Enchantment	인챈트먼트
戰利獎賞	Reward	리워드
敏捷	Agility	어질리티
防具附魔	Enchant Armor	인챈트 아머
製作魔法卷軸	Craft Spellbook	스펠북 제작
咒語書使用後就會消失	The spellbook disappears after it's used	스펠북은 사용 후 사라짐
雷屬性附魔	Enchant Lightning	인챈트 라이트닝
精神賦予	Empowering	임파워링
大地強化	Enchant Earth	인챈트 어스
暗影荊棘	Shadow Thorn	섀도우 쏜
暗影魔法	Shadow Conjuration	섀도우 컨저레이션
暗影沼澤	Shadow Pool	섀도우 풀
幻影分身	Hallucination 	할루시네이션
暗影束縛	Shadow Fetter	섀도우 페터
滿弦	Full Draw	풀드로우
跪射	Kneeling Shot	닐링샷
迅步	Swift Step	스위프트스텝
斜射	Oblique Shot	오블리크 샷
強力射擊	Heavy Shot	헤비샷
雙箭	Twin Arrows	트윈애로우
扇射	Barrage	배라지
貫通箭	High Anchoring	하이앵커링
暴擊射擊	Critical Shot	크리티컬 샷
穩定瞄準	Steady Aim	스테디에임
定時炸彈箭	Time Bomb Arrow	타임봄 애로우
彈跳射擊	Bounce Shot	바운스샷
箭雨	Arrow Sprinkle	화살비
置盾	Deploy Pavise	파비스 설치
丟擲鐵蒺藜	Scatter Caltrops	캘트롭 뿌리기
撿取石彈	Stone Picking	돌멩이 줍기
石頭射擊	Stone Shot	스톤샷
連續射擊	Rapid Fire	래피드파이어
拆除	Teardown	철거
奔跑射擊	Running Shot	런닝샷
竹尖釘	Punji Stake	푼지스테이크
引爆陷阱	Detonate Traps	데토네이트 트랩
隱蔽	Conceal	은폐
掃蕩陷阱	Broom Trap	브룸트랩
鋼絲陷阱	Spike Shooter	스파이크 슈터
連打型陷阱	Continuous-type Trap	연타형 트랩
追蹤咬擊	Coursing	코싱
攫取	Snatching	스내칭
衝鋒	Rush Dog	러쉬독
讚揚	Praise	프레이즈
標記	Pointing	포인팅
咬回	Retrieve	리트리브
追蹤	Hounding	하운딩
咆哮	Growling	그로울링
解毒	Detoxify	해독
吹箭	Needle Blow	취시
蠱惑	Bewitch	고혹
蜈蚣蠱	Wugong Gu	오공고
毒罐	Throw Gu Pot	독항아리
金蠶蠱	Jincan Gu	금잠고
鴆毒	Zhendu	짐 독
偽裝	Camouflage	카모플라주
響箭	Flu Flu	플루플루
燃燒箭	Flare Shot	플레어 샷
潛行	Cloaking	클로킹
距離扭曲	Perspective Distortion	원근왜곡
掃瞄	Scan	스캔
預備	Be Prepared	차렷
分裂箭	Split Arrow	스플릿 애로우
偷襲	Sneak Hit	스닉 힛
佯攻	Feint	페인트
奪取	Capture	노획
仇殺	Vendetta	벤데타
迴避	Evasion	이베이션
潛伏	Burrow	버로우
催淚彈	Lachrymator	최루
背刺	Backstab	백스텝
闊箭	Broadhead	브로드헤드
荊棘箭	Barbed Arrow	바브드애로
交叉火力	Crossfire	크로스파이어
集中炮火	Concentrated Fire	집중포화
逃脫射擊	Caracole	카라콜
騎射	Limacon	리마콘
後退射擊	Retreat Shot	후퇴 사격
狂射	Wild Shot	와일드 샷
啟動迴避	Evasive Action	회피기동
進射	Marching Fire	돌격 사격
呼喚	Call	부르기
棲木	Roost	횃대 설치
盤旋	Circling	서클링
俯衝	Hovering	호버링
懸吊射擊	Hanging Shot	행잉샷
鷹屎白	Looking	응시백
音速突擊	Sonic Strike	음속타
熔合	Combination	콤비네이션
神隱彈	Dive Bomb	다이브 봄
瞄準	Aiming	에이밍
主動攻擊	Pre-Emptive Strike	선제 공격
重砲射擊	Cannon Shot	캐논샷
對空砲擊	Shootdown	슛다운
攻城轟炸	Siege Burst	시즈버스트
重砲轟炸	Cannon Blast	캐논 블래스트
連續砲擊	Cannon Barrage	캐논 배라지
火箭筒	Bazooka	바주카
大砲轟炸	Sweeping Cannon	스위핑 캐논
掩護射擊	Covering Fire	커버링파이어
爆頭射擊	Headshot	헤드샷
狙擊	Snipe	스나이프
穿透射擊	Penetration Shot	페네트레이션 샷
槍托重擊	Butt Stroke	버트스트로크
刺刀突擊	Bayonet Thrust	바요넷 쓰러스트
群體發射	Volleyfire	발리파이어
鳥狙	Birdfall	버드폴
狙擊手的沉著	Sniper's Serenity	스나이퍼즈 세레니티
裝填就緒	Prime and Load	프라임 앤드 로드
槍口律動	Grooving Muzzle	그루빙 머즐
銳光切擊	Skarphuggning	스칼푸그닝
刀騎兵	Hakka Palle	하카 펠레
炮擊命令	Bombardment Orders	포격 명령
騎兵衝鋒	Hackapell Charge	하카펠 차지
腿部射擊	Leg Shot	다리 쏘기
騎兵集氣	Cavalry Charge	카발리 챠지
暴風錘	Storm Bolt	스톰 볼트
連續斬擊	Grind Cutter	그라인드 커터
多方射擊	Spread Shot	스프레드 샷
火力集中	Homing Arrow	호밍 애로우
速射	Rapid Fire	속사
跳躍射擊	Jump Shot	도약 사격
帕提亞射擊	Parthian Shaft	파르티안 샤프트
箭雨	Down Fall	다운 폴
鑑定	Identify	감정
高估	Overestimate	과대평가
仿造品	Forgery	모조품
低估	Devaluation	평가절하
弱點攻擊	Blindside	약점공격
銀彈	Silver Bullet	실버불릿
電擊彈	Tase	테이즈
燃燒彈	Napalm Bullet	소이탄
全金屬包覆彈	Full Metal Jacket	풀 메탈 자켓
雙槍姿態	Double Gun Stance	더블 건 스탠스
血腥殺戮	Bloody Overdrive	블러디 오버드라이브
粉碎彈	Smash Bullet	파쇄탄
曳光彈	Tracer Bullet	예광탄
莫三比克射擊法	Mozambique Drill	모잠비크 드릴
軍刀痛擊	Saber Bash	세이버 배쉬
軍馬衝突	Horse Tackle	군마충돌
空砲彈	Blank Ammunition	공포탄
箭頭攻擊	Pommel Attack	폼멜찍기
弱化	Weakening	약화
揮舞弓箭	Brandish Bow	브랜디쉬 보우
演奏笛子	Playing Flute	피리 연주
淨化	Cure	큐어
安全領域	Safety Zone	세이프티 존
破防領域	Deprotected Zone	디프로텍티드 존
神聖力量	Divine Might	디바인 마이트
漸隱	Fade	페이드
守護聖人	Guardian Saint	수호성인
暴擊魔法陣	Zalciai	잘챠이
神光	Daino	다이노
神聖烙印	Divine Stigma	디바인 스티그마
祈禱	Melstis	멜스티스
潑灑聖水	Aspersion	아스퍼션
聖光體	Monstrance	몬스트런스
祝福	Blessing	블레싱
復活術	Resurrection	리저렉션
聖禮	Sacrament	사크라멘트
重生	Revive	리바이브
驅魔	Exorcise	엑소사이즈
多多拉	Dodola	도돌라
群體治療	Mass Heal	매스 힐
皮膚硬化	Stone Skin	스톤 스킨
迷惑	Hexing	헥싱
釘草人	Effigy	에피지
驅屍	Tet Mamak La	텟 마카클라
製造殭屍	Zombify	좀비 만들기
符咒	Mackangdal	마캉달
殭屍圍繞	Bwa Kayiman	브와카이망
體力旗幟	Samediveve	삼디베베
力量旗幟	Ogouveve	오구베베
殭屍自爆	Damballa	댐발라
殭屍膠囊	Zombie Capsule	좀비 캡슐
雕刻攻擊	Carve Attack	목각 공격
貓頭鷹雕刻	Carve Owl	부엉이 조각
靈魂出竅	Out of Body	유체이탈
靈體合一	Prakriti	프라크리티
衰弱	Vashita Siddhi	바쉬타 싯디
靈魂爆炸	Astral Body Explosion	유체 폭발
支配	Possession	포제션
能量傳送	Transmit Prana	프라나 전송
靈體攻擊	Attack soul	영체 공격
靈魂結界	Spirit Barrier	영혼의 결계
重擊	Smite	스마이트
恢復	Restoration	리스토레이션
元素抗性	Resist Elements	레지스트 엘레멘츠
驅趕惡靈	Turn Undead	턴 언데드
皈依	Conversion	개종
定罪	Conviction	컨빅션
庇護	Sanctuary	생츄어리
摧毀	Demolition	데몰리션
鐵布衫	Iron Skin	철포삼
雙鎖功	Double Punch	쌍쇄공
鐵砂掌	Palm Strike	철사장
觀音掌	Hand Knife	관음장
寸勁	One Inch Punch	촌경
氣功波	Energy Blast	양광수
彈指神功	God Finger Flick	탄지신통
聖職買賣	Simony	시모니
寬恕	Indulgentia	인둘겐티아
辨別邪惡	Discerning Evil	디서닝 이블
奉獻	Oblation	봉헌
開設魔法商店	Spell Shop	주문 판매상점 개설
製作驅除器	Dispeller Crafting	디스펠러 제작
推進器製作	Craft Booster	부스터제작
魔防增加	Increase Magic Defense	마법방어력 증가
the TEN	Dekatos	데카토스
心靈控制	Telepath	텔레파쓰
肉食植物	Carnivory	육식화
形態變換	Shape Shifting	쉐입시프팅
變形術	Transform	트랜스폼
防禦植物	Sterea Trofh	스트레아 트로페
速成植被	Chortasmata	코르타스마타
救世者	Savior	세이비어
狼人化	Lycanthropy	라이칸스로피
女神呼喚	Call of Deities	콜오브디어티스
秘法能量	Arcane Energy	아케인에너지
轉換	Change	체인지
預知眼	Clairvoyance	클레어보이언스
反擊	Counter Spell	카운터스펠
預知	Forecast	포어캐스트
重置	Resetting	리셋팅
預言	Prophecy	프로퍼시
性別開關	Gender Switch	스위치 젠더
預示	Foretell	포어텔
命運扭轉	Twist of Fate	트위스트 오브 페이트
再生因子	Healing Factor	힐링팩터
焚燒	Incineration	소각
放血	Bloodletting	방혈
消毒	Fumigate	소독
感染	Pandemic	판데믹
鳥喙面具	Beak Mask	새 부리 가면
黑死病蒸氣	Black Death Steam	흑사병 증기
反附魔	Disenchant	디센챈트
美沙酮	Methadone	메타돈
七重煉獄	Revenged Sevenfold	리벤지드 세븐폴드
快蛇	Nachash	나하쉬
無盡	Ein Sof	아인 소프
梅爾卡巴戰輪	Merkabah	메르카바
數秘術	Gematria	게마트리아
拼詞計算術	Notarikon	노타리콘
連打機會	Double Chance	연타 챤스
等級降低	Reduce Level	레벨 감소
複製	Clone	복제
權能輪	Gevura	게부라
終傅聖事	Last Rites	종부성사
設置祈禱所	Deploy Cappella	카펠라 설치
十字驅魔	Magnus Exorcismus	장엄구마
潑灑聖水	Aspergillum	아스페르길룸
異端者佛克	Heretic's Fork	이단자 포크
鋼鐵靴	Iron Boots	아이언 부츠
噴蠟機	Lead Sprayer	납 뿌리개
神之粉碎	God Smash	갓 스매쉬
魔導的審判	Malleus Maleficarum	마도 심판
審判	Judgment	저지먼트
人足付地法	Entrenchment	인족부지법
引重法	Hurling	인중법
取人藏物法	Hidden Potential	취인장물법
急急如律令	Begone Demon	급급여율령
天衝符	Divine Punishment	천형부
祭神杖	Gohei	고헤이
清掃	Sweeping	빗자루질
破魔矢	Hamaya	하마야
神樂	Kagura	카구라
無懈可擊	Invulnerable 	인버너러블
犧牲	Immolation	이몰레이션
目光銳利	Beady Eyed	비디 아이드
狂熱	Fanaticism 	파나티시즘
狂熱幻覺	Fanatic Illusion	파나틱 일루젼
盲目信仰	Blind Faith	블라인드 페이쓰
疾走	Spurt	질주
恢復	Recovery	회복
發現	Discovery	발견
休息	Rest	휴식
安全	Safety	안전
寒氣	Chilly	냉기
結冰	Frozen	결빙
著火	Ignite	발화
復活後遺症	Resurrection After Effects	부활 후유증
昏倒	Stun	기절
無法行動。	Unable to move	행동 불가.
移動速度增加	Increase Movement Speed	이동속도증가
衝擊波	Shock wave	충격파
收到週期性的火屬性傷害	Periodically receive Fire damage	주기적으로 불 속성 피해를 받음.
固定移動速度	Fixed Movement Speed	이동속도고정
暗黑	Dark	암흑
猛毒	Deadly Poison	맹독
傳染性劇毒	Contagious Deadly Poison	전염성 맹독
迴避	Evasion	회피
防禦衝擊	Defense Shock	방어 충격
石化	Petrify	석화
強化忍耐	Enhance patience	강화 인내
活著的火花	Burning Flame	살아있는 불꽃
觸發寒氣	Trigger chill	냉기 촉발
燃燒	Burn	타오름
平靜	Calm	진정
中毒	Poison	중독
透明	Transparent	투명
怪物抑制	monster Hold	몬스터 홀드
怪物抑制 Script 連續	Monster hold script link	몬스터 홀드 스크립트 연계
攻擊力和迴避數值減少	Attack and evasion decrease	공격력과 회피 수치 감소
SP、耐力增加	Increased SP & Stamina	SP, 스태미나 증가
SP、耐力恢復量增加	Increases the amount of SP and Stamina recovery	SP, 스태미나 회복량 증가
憤怒	Rage	분노
中毒氣息	Addiction Aura	중독의 오오라
成長	Growth	성장
混亂	Confusion	혼란
僵直	Staggered	경직
凍結	Frozen	얼어붙음
行動者 Frozen	Actor Frozen	액터 Frozen
陣營破壞	Destroy Camp	진영 파괴
吸引	Suction	흡인
反射	Reflection	반사
技能追加中	Adding skills	스킬 추가중
犧牲	Sacrifice	희생
生機位置互換	Exchange life	생기 교환
靜止	Stop	정지
移動速度增加	Increased Movement Speed	이동속도 증가
移動速度大幅增加	Significantly increases Movement Speed	이동속도 대폭 증가
離子	Ion	이온
對象以外周圍傷害	Damage surroundings except target	대상제외 주변데미지
倒數	Countdown	카운트다운
隨對象攻擊的次數追加傷害	Additional damage according to the number attacks	대상이 공격한 횟수만큼 추가 피해
防具破壞	Armor Break	방어구파괴
傷害效果	Damage Effect	대미지효과
效果結束後受到傷害	Receive damage after an effect	효과가 끝나면 피해를 받음
可以更輕易開啟寶箱。	Can open the treasure chest easily	보물상자를 더 쉽게 열 수 있습니다.
恐怖	Fear	공포
出血	Bleeding	출혈
過多出血	Excessive Bleed	과다출혈
以念動力抓住敵人	Capture enemies with Telekinesis	텔레키네시스로 적을 붙잡음
被念動力抓住的狀態	Captured by Telekinesis	텔레키네시스로 인해 붙잡힌 상태
發生恐怖和混亂	Causes Fear and Confusion	공포와 혼란 발생
響箭效果	Flu Flu Effect	플루플루 효과
發生恐怖	Fear Outbreak	공포 발생
全身汽油	Oil Stains	기름범벅
神聖氣息	Holy Aura	홀리아우라
將新獲得的效果撒在我軍身上。	Spread the new buff received to allies	새로받은 효과를 아군에게 뿌린다.
煙霧	Fog	포그
箱子隱藏	Hide in Box	상자숨기
擋開	Parrying	패링
挑釁	Provoke	도발
鶴翼陣	Winged Formation	윙드 포메이션
稍後獲得傷害	Receive damage after a while	잠시 후 피해를 받음
火柱	Fire Pillar	파이어필라
感染	Infection	감염
無法移動	Movement Disabled	이동불가
減少移動速度	Decreased movement speed	이동속도 감소
出血毒	Bleeding Poison	출혈 독
神經毒	Neurotoxin	신경 독
要害強打	Vital Strike	급소 강타
庇護	Bless	블레스
聖水洗禮	Holy Baptism	성수 세례
局限	Limitation	리미테이션
生命之光。	Light of Life	생명의 빛
減少移動速度	Decreased movement speed	이동 속도 감소
神聖氣息	Divine Aura	신성의 기운
笑咪咪	Round	빙글
滴溜溜	All around	빙그르르
無法攻擊狀態	Attack disabled	공격불능상태
消護	Protection	수호
懸賞金	Reward	현상금
轉動	Round and round	빙글빙글
鸚鵡	Parrot	앵무새
擊倒力量增加	Increased knockdown power	넉다운파워증가
丟擲裝備	Throw Equipment	장비 던지기
隱藏左手裝備	Hide Left-handed Equipment	왼손장비 감추기
隱藏左手裝備	Hide Left-handed Equipment	왼손장비 감춤
隱藏右手裝備	Hide right handed Equipment	오른손장비 감추기
隱藏右手裝備	Hide Right-handed Equipment	오른손장비 감춤
迅步	Swift Step	스위프트 스텝
發生距離扭曲	Perspective distortion occurs	원근왜곡이 발생하고 있음
神聖力量	Divine Might	디바인마이트
衝擊	Shock	충격
增加暴擊攻擊力	Increased critical attack	치명타 공격력 증가
減少暴擊抵抗	Decreased critical resistance	치명타 저항 감소
冰爆術	Ice Blast	아이스블래스트
元素抗性	Resist Elements	레지스트 엘리멘츠
攻擊力強化	Enhanced Attack	공격력 강화
排除預定	Scheduled removal	제거 예정
1次暴擊增加	One-Time Increased Critical	1회 크리증가
防禦力增加	Increased defense	방어력증가
力量減少	Reduce STR	힘감소
力量減少	Decreased STR	힘이 감소합니다
神聖	Holiness	신성함
防禦力減少	Decreased defense	방어력 감소
敏捷暫時大幅提升	Agility is temporarily increased significantly	민첩이 일시적으로 대폭 상승
物理防禦力減少	Decreased physical defense 	물리 방어력 감소
減少物理防禦力	Decreased defense 	물리 방어력이 감소함
火屬性攻擊力提升。	Increased Fire property damage	불 속성 공격력 상승.
增加刺擊傷害。	Increased Pierce damage	찌르기 데미지 증가
強化火焰	Enchant Fire	인챈트파이어
激奮	Rage	격분
傷害增加、SP消耗量增加	Increased damage and SP cost	데미지 증가, sp 소모량 증가
集氣中-迴避	Charging - Evasion	차지중-회피
敵人的物理、魔法防禦力減少。	Enemy's physical and magic defense decreased	적의 물리, 마법 방어력이 감소
吹箭毒	Needle Blow Poison	취시 독
高亢	Poison Pot	고항
提升寵物的能力值	Companion Ability Buff	컴패니언의 능력치 향상
失衡	Unbalanced	언밸런스
升級	Level Up	레벨업
分身	Shadow Clone	분신
移動射擊 on	Moving Shot On	무빙샷on
大頭	Big Head	대두
束縛	Trap	결박
炸彈爆炸，對周圍造成傷害。	Bomb explodes and inflicts damage around	폭탄이 터지고, 주변에 피해를 입힙니다.
減少持續的傷害和 SP	Periodic decrease of SP and damage	지속적인 대미지와 SP 감소
丟擲右手裝備	Throw right-hand weapon	오른손 장비 던지기
掠奪。	Pillaging	약탈.
腐敗	Corruption	부패
無法攻擊	Unable to Attack	공격 불가
女神的庇護	Blessing of the Goddess	여신의 가호
範圍防禦比率固定為1的狀態	AoE defense rate fixed to 1	광역 방어 비율이 1로 고정된 상태
圖示轉換	Ani Change	애니 체인지
快死掉時圖示變更	Ani Change when damaged	피달면 애니변경
時間到後圖示變更	Ani Change when free time	시간되면 애니변경
受到週期性的火屬性傷害	Periodically receive Fire damage	주기적으로 불 속성 피해를 받음
SP 吸收	SP Absorption	SP 흡수
為吸收SP的狀態	SP Absorption Status	SP를 흡수하는 상태입니다
遭受SP吸收	SP absorbed	SP 흡수당함
SP遭吸收的狀態。	Status from receiving SP Absorption	SP를 흡수당하는 상태입니다
1等級狀態以上免疫	Immune to Lv1 status ailments	1레벨 상태이상 면역
盾牌痛擊-屬性能力混亂。	Shield Bash-Mix stat	실드배쉬-스탯 뒤섞임
對打擊攻擊脆弱	Vulnerable to Strike attacks	때리기 공격에 취약해짐
狂氣	Lunacy	광기
長矛刺擊	Spear Lunge	스피어런지
下一次攻擊的刺擊屬性攻擊力增加。	Increased Pierce-type attack upon the next attack	다음 1회 공격하는 찌르기 속성의 공격력이 증가합니다.
移動速度增加	Increased movement speed	이동 속도 증가
隱身	Stealth	은신
移動速度減少狀態。	Decreased movement speed	이동속도 감소 상태입니다
減少冷卻時間	Reducing cooltime	재사용 대기시간이 감소합니다
移動速度、迴避減少	Decreased movement speed and evasion	이동속도, 회피 감소
斬擊攻擊下變得脆弱	Vulnerable to Slash Attacks	베기 공격에 취약해짐
暴擊抵抗 降低	Decreased Critical Resistance	크리티컬 저항 감소
壓縮	Condensation	콘덴세이션
熱氣	Heat	열기
火抗性減少	Fire property resistance decreased	불 속성 저항 감소
寒氣	Chill	한기
SP 回復速度	SP Recovery Speed	SP 회복 속도
耐力回復	Stamina Recovery	스태미나 회복
減少迴避率	Decreased evasion rate	회피율 감소
提升迴避率	Increased evasion rate	회피율 상승
預計移除。	x	제거 예정.
增加最大 SP和最大 STA	Increased maximum SP and STA	최대 SP와 최대 STA 증가
魔法攻擊無效化	Dispel Magic Attack	마법 공격 무효화
植物化	Make into Plant	식물화
增加主人的黑暗屬性攻擊力	Increased owner's Dark property attack	주인의 어둠 속성 공격력 증가
潑灑聖水	Aspergillum	아스페르길름
比較帶來的黑色哈路卡爾精髓後，製造出能區分野心哈勃克精銳部下的印章。{nl}使用識別印章分辨野心哈勃克的部下後，使用紀錄寶珠。	Immune to Knockback and Knockdown	넉백, 넉다운 면역 상태
強烈腐蝕	Great Corruption	강력한 부패
提升輔助武器的強化度。	Increase Sub-weapon Enhancement	보조무기의 강화도를 올려준다
曝露弱點	Reveal Weak Spot	약점 노출
靈魂消失	Loss of Spirit	영혼소실
腿部僵直	Stiff Legs	다리 경직
騎乘衝鋒技能可以再使用一次	Steed Charge can be used 1 more time	스티드 챠지 스킬 한번 더 사용 가능
技能的傷害值會增加，但是會有額外SP消耗	Skill damage and SP consumption increased	스킬의 대미지가 증가하지만, SP 소비가 추가
暫時讓空中型敵人變為地上型	Temporarily changes flying type enemies to ground type	일시적으로 공중형 적이 지상형으로 변경됨
連結對方的靈魂，炎屬性魔法攻擊	Links to an enemy's spirit and inflicts psychokinesis property damage	상대방의 영혼에 연결하여 염속성 마법 공격
魔法防禦力減少	Decreased Magic Defense	마법 방어력 감소
增加HP恢復能力。	Increases HP recovery	HP 회복능력이 증가합니다.
焚燒狀態。	Incineration state	소각 상태입니다.
消毒狀態。	Fumigate state	소독 상태입니다.
增加3級以下狀態異常抵抗機率	Increased chance of resisting Lv3 status ailments	3레벨 이하 상태이상 저항 확률 증가
那就是紀錄寶珠創造裝置，{nl}只要在裝置寫下注意事項，就會出現紀錄的寶珠。	Put enemies in Iron Maiden	적을 아이언 메이든에 가둠
車輪刑罰	Wheel Torture	수레바퀴 형벌
呼風喚雨	Storm Calling	호풍환우
束縛狀態	Bound	결박 상태
迴避率增加	Increased evasion rate	회피율 증가
腿部彈傷	Leg Shot	레그샷
戰利獎賞(武器)	Reward (Weapon)	리워드(무기)
戰利獎賞(上衣)	Reward (Top)	리워드(상의)
鑲金防具	Cracked Armor	금간 방어구
物理防禦力減少	Decreased Physical Defense	물리방어력 감소
魔法防禦力減少	Decreased Magic Defense	마법방어력 감소
減少物理攻擊力	Decreased Physical Attack	물리공격력 감소
魔法攻擊力減少	Decreased Magic Attack	마법공격력 감소
雖然選擇單字時想必有一定程度的難度，但你表現得很好，所以紀錄寶珠完成了。	Debuff Immunity	디버프에 면역됨
看來得告訴你使用紀錄寶珠時的注意事項才行！{nl}紀錄寶珠烙印在腦海中的時間並不長。	Cursed characters will receive additional damage when hit	저주를 건 캐릭터에게 피격 시 추가 대미지를 입음
挑釁周圍敵人的狀態	Surrounding enemies are provoked	주변 적을 도발한 상태
Seed red	SeeRed	씨레드
可格擋魔法的狀態。	Able to block magic	마법 블록이 가능한 상태입니다.
火屬性傷害	Fire Property Damage	불 속성 피해
暴擊機率增加	Critical Chance Increase	치명타 확률 증가
暴擊傷害增加	Critical Damage Increase	치명타 피해 증가
暗影侵蝕	Shadow Trap	그림자 잠식
迴避增加	Increase Evasion	회피 증가
粒子空間後遺症	Micro Dimension After Effects	마이크로 디멘션 후유증
終極空間後遺症	Ultimate Dimension After Effects	얼티밋 디멘션 후유증
周期性HP減少	Periodical HP Reduction	주기적인 HP 감소
在掛桿周圍的範圍內，馴鷹者技能的傷害會增加	Increased damage of Falconer skills around the roost	횃대 주변 범위 안에서는 응사 스킬의 대미지가 증가
範圍攻擊比率增加3	AoE attack ratio +3	광역공격 비율 3증가
暴擊率增加	Critical Rate Increase	치명타 발생 증가
楔形陣。	Wedge Formation	웨지 포메이션.
密集方陣。	Schiltron	스킬트론.
龜甲陣。	Testudo	테스튜도.
北斗陣	Great Bear camp	북두진
揮刀前進。	Use sword while moving forward	칼질하며 전진합니다.
狂熱	Fever	피버
飛彈攻擊傷害增加	Missile Attack Damage Increase	미사일 공격 데미지 증가
隱藏角色(影片用)	Hide character (for video)	캐릭터감추기(영상용)
解除負面效果	Removes harmful effects	해로운 효과를 해제
猛衝撞擊	Dash Run	대쉬런
增加物理攻擊力和魔法攻擊力	Increase Physical and Magic Attack	물리 공격력과 마법 공격력이 증가
HP 恢復	HP Recovery	HP 회복
毒免疫	Poison Immunity	독 면역
增加物理攻擊力、魔法攻擊力	Increased physical attack and magic attack	물리 공격력, 마법 공격력 증가
增加物理防禦力、魔法防禦力	Increased physical defense and magic defense	물리 방어력, 마법 방어력 증가
隱藏	Hide	하이드
隱藏狀態	Hidden State	하이드 상태
隔絕負面效果機率增加	Increased harmful effect resistance rate	해로운 효과 차단 확률 증가
有害效果的持續時間快速消耗	Fastly Decreases Duration of Harmful Effects	해로운 효과의 지속시간이 빠르게 소진
公會戰鬥觀戰者	GvG Spectator	길드배틀 관전자
公會戰鬥開始前	Pre-GvG	길드배틀 시작전
防禦效果增加	Increased defense effects	방어 효과 증가
魔法攻擊 免疫	Magic Attack Immunity	마법 공격 면역
飛彈攻擊 免疫	Missile Attack Immunity	미사일 공격 면역
固定傷害免疫	Continuous Damage Immunity	고정 피해 면역
地板免疫 BUFF	Floor Immunity Buff	장판면역 버프
侏儒	Homunculus	호문클루스
飛彈攻擊防禦	Missile Attack Defense	미사일 공격 방어
野性	Wild Nature	야성
海盜團	Pirates	해적단
物理防禦力和魔法防禦力增加，攻擊時，依增加的防禦力賦予追加傷害	Physical and magic defense increased and additional damage while attack	물리 방어력과 마법 방어력이 증가하고 공격 시 증가한 방어력만큼 추가 대미지
盾牌集氣啟動中	Shield Charger Activated	실드 차져 가동중
暫時免疫壓縮	Condensation Immunity	콘덴세이션일시면역
反擊準備	Counterattack Ready	반격 준비
確保安全距離，無法使用	Cannot use Safe Distance	안전거리 확보 사용불가
紅絨布施展時間結束後，賦予的Buff	Muleta Buff	물레타 캐스팅 끝나고 걸리는 버프
固定狀態	Fixed	고정 상태
挑撥免疫	Provoke Immunity	도발 면역
挑撥免疫狀態	Immune to provoke	도발 면역상태
安息日傷害增加狀態	Sabath damage increased	사바쓰 대미지 증가 상태
力量增加	Increase Strength	힘 증가
力量增加	Strength increases	힘이 증가
體力增加	Increase HP	체력 증가
體力增加	Increase CON	체력이 증가
智力增加	Increase INT	인트 증가
智力增加	Increase Intelligence	지능이 증가
敏捷增加	Increase DEX	민첩 증가
敏捷增加	Agility is increased	민첩이 증가
守護力量	Power of the guardian	수호의 힘
超級瑪利歐	Super Mario	슈퍼마리오
女神淨化	Goddess' Purification	여신의 정화
攻擊能力喪失	Loss ability to attack	공격능력 상실
SP 恢復	SP Recovery	SP 회복
SP 恢復	SP Recovery	SP가 회복
HP 恢復	HP Recovery	HP가 회복
梅杜莎	Medusa	메두사
卡普利頌的力量	Cafrisun's Power	카프리선의 힘
攻擊時，追加 +12 地屬性固定傷害	+12 additional Earth property damage when attacking	공격시 +12 땅 속성 고정 피해 추가
可探索	Searchable	탐색 가능
肌肉傾注	Muscle Pumping	근육 펌핑
守望者套裝BUFF	Sentinel Set Buff	파수꾼 세트 버프
可以發動守望者意志效果的狀態效果	A status effect can activate Will of Guard	파수꾼의 의지 효과가 발동 될 수 있는 상태 효과
守望者的意志	Will of Guard	파수꾼의 의지
增加惡魔型對象攻擊力 +125	Increases damage against Devil-type targets by +125	악마형 대상 공격력 +125 증가
紅色靈氣	Red Aura	레드 오라
藍色靈氣	Blue Aura	블루 오라
黃色靈氣	Yellow Aura	옐로 오라
耐力回復上升	Increase Stamina recovery	스태미나 회복 상승
每打擊10下就會造成較大的傷害	Give greater damage every 10 attacks	10대를 칠 때마다 큰 피해를 입힙니다
大地套裝BUFF	Earth Set Buff	대지의 세트 버프
可以發動大地憤怒效果的狀態效果	A status effect can activate Rage of Earth	대지의 분노 효과가 발동 될 수 있는 상태 효과
大地的憤怒	Earth Rage	대지의 분노
大屬性固定傷害追加	Additional fixed damage for Earth property attacks	땅 속성 고정 피해 추가
鐵鏟開挖狀態效果	Shovel status effect	삽질 상태 효과
露奎家族的套裝BUFF	Legwyn Family Set Buff	르귄가문의 세트 버프
可以發動露奎家族的遺產效果的狀態效果	Status effect can activate Legacy of Legwyn Family	르귄가문의 유산 효과가 발동 될 수 있는 상태 효과
露奎家族的遺產	Legwyn Family's Legacy	르귄가문의 유산
格擋增加	Block Increase	블럭 증가
格擋增加	Increased block	블럭이 증가
暴擊攻擊力增加	Increased critical attack	치명타 공격력이 증가
魔法增幅增加	Magic Amplification Increase	마법 증폭 증가
增加魔法增幅	Increase Magic Amplification	마법 증폭이 증가
防具貫穿	Armor Penetration	방어구 관통
減少物理防禦力	Decreased Physical Defense	물리 방어력이 감소
銀幣增加	Silver Increase	실버 증가
魔防增加	Increased magic defense 	마법 방어력이 증가
定期受到毒屬性傷害	Periodically receive poison damage	주기적으로 독 속성 피해를 받음
減少移動速度	Movement speed decrease	이동속도가 감소
狂擊衝擊	Lightning Shock	전기 충격
定期受到電氣屬性傷害	Periodically receiving Lightning property damage	주기적으로 전기 속성 피해를 받음
MP減少	MP decreases	MP가 감소
增加獲得的傷害	Damage taken increase	받는 피해 증가
採集植物	Gather plants	식물채집
狂氣解放	Release Lunacy	광기 해방
釘草人強化	Effigy Enhance	에피지 강화
提前釘草人的攻擊紅利	Increases the attack bonus of Effigy	에피지의 공격보너스를 앞당겨준다
阿克貝尼帕套裝BUFF	Agvenipa Set Buff	아그베니파 세트 버프
範圍攻擊比率增加	Wide Range Attack Rate Increases	광역 공격 비율 증가
範圍攻擊比率增加	Wide Range Attack Rate Increases	광역 공격 비율이 증가
晶球召喚負面BUFF	Orb Summon Debuff	오브 소환 디버프
魔防防禦力增加	Increased magic attack	마법 공격력이 증가합니다
增加物理攻擊力	Physical Attack Increased	물리 공격력이 증가합니다
暴擊率增加	Increased critical rate	치명타 발생이 증가
物理攻擊力增加	Increase Physical Attack	물리 공격력 증가
物理攻擊力增加	Increased physical attack	물리 공격력이 증가
火屬性抵抗力增加	Fire Property Resistance Increase	불 속성 저항력 증가
火屬性抵抗力增加	Increased Fire property resistance	불 속성 저항력이 증가
冰屬性抵抗力增加	Ice Property Resistance Increase	얼음 속성 저항력 증가
冰屬性抵抗力增加	Increased Ice property resistance	얼음 속성 저항력이 증가
毒屬性抵抗力增加	Poison Property Resistance Increase	독 속성 저항력 증가
毒屬性抵抗力增加	Increased Poison property resistance	독 속성 저항력이 증가
地屬性抵抗力增加	Earth Property Resistance Increase	땅 속성 저항력 증가
地屬性抵抗力增加	Increased Earth property resistance	땅 속성 저항력이 증가
電氣屬性抵抗力增加	Lightning Property Resistance Increase	전기 속성 저항력 증가
電氣屬性抵抗力增加	Increased Lightning property resistance	전기 속성 저항력이 증가
魔法防禦力增加	Increase Magic Defense	마법 방어력 증가
魔法攻擊力增加	Increase Magic Attack	마법 공격력 증가
魔法攻擊力增加	Increase Magic Attack	마법 공격력이 증가
鑽研	Porapore	포라포레
鑽研活性化	Porapore Activation	포라포레 활성화
光明、黑暗屬性攻擊力增加	Light and Dark Property Attack Increase	빛, 어둠 속성 공격력이 증가
魔法防禦力增加，物理防禦力增加	Increased magic defense and decreased physical defense	마법 방어력이 증가, 물리 방어력은 감소
在保護膜全部消失以前，HP不會減少	HP won't be reduced by attacks until all the protections are used	보호막이 모두 소진되기 전까지 HP가 감소되지 않음
基本攻擊套用5連打	Changed to 5 continuous attacks	기본 공격이 5연타로 적용
耐力減少	Reduced Stamina	스태미나 감소
跛腳	Cripple	절름발이
釘草人紅利1	Effigy bonus1	에피지 보너스1
釘草人的追加害紅利套用於第2次攻擊	Applies additional damage of Effigy on the second attack	에피지의 추가대미지 보너스가 2회째 공격에 적용
聖職者系列套用時，增加神聖屬性攻擊力	Increases Holy Property attack when used by Cleric-type characters	성직자 계열이 착용 시, 신성 속성 공격력 증가
移動速度、物理攻擊力、魔法攻擊力增加	Increased movement speed and physical/magic attack	이동속도, 물리 공격력, 마법 공격력 증가
魔力增幅	Magic Amplification	마력증폭
防禦力、魔法防禦力增加	Defense and Magic Defense Increase	방어력,마법방어력 증가
企鵝持有中	Penguin Owner	펭귄 보유중
攻擊力、魔法攻擊力增加	Attack and Magic Attack Increase	공격력,마법공격력 증가
紅熊貓持有中	Lesser Panda Owner	레서판다 보유중
守護的項鍊-黑暗	Necklace of Protection - Darkness	수호의 목걸이-어둠
守護的手鐲-黑暗	Bracelet of Protection - Darkness	수호의 팔찌-어둠
守護的項鍊-黑暗II	Necklace of Protection - Darkness II	수호의 목걸이-어둠II
守護的手鐲-黑暗II	Bracelet of Protection - Darkness II	수호의 팔찌-어둠II
守護的項鍊-黑暗III	Necklace of Protection - Darkness III	수호의 목걸이-어둠III
守護的手鐲-黑暗III	Bracelet of Protection - Darkness III	수호의 팔찌-어둠III
物理/魔法 防禦力 增加	Increase Physical/Magical Defense	물리/마법 방어력 증가
物理/魔法 防禦力 增加	Physical/Magical Defense will be increased	물리/마법 방어력이 증가
戰鬥鴉雀持有中	Battlebird Owner	전투 뱁새 보유중
古代力量	Power Ancient	고대의 힘
強化攻擊效果	Berserker Effect	버서커 효과
SP 增加狀態	SP Increased State	SP 증가 상태
HP 增加 狀態	HP Increased State	HP 증가 상태
瑪那哈斯的呵護	Manahas' Protection	마나하스의 가호
香檳	Champagne	샴페인
地下城掃蕩券保護膜	Instanced Clear Voucher Barrier	인스턴스 던전 소탕권 보호막
索爾米奇板金組合	Solmiki Plate Set	솔미키 판금 세트
可以令索爾米奇板金組合的特殊效果發動的狀態	Able to activate the special effect of Solmiki plate set	솔미키 판금 세트의 특수효과를 발동시킬 수 있는 상태
索爾米奇板金組合效果	Solmiki Plate Set Effect	솔미키 판금 세트 효과
5秒內恢復一定HP	Partially heals HP for 5 seconds	5초간 일정 HP를 회복
拉克斯頓 持有中	Rocksodon Owner	락스돈 보유중
屬性扺抗力屬性攻擊力變更	Property Resistance to Property Attack	속성 저항력 속성 공격력변경
卡伊特姆歐組合	Kite Moor Set	카이트 무어 세트
休克炸彈發生	Shock Boom Effect	쇼크 봄 발생
普利耶努組合	Frieno Set	프리에노 세트
Stack型防禦力增加	Stack Defense Increase	스택형 방어력 증가
帕希烏泰斯組合	Pasiuteset	파시우테스 세트
Stack型防禦力確認用途	Stack Defense Check	스택형 방어력 체크용도
帕希烏泰斯組合確認	Pasiuteset Check	파시우테스 세트 체크
Stack型魔攻確認用途	Stack Magic Attack Check	스택형 마공 체크 용도
利嫰奇希特組合確認	Lynnki Sit Set Check	리느키 시트 세트 체크
Stack型魔攻增加	Stack Magic Attack Increase	스택형 마공 증가
利嫰奇希特組合	Lynnki Sit Set	리느키 시트 세트
烤魚	Grilled Fish	생선 구이
物理/魔方防禦力減少	Decreased Physical/Magical Defense	물리/마법 방어력 감소
元素效果	Elemental Effect	원소 효과
凱特力斯屬性傷害增加藥水效果	Keitrys Elemental Enhance Potion Effect	케이트리스 속성 대미지 증가 포션 효과
火屬性追加傷害增加	Additional Fire Property Damage Increased	불 속성 추가 대미지 증가
火屬性追加傷害+200	Fire Damage +200	불 속성 추가 대미지 +200
冰屬性追加傷害增加	Increases additional ice damage	얼음 속성 추가 대미지 증가
冰屬性追加傷害+200	Ice damage +200	얼음 속성 추가 대미지 +200
電屬性追加傷害增加	Increases additional lightning damage	전기 속성 추가 대미지 증가
電屬性追加傷害+200	Lightning damage +200	전기 속성 추가 대미지 +200
地屬性追加傷害增加	Increases additional earth damage	땅 속성 추가 대미지 증가
地屬性追加傷害+200	Earth damage +200	땅 속성 추가 대미지 +200
屬性詛咒發生效果	Elemental Curse Effect	속성 저주 발생 효과
HP自然恢復量增加	Increases natural recovery of HP	HP 자연 회복량 증가
格擋減少	Decreases Block 	블럭 감소
衝突	Collision	충돌
衝突後遺症	Collision Aftershock	충돌 후유증
摩西尼奧斯雙手槍	Masinios Two-handed Spear	마시니오스 양손창
瑪西尼歐雙手槍	Masinios Two-handed Spear	마시니오 양손창
瑪西尼歐細劍	Masinios Rapier	마시니오 레이피어
銳利	Sharpness	예리함
5連擊	5 Consecutive Attacks	5연격
集中精神	Mental Concentration	정신 집중
鬥氣	Fighting Spirit	투기
戰鬥狂	War Mode	전투광
增加Rooting機會	Looting Chance Increased	루팅찬스 증가
拓本第一名增益效果	Rubbing 1st Place Buff	탁본 1위 버프
黃金財犬持有中	Golden Dog	금강불개 보유 중
神聖屬性攻擊力增加。	Added Holy attack	신성 속성 공격력이 증가합니다.
變異形怪物增加傷害	Deals additional damage to Mutant-type monsters	변이형 몬스터 추가 대미지
怪物依大小增加傷害	Deals additional damage to monsters depending on their size	몬스터 사이즈별 추가 대미지
怪物依名次增加傷害	Deals additional damage to monsters depending on their rank	몬스터 랭크별 추가 대미지
怪物依種族增加傷害	Deals additional damage to monsters depending on their species	몬스터 종족별 추가 대미지
怪物依屬性增加傷害	Deals additional damage to monsters depending on their properties	몬스터 속성별 추가 대미지
物理防禦力增加	Increased physical defense	물리 방어력 증가
黑暗屬性攻擊力增加	Increased Darkness property damage	어둠 속성 공격력 증가
地屬性攻擊力增加	Increased Earth property damage	땅 속성 공격력 증가
火屬性攻擊力增加	Increased Fire property damage	불 속성 공격력 증가
神聖屬性攻擊力增加	Increased Holy property damage	신성 속성 공격력 증가
冰屬性攻擊力增加	Increased Ice property damage	얼음 속성 공격력 증가
電氣屬性攻擊力增加	Increased Lightning property damage	전기 속성 공격력 증가
毒屬性攻擊力增加	Increased Poison property damage	독 속성 공격력 증가
發動利卡烏斯卡片	Activated Rikaus Card	리카우스 카드 발동
發動地獄三頭犬卡片。	Activated Cerberos Card	켈베로스 카드 발동
發動克洛佩斯卡片	Activated Carapace Card	캐러페이스 카드 발동
發動約納喬雷卡片	Activated Yonazolem Card	요나졸렘 카드 발동
發動克帕奇樹妖卡片	Activated Kepa Chieftain Card	케파치프틴 카드 발동
發動機角卡洛斯卡片	Activated Ellaganos Card	엘라가노스 카드 발동
忍住	Endure	버티기
希德拉的劇毒	Hydra's Venom	히드라의 맹독
被凍住的腳	Frozen Feet	얼어붙은 발
魔法拒絕	Reject Magic	마법 거부
載主人	Give ride to master	주인태우기
副本組隊經驗值獲得量增加	Increased party EXP rate for Instanced Dungeons	인던 파티 경험치 획득량 증가
隊伍等級	Team Level	팀 레벨
火屬性傷害反射	Reflects Fire property damage	불속성 대미지 반사
伺服器追加經驗值	Server EXP Bonus	서버 추가 경험치
經驗值追加活動	EXP Event Bonus	추가 경험치 이벤트
隊伍追加經驗值	Party EXP Bonus	파티 추가 경험치
祈願合格麥芽糖	Lucky Taffy	합격 기원 엿
祈願合格維他命	Vitamin Pill	합격 기원 비타민
祈願合格巧克力	Valentine Chocolate	합격 기원 초콜릿
紅色種子	Red Seed	붉은 씨앗
角色別經驗值活動	Character EXP Event	캐릭별 경험치 이벤트
蘊含祝福的新芽 第1階段	Blessed Sprout Stage 1	축복이 깃든 새싹 1단계
蘊含祝福的新芽 第2階段	Blessed Sprout Stage 2	축복이 깃든 새싹 2단계
蘊含祝福的新芽 第3階段	Blessed Sprout Stage 3	축복이 깃든 새싹 3단계
蘊含祝福的新芽 第4階段	Blessed Sprout Stage 4	축복이 깃든 새싹 4단계
蘊含祝福的新芽 第5階段	Blessed Sprout Stage 5	축복이 깃든 새싹 5단계
幸運餅乾 1階段	Fortune Cookies - 1	포춘 쿠키 1단계
幸運餅乾 2階段	Fortune Cookies - 2	포춘 쿠키 2단계
幸運餅乾 3階段	Fortune Cookies - 3	포춘 쿠키 3단계
幸運餅乾 4階段	Fortune Cookies - 4	포춘 쿠키 4단계
幸運餅乾 5階段	Fortune Cookies - 5	포춘 쿠키 5단계
活動地下城	Event Dungeon	이벤트 던전
公會戰 第1名	Regional Guild Battles - 1st Place	길드배틀 1위
公會戰 第2名	Regional Guild Battles - 2nd Place	길드배틀 2위
公會戰 第3名	Regional Guild Battles - 3rd Place	길드배틀 3위
公會戰勝利者	Guild Battle Victor	길드배틀 승리자
白色情人節	Sweet Boy Buff	화이트데이
參與活動	Apply for Event	이벤트 참여
移動速度+5。	Increases Movement Speed +5	이동 속도 +5 증가합니다.
GM 攻擊力	GM Attack 	GM 공격력
GM 防禦力	GM Defense 	GM 방어력
GM 最大HP	GM Max HP 	GM 최대HP
物理、魔法攻擊力 +100	Physical and magic attack +100	물리, 마법 공격력 +100
物理、魔法防禦力 +100	Physical and magic defense +100	물리, 마법 방어력 +100
隊伍戰鬥聯盟第1名	Team Battle League 1st Place	팀 배틀 리그 1위
隊伍戰鬥聯盟第2名	Team Battle League 2nd Place	팀 배틀 리그 2위
隊伍戰鬥聯盟第3名	Team Battle League 3rd Place	팀 배틀 리그 3위
獵鯨人	Stone Spirit	고래 사냥꾼
隱藏Buff	Hide Buff	하이드 버프
奎波爾的祈禱	Kupole's Prayer	큐폴의 기도
一流冒險家	First-rate Adventurer	초일류 모험가
已達成冒險日誌排名第1名。	Achieved 1st place in the Adventure Journal	모험일지 랭킹 1위를 달성했습니다
有嚴重浪費癖的救援者	Thrifty Savior	낭비벽이 심한 구원자
已達成冒險日誌道具消費排名第1名。	Achieved 1st place for item consumption in the Adventure Journal	모험일지 아이템 소비 랭킹 1위를 달성했습니다
移動速度增加 +3。	Increases Movement Speed +3	이동 속도 +3 증가합니다.
Rooting機會活動	Looting Chance Event	루팅 찬스 이벤트
Rooting機會增加 +2000	Increase Looting Chance +2000	루팅 찬스 +2000 증가
2週年記念樹的祝福	2nd Anniversary Blessing	2주년 기념수의 축복
聖誕節爆竹活動	Christmas Firecracker Event	크리스마스 폭죽 이벤트
米飯餌	Paste Bait	떡밥
黃金漁場	Golden Fishing Spot	황금어장
移動速度增加	Increased movement speed	이동속도가 증가
Nexon網咖	Nexon PC Internet Cafe	넥슨 피시방
經驗之書	EXP Tome	경험의 서
副本無限制入場	Unlimited Instanced Dungeon Entry	인던 무제한입장
不可獲得野外BOSS魔方	Field Boss Cube Unobtainable	필드 보스 큐브 획득 불가
製作寒氣彈、火焰彈、電氣彈基本上需要帶有魔力的粉末。{nl}夏頓蓄水區裡有發著紅光的魔力凝聚器。{nl}{nl}魔力凝聚器發出紅光啟動的時候，可以消滅充滿魔氣的怪物，把他們的肉塊放入裡面。	Cannot gain EXP	경험치 획득 불가
滾動雪球Attach 	Snow Rolling Attached	스노우롤링어태치
獲得的傷害減少	Decreased received damage	받는 대미지 감소
盾牌	Shield	실드
增加精神	Increase SPR	정신 증가
守護者	Guardian	수호자
堅固的皮膚	Thick Skin	견고한 피부
挑戰者	Challenger	챌린저
挑戰結束	End Challenge	도전 종료
超級盔甲	Super Armor	슈퍼아머
瞬間迴避	Instant Evasion	순간회피
透徹的舉報精神	Clear Signal	투철한 신고정신
寵物停車	Park Companion	컴패니언 주차
武器位置互換	Weapon Swap	무기 스왑
* 武器可變更	* Can change weapons	* 무기 변경 가능
使用單手劍	Use One-handed Swords	한손검 사용
* 可以裝備[單手劍]系列武器	* Can equip [One-handed Sword] type weapons	* [한손검] 계열 무기 착용 가능
使用雙手劍	Use Two-handed Swords	양손검 사용
使用單手長槍	Use One-handed Spears	한손창 사용
使用雙手長槍	Use Two-handed Spears	양손창 사용
使用弓箭	Use Bows	활 사용
* 可以裝備[弓 ]系列武器	* Can equip [Bow] type weapons	* [활] 계열 무기 착용 가능
使用十字弓	Use Crossbows	크로스보우 사용
* 可以裝備[十字弓]系列武器	* Can equip [Crossbow] type weapons	* [크로스보우] 계열 무기 착용 가능
使用魔杖	Use Rods	로드 사용
* 可以裝備[魔杖]系列武器	* Can equip [Rod] type weapons	* [로드] 계열 무기 착용 가능
使用權杖	Use Staves	스태프 사용
使用鈍器	Use Maces	메이스 사용
* 可以裝備[鈍器]系列武器	* Can equip [Mace] type weapons	* [메이스] 계열 무기 착용 가능
使用魔棒	Use Wands	완드 사용
* 可以裝備[魔棒]系列武器	* Can equip [Wand] type weapons	* [완드] 계열 무기 착용 가능
使用手槍	Use Pistol	권총 사용
召魔：騎乘寵物	Companion Riding	컴패니언 탑승
* 騎乘寵物時可使用技能	* Can use skill while riding companion	* 컴패니언에 탑승한채로 스킬 사용 가능
使用細劍	Use Rapiers	레이피어 사용
* 可以裝備[細劍]系列武器	* Can equip [Rapier] type weapons	* [레이피어] 계열 무기 착용 가능
最大重量增加	Increased Maximum Weight	최대 무게 증가
* 角色背包可攜帶重量增加20	* Increases character's maximum inventory weight by 20	* 캐릭터 인벤토리의 휴대 가능무게가 20 증가
* 寵物的耐力消耗周期時間每特性等級{nl}    增加10秒	* Increases stamina consumption cycle of companion by 10 seconds per attribute level	* 컴패니언의 스태미나가 소모되는 주기 시간이 특성 레벨당{nl}    10초 증가
寵物緊急治療	Companion First Aid	컴패니언 응급치료
使用步槍	Use Rifles	장총 사용
* 可以裝備[步槍]系列武器	* Can equip [Rifle] type weapons	* [장총] 계열 무기 착용 가능
繳納稅金	Tax Payment	세금 납부
增加最大Buff數	Increased Maximum Buff Count	최대 버프 수 증가
* 角色可獲得的最多Buff數量增加1	* Increases character's maximum amount of buffs by 1	* 캐릭터가 받을 수 있는 최대 버프 개수가 1 증가
* 可以裝備[單手劍]系列武器於右手(輔助裝備)	* [One-handed Sword] type weapons can be equipped on the right hand (sub weapon)	* [한손검] 계열 무기를 오른손(보조 장비)에 착용 가능
使用雙手鈍器	Use Two-handed Blunt Weapon	양손둔기 사용
* [痛擊]的技能攻擊力每特性等級增加28	* Increases damage dealt with [Bash] by 28 per attribute level	* [배쉬]의 스킬 공격력이 특성 레벨당 28 증가
* [痛擊]傷害強化為劍士3階水準	* Enhances damage of [Bash] to Swordsman Circle 3 standards	* [배쉬] 대미지가 소드맨 3서클 수준으로 강화
* [突刺]傷害強化為劍士2階水準	* Enhances damage of [Thrust] to Swordsman Circle 2 standards	* [쓰러스트] 대미지가 소드맨 2서클 수준으로 강화
* [突刺]傷害強化為劍士3階水準	* Enhances damage of [Thrust] to Swordsman Circle 3 standards	* [쓰러스트] 대미지가 소드맨 3서클 수준으로 강화
挑釁	Provoke	프로보크
* [盾心打擊]傷害強化為輕裝步兵2階水準	* Enhances damage of [Umbo Blow] to Peltasta Circle 2 standards	* [엄보블로] 대미지가 펠타스타 2서클 수준으로 강화
* [盾心打擊]傷害強化為輕裝步兵3階水準	* Enhances damage of [Umbo Blow] to Peltasta Circle 3 standards	* [엄보블로] 대미지가 펠타스타 3서클 수준으로 강화
* [盾牌投擲]傷害強化為輕裝步兵3階水準	* Enhances damage of [Shield Lob] to Peltasta Circle 3 standards	* [실드랍] 대미지가 펠타스타 3서클 수준으로 강화
盾防防守	Shield Guard	실드 가드
* 使用技能[高級守護]時每特性等級防禦力增加1	* Increases defense by 1 per attribute level when using [High Guard]	* 스킬 [하이 가드] 중일 때 방어력이 특성 레벨당 1씩 증가
* 技能[敲盾挑釁] 持續時間每特性等級增加 1秒	* Increases duration of [Swash Buckling] by 1 second per attribute level	* 스킬 [스워시 버클링] 지속시간이 특성 레벨당 1초 증가
* 挑撥數值增加為 2倍	* Provocation value increases by 2 times	* 도발 수치가 2배로 증가
* [蓄力一擊]傷害強化為高地戰士2階水準	* Enhances damage of [Cartar Stroke] to Highlander Circle 2 standards	* [카타스트로크] 대미지가 하이랜더 2서클 수준으로 강화
* [蓄力一擊]傷害強化為高地戰士3階水準	* Enhances damage of [Cartar Stroke] to Highlander Circle 3 standards	* [카타스트로크] 대미지가 하이랜더 3서클 수준으로 강화
* [擊頭]傷害強化為高地戰士2階水準	* Enhances damage of [Crown] to Highlander Circle 2 standards	* [크라운] 대미지가 하이랜더 2서클 수준으로 강화
* [擊頭]傷害強化為高地戰士3階水準	* Enhances damage of [Crown] to Highlander Circle 3 standards	* [크라운] 대미지가 하이랜더 3서클 수준으로 강화
* [車輪斬]傷害強化為高地戰士2階水準	* Enhances damage of [Wagon Wheel] to Highlander Circle 2 standards	* [수레바퀴] 대미지가 하이랜더 2서클 수준으로 강화
* [車輪斬]傷害強化為高地戰士3階水準	* Enhances damage of [Wagon Wheel] to Highlander Circle 3 standards	* [수레바퀴] 대미지가 하이랜더 3서클 수준으로 강화
* [十字守護]的物理防禦力增加效果每特性等級增加3	* Enhances physical defense increase effect of [Cross Guard] by 3 per attribute level	* [크로스 가드]의 물리 방어력 증가 효과가 특성 레벨당 3 추가
* [連續斬]傷害強化為高地戰士3階水準	* Enhances damage of [Moulinet] to Highlander Circle 3 standards	* [뮬리넷] 대미지가 하이랜더 3서클 수준으로 강화
* 受到[骷髏搖擺]的敵人無法跳躍	* Enemies cannot jump when attacked with [Skull Swing]	* [스컬 스윙]에 당한 적은 점프 불가
* [刺擊]傷害強化為重裝步兵2階水準	* Enhances damage of [Stabbing] to Hoplite Circle 2 standards	* [스태빙] 대미지가 하플라이트 2서클 수준으로 강화
* [刺擊]傷害強化為重裝步兵3階水準	* Enhances damage of [Stabbing] to Hoplite Circle 3 standards	* [스태빙] 대미지가 하플라이트 3서클 수준으로 강화
* [雙手突刺]傷害強化為重裝步兵2階水準	* Enhances damage of [Synchro Thrusting] to Hoplite Circle 2 standards	* [양손찌르기] 대미지가 하플라이트 2서클 수준으로 강화
* [雙手突刺]傷害強化為重裝步兵3階水準	* Enhances damage of [Synchro Thrusting] to Hoplite Circle 3 standards	* [양손찌르기] 대미지가 하플라이트 3서클 수준으로 강화
* [貫穿擊]傷害強化為重裝步兵2階水準	* Enhances damage of [Pierce] to Hoplite Circle 2 standards	* [피어스] 대미지가 하플라이트 2서클 수준으로 강화
* [貫穿擊]傷害強化為重裝步兵3階水準	* Enhances damage of [Pierce] to Hoplite Circle 3 standards	* [피어스] 대미지가 하플라이트 3서클 수준으로 강화
* [長驅直入]傷害強化為重裝步兵3階水準	* Enhances damage of [Long Stride] to Hoplite Circle 3 standards	* [롱스트라이드] 대미지가 하플라이트 3서클 수준으로 강화
* 技能[長驅直入]的冷卻時間減少10秒	* Decreases??쬸oldown time of [Long Stride] by 10 seconds	* 스킬 [롱스트라이드]의 재사용 대기시간이 10초 감소
* [開腸剖肚]傷害強化為野蠻人2階水準	* Enhances damage of [Embowel] to Barbarian Circle 2 standards	* [임바우얼] 대미지가 바바리안 2서클 수준으로 강화
* [開腸剖肚]傷害強化為野蠻人3階水準	* Enhances damage of [Embowel] to Barbarian Circle 3 standards	* [임바우얼] 대미지가 바바리안 3서클 수준으로 강화
* [狂怒]的物理攻擊力增加效果每特性等級提升	* Enhances physical attack increase effect of [Frenzy] per attribute level	* 특성 레벨당 [프렌지]의 물리 공격력 증가 효과가 상승
* [踐踏]傷害強化為野蠻人3階水準	* Enhances damage of [Stomping Kick] to Barbarian Circle 3 standards	* [스톰핑 킥] 대미지가 바바리안 3서클 수준으로 강화
* 野性Buff的持續時間增加5秒	* Increases Wild Nature buff duration by 5 seconds	* 야성 버프의 지속시간이 5초 증가
* [盾牌衝鋒]傷害強化為圓盾劍士2階水準	* Enhances damage of [Shield Charge] to Rodelero Circle 2 standards	* [실드 챠지] 대미지가 로델레로 2서클 수준으로 강화
* [盾牌衝鋒]傷害強化為圓盾劍士3階水準	* Enhances damage of [Shield Charge] to Rodelero Circle 3 standards	* [실드 챠지] 대미지가 로델레로 3서클 수준으로 강화
* [蒙塔諾]傷害強化為圓盾劍士2階水準	* Enhances damage of [Montano] to Rodelero Circle 2 standards	* [몬타노] 대미지가 로델레로 2서클 수준으로 강화
* [蒙塔諾]傷害強化為圓盾劍士3階水準	* Enhances damage of [Montano] to Rodelero Circle 3 standards	* [몬타노] 대미지가 로델레로 3서클 수준으로 강화
* [盾牌碎擊]傷害強化為圓盾劍士2階水準	* Enhances damage of [Targe Smash] to Rodelero Circle 2 standards	* [타지스매쉬] 대미지가 로델레로 2서클 수준으로 강화
* [盾牌碎擊]傷害強化為圓盾劍士3階水準	* Enhances damage of [Targe Smash] to Rodelero Circle 3 standards	* [타지스매쉬] 대미지가 로델레로 3서클 수준으로 강화
* [盾牌推擊]傷害強化為圓盾劍士2階水準	* Enhances damage of [Shield Push] to Rodelero Circle 2 standards	* [실드푸시] 대미지가 로델레로 2서클 수준으로 강화
* [盾牌推擊]傷害強化為圓盾劍士3階水準	* Enhances damage of [Shield Push] to Rodelero Circle 3 standards	* [실드푸시] 대미지가 로델레로 3서클 수준으로 강화
* [穿刺]傷害強化為鐵甲騎兵2階水準	* Enhances the damage of [Impaler] to Cataphract Circle 2 standards	* [임패일러] 대미지가 캐터프락트 2서클 수준으로 강화
* [穿刺]傷害強化為鐵甲騎兵3階水準	* Enhances the damage of [Impaler] to Cataphract Circle 3 standards	* [임패일러] 대미지가 캐터프락트 3서클 수준으로 강화
* [地動波]傷害強化為鐵甲騎兵2階水準	* Enhances damage of [Earth Wave] to Cataphract Circle 2 standards	* [어스 웨이브] 대미지가 캐터프렉트 2서클 수준으로 강화
* [地動波]傷害強化為鐵甲騎兵3階水準	* Enhances damage of [Earth Wave] to Cataphract Circle 3 standards	* [어스 웨이브] 대미지가 캐터프렉트 3서클 수준으로 강화
* [騎乘衝鋒]傷害強化為鐵甲騎兵2階水準	* Enhances damage of [Steed Charge] to Cataphract Circle 2 standards	* [스티드 챠지] 대미지가 캐터프렉트 2서클 수준으로 강화
* [騎乘衝鋒]傷害強化為鐵甲騎兵3階水準	* Enhances damage of [Steed Charge] to Cataphract Circle 3 standards	* [스티드 챠지] 대미지가 캐터프렉트 3서클 수준으로 강화
* [毀滅刺擊]傷害強化為鐵甲騎兵3階水準	* Enhances damage of [Doom Spike] to Cataphract Circle 3 standards	* [둠 스파이크] 대미지가 캐터프렉트 3서클 수준으로 강화
* 技能[武器修理]的次數每特性等級增加20	* Increases count of [Weapon Maintenance] by 20 per attribute level	* 스킬 [무기 손질]의 횟수가 특성 레벨당 20씩 증가
* 技能[防具修理]的次數每特性等級增加5	* Increases count of [Armor Maintenance] by 5 per attribute level	* 스킬 [방어구 손질]의 횟수가 특성 레벨당 5씩 증가
* 技能[設置餐台]的沙拉效果持續時間{nl}    每特性等級增加1分鐘	* Increases duration of [Refreshment Table] Salad effects by 1 minute per attribute level	* 스킬 [배식대 설치]의 샐러드 효과의 지속시간이{nl}    특성 레벨당 1분씩 증가
* 技能[設置餐台]的三明治效果持續時間{nl}    每特性等級增加1分鐘	* Increases duration of [Refreshment Table] Sandwich effects by 1 minute per attribute level	* 스킬 [배식대 설치]의 샌드위치 효과의 지속시간이{nl}    특성 레벨당 1분씩 증가
* 技能[設置餐台]的濃湯效果持續時間{nl}    每特性等級增加1分鐘	* Increases duration of [Refreshment Table] Soup effects by 1 minute per attribute level	* 스킬 [배식대 설치]의 수프 효과의 지속시간이{nl}    특성 레벨당 1분씩 증가
* 技能[設置餐台]的優格效果持續時間{nl}    每特性等級增加1分鐘	* Increases duration of [Refreshment Table] Yogurt effects by 1 minute per attribute level	* 스킬 [배식대 설치]의 요거트 효과의 지속시간이{nl}    특성 레벨당 1분씩 증가
* 技能[掠奪]的持續時間每特性等級增加1秒	* Increases duration of [Pillaging] by 1 second per attribute level	* 스킬 [약탈]의 지속시간이 특성 레벨당 1초 증가
獲得寶箱道具	Obtain Chest Item	상자 아이템 획득
* 若開啟寶箱每特性等級7秒內{nl}    角色的移動速度增加4	* Increases movement speed by 4 for 7 seconds per attribute level when opening a treasure chest	* 보물 상자를 열면 특성 레벨당 7초 동안 캐릭터의{nl}    이동속도가 4 증가
* 疾走中移動速度大幅增加{nl}STA消耗量減少	* Increases movement speed and decreases STA consumption while dashing	* 대쉬 중 이동속도가 소폭 증가{nl}STA 소모량 감소
輕裝步兵盾牌攻擊 強化	Enhanced Peltasta Shield Attack	펠타스타 방패 공격 강화
圓盾劍士盾牌攻擊 強化	Enhanced Rodelero Shield Attack	로델레로 방패 공격 강화
連打攻擊 強化	Repeated Hits Attack Boost	연타 공격 강화
重裝步盾牌攻擊強化	Enhanced Hoplite Shield Attack	하플라이트 방패 공격 강화
刺牛士	Picador	피카도르
鬥牛士	Banderillero	반데리예로
* [能量箭]傷害值強化為法師2階水準	* Enhances damage of [Energy Bolt] to Wizard Circle 2 standards	* [에너지 볼트] 대미지가 위저드 2서클 수준으로 강화
* [能量箭]傷害值強化為法師3階水準	* Enhances damage of [Energy Bolt] to Wizard Circle 3 standards	* [에너지 볼트] 대미지가 위저드 3서클 수준으로 강화
* [地震]傷害值強化為法師3階水準	* Enhances damage of [Earthquake] to Wizard Circle 3 standards	* [어스퀘이크] 대미지가 위저드 3서클 수준으로 강화
* [催眠]的持續時間每特性等級增加1	* Increases duration of [Sleep] by 1 second per attribute level	* [슬리프]의 지속시간이 특성 레벨당 1초씩 증가
* [火球]傷害強化為烈焰術士2階水準	* Enhances damage of [Fireball] to Pyromancer Circle 2 standards	* [파이어볼] 대미지가 파이로맨서 2서클 수준으로 강화
* [火球]傷害強化為烈焰術士3階水準	* Enhances damage of [Fireball] to Pyromancer Circle 3 standards	* [파이어볼] 대미지가 파이로맨서 3서클 수준으로 강화
* [火牆]傷害強化為烈焰術士2階水準	* Enhances damage of [Fire Wall] to Pyromancer Circle 2 standards	* [파이어월] 대미지가 파이로맨서 2서클 수준으로 강화
* [火牆]傷害強化為烈焰術士3階水準	* Enhances damage of [Fire Wall] to Pyromancer Circle 3 standards	* [파이어월] 대미지가 파이로맨서 3서클 수준으로 강화
* [烈焰]傷害強化為烈焰術士2階水準	* Enhances damage of [Flare] to Pyromancer Circle 2 standards	* [플레어] 대미지가 파이로맨서 2서클 수준으로 강화
* [烈焰]傷害強化為烈焰術士3階水準	* Enhances damage of [Flare] to Pyromancer Circle 3 standards	* [플레어] 대미지가 파이로맨서 3서클 수준으로 강화
* [火焰附魔]的火屬性攻擊力增加效果每特性等級提升	* Increases Fire property attack enhancing effect of [Enchant Fire] per attribute level	* 특성 레벨당 [인챈트 파이어]의 불 속성 공격력 증가 효과가 상승
* [火柱]傷害強化為烈焰術士3階水準	* Enhances damage of [Fire Pillar] to Pyromancer Circle 3 standards	* [파이어필라] 대미지가 파이로맨서 3서클 수준으로 강화
* 被[火牆]擊中的敵人會擊退	* Knocks back enemies hit by [Fire Wall]	* [파이어월]에 피격된 적은 넉백
* [冰箭]傷害強化為寒冰法師2階水準	* Enhanced damage of [Ice Bolt] to Cryomancer Circle 2 standards	* [아이스 볼트] 대미지가 크리오맨서 2서클 수준으로 강화
* [冰箭]傷害強化為寒冰法師3階水準	* Enhances damage of [Ice Bolt] to Cryomancer Circle 3 standards	* [아이스 볼트] 대미지가 크리오맨서 3서클 수준으로 강화
* [冰槍]傷害強化為寒冰法師2階水準	* Enhances damage of [Ice Pike] to Cryomancer Circle 2 standards	* [아이스파이크] 대미지가 크리오맨서 2서클 수준으로 강화
* [冰槍]傷害強化為寒冰法師3階水準	* Enhances damage of [Ice Pike] to Cryomancer Circle 3 standards	* [아이스파이크] 대미지가 크리오맨서 3서클 수준으로 강화
* [冰爆術]傷害強化為寒冰法師2階水準	* Enhances damage of [Ice Blast] to Cryomancer Circle 2 standards	* [아이스 블래스트] 대미지가 크리오맨서 2서클 수준으로 강화
* [冰爆術]傷害強化為寒冰法師3階水準	* Enhances damage of [Ice Blast] to Cryomancer Circle 3 standards	* [아이스 블래스트] 대미지가 크리오맨서 3서클 수준으로 강화
* [冰牆]技能的持續時間增加10秒	* Increases duration of [Ice Wall] by 10 seconds	* [아이스월] 스킬의 지속시간이 10초 증가
* [念動力]傷害強化為念力法師2階水準	* Enhances damage of [Telekinesis] to Psychokino Circle 2 standards	* [텔레키네시스] 대미지가 사이코키노 2서클 수준으로 강화
* [念動力]傷害強化為念力法師3階水準	* Enhances damage of [Telekinesis] to Psychokino Circle 3 standards	* [텔레키네시스] 대미지가 사이코키노 3서클 수준으로 강화
* [靈能壓力]傷害強化為念力法師2階水準	* Enhances damage of [Psychic Pressure] to Psychokino Circle 2 standards	* [사이킥 프레셔] 대미지가 사이코키노 2서클 수준으로 강화
* [靈能壓力]傷害強化為念力法師3階水準	* Enhances damage of [Psychic Pressure] to Psychokino Circle 3 standards	* [사이킥 프레셔] 대미지가 사이코키노 3서클 수준으로 강화
* [磁力]傷害強化為念力法師3階水準	* Enhances damage of [Magnetic Force] to Psychokino Circle 3 standards	* [마그네틱 포스] 대미지가 사이코키노 3서클 수준으로 강화
* 技能[重力磁場]使用中每特性等級迴避增加50	* Increases evasion by 50 per attribute level while using [Gravity Pole]	* 스킬 [그라비티 폴] 사용 중, 회피가 특성 레벨당 50 증가
* 技能[位置互換]的套用對象是我軍不是敵軍	* Applies [Swap] to allies and not enemies	* 스킬 [스왑]이 적군이 아닌 아군을 대상으로 적용
* 使用[能力調換]時短力和體力不會互換{nl}    而是各自套用智力和體力的平均值	* Applies average of INT and CON to both stats when using [Transpose]	* [트랜스포스] 사용 시 지능과 체력이 서로 바뀌지 않고{nl}    지능과 체력의 평균값이 각각 적용
* [紅焰]傷害強化為元素使2階水準	* Enhances damage of [Prominence] to Elementalist Circle 2 standards	* [홍염] 대미지가 엘리멘탈리스트 2서클 수준으로 강화
* [紅焰]傷害強化為元素使3階水準	* Enhances damage of [Prominence] to Elementalist Circle 3 standards	* [홍염] 대미지가 엘리멘탈리스트 3서클 수준으로 강화
* [冰雹]傷害強化為元素使2階水準	* Enhances damage of [Hail] to Elementalist Circle 2 standards	* [헤일] 대미지가 엘리멘탈리스트 2서클 수준으로 강화
* [冰雹]傷害強化為元素使3階水準	* Enhances damage of [Hail] to Elementalist Circle 3 standards	* [헤일] 대미지가 엘리멘탈리스트 3서클 수준으로 강화
* [電擊]傷害強化為元素使2階水準	* Enhances damage of [Electrocute] to Elementalist Circle 2 standards	* [일렉트로큐트] 대미지가 엘리멘탈리스트 2서클 수준으로 강화
* [電擊]傷害強化為元素使3階水準	* Enhances damage of [Electrocute] to Elementalist Circle 3 standards	* [일렉트로큐트] 대미지가 엘리멘탈리스트 3서클 수준으로 강화
* [隕石]傷害強化為元素使3階水準	* Enhanced damage of [Meteor] to Elementalist Circle 3 standards	* [메테오] 대미지가 엘리멘탈리스트 3서클 수준으로 강화
* [紅焰]出現的次數每特性等級增加 1次	* The number of [Prominence] summoned increases by 1 per attribute level	* [홍염]이 나오는 횟수가 특성 레벨당 1회 추가
* [礫石暴風]範圍內的敵人之移動速度每特性等級各減少 2	* Movement speed of enemies in range of [Storm Dust] decreases by 2 per attribute level	* [스톰 더스트] 범위 안의 적의 이동속도가 특성 레벨당 2씩 감소
* 讓在[烈焰大地] 上的敵人於使用[隕石]時，受到 5連擊	* Enemies on [Flame Ground] take 5 consecutive hits by [Meteor]	* [플레임 그라운드] 위에 있는 적에게 [메테오] 사용 시 5연타 적용
* 角色的SP恢復力每特性等級增加1	* increases character's SP recovery by 1 per attribute level	* 캐릭터의 SP 회복력이 특성 레벨당 1씩 증가
* 技能[攻擊領域]的冷卻時間減少2秒	* Decreases cooldown time of [Attack Ground] by 2 seconds	* 스킬 [어택 그라운드]의 재사용 대기시간이 2초 감소
* 技能[待命]的冷卻時間減少2秒	* Decreases cooldown time of [Hold] by 2 seconds	* 스킬 [홀드]의 재사용 대기시간이 2초 감소
* 技能[時間暫停]的SP消耗減少40	* Decreases SP consumption of [Stop] by 40	* 스킬 [스톱]의 소모 SP가 40 감소
* 被死靈法師技能命中後陷入[腐敗]Debuff時{nl}    敵人所穿戴的裝備會暫時腐敗變得無效	* Corruption caused by Necromancer skills will temporarily nullify enemy gear	* 네크로맨서 스킬로 인해 [부패] 디버프에 걸렸을 떄{nl}    적이 장착한 장비 아이템을 일시적으로 부패시켜 무력하게 만듬
* 死靈之書的最大屍體持有量每特性等級增加100	* Increases Necronomicon's maximum corpse capacity by 100 per attribute level	* 네크로노미콘의 최대 사체 보유량이 특성 레벨당 100 증가
* 技能[挖掘]的冷卻時間減少10秒	* Decreases cooldown time of [Dig] by 10 seconds	* 스킬 [디그]의 재사용 대기시간이 10초 감소
* 當附近沒有掉落的道具時{nl}    使用身上200銀幣對前方造成爆作傷害	* Creates explosion using 200 silver when there are no dropped items nearby	* 주변에 드랍된 아이템이 없을 때, 소지한 200 실버를{nl}    사용해 전방에 폭발 대미지
* 進行[熔合]技能時可選擇主武器或是材料武器的外型	* Allows for [Briquetting] to change the appearance of a main weapon or material weapon	* [브리케팅]시 주 무기 또는 재료 무기의 외형 선택 가능
* 在[道具喚醒]地下城登場的怪物個體數減少 	* Reduces number of monsters in [Item Awakening] dungeon	* [아이템 어웨이크닝] 던전에서 등장하는 몬스터의 개체수 감소
黑暗恐懼	Darkness Fear	어둠의 공포
* 以[血浴]吸收的SP量每特性等級增加1	* Increases SP absorbed by 1 per attribute level	* [블러드배쓰]로 흡수하는 SP량이 특성 레벨당 1 증가
製作附魔彈	Craft Enchant Round	인챈트탄 제작
* 可使用魔法粉末製作附魔彈{nl}* 在休息模式下也可製作附魔彈	* Allows you to craft Enchant Rounds using Magic Powder on Rest Mode	* 마법 가루를 이용하여 인챈트탄 제작 가능{nl}* 인챈트탄 제작은 휴식모드에서 가능
* 傳點的欄位數量每特性等級增加1	* Increases portal slot number by 1 per attribute level	* 포탈의 슬롯수가 특성 레벨당 1 증가
* [多重射擊]傷害強化為弓箭手2階水準	* Enhances damage of [Multi Shot] to Archer Circle 2 standards	* [멀티샷] 대미지가 아처 2서클 수준으로 강화
* [多重射擊]傷害強化為弓箭手3階水準	* Enhances damage of [Multi Shot] to Archer Circle 3 standards	* [멀티샷] 대미지가 아처 3서클 수준으로 강화
* [滿弦]傷害強化為弓箭手2階水準	* Enhances damage of [Full Draw] to Archer Circle 2 standards	* [풀드로우] 대미지가 아처 2서클 수준으로 강화
* [滿弦]傷害強化為弓箭手3階水準	* Enhances damage of [Full Draw] to Archer Circle 3 standards	* [풀드로우] 대미지가 아처 3서클 수준으로 강화
* [斜射]傷害強化為弓箭手3階水準	* Enhances damage of [Oblique Shot] to Archer Circle 3 standards	* [오블리크 샷] 대미지가 아처 3서클 수준으로 강화
* [強力射擊]傷害強化為弓箭手3階水準	* Enhances damage of [Heavy Shot] is to Archer Circle 3 standards	* [헤비샷] 대미지가 아처 3서클 수준으로 강화
* [跪射]狀態下可使用部份技能	* Allows you to use some skills in the [Kneeling Shot] position	* [닐링샷] 상태에서 일부 스킬 사용 가능
* [扇射]傷害強化為遊俠2階水準	* Enhanced damage of [Barrage] to Ranger Circle 2 standards	* [배라지] 대미지가 레인저 2서클 수준으로 강화
* [扇射]傷害強化為遊俠3階水準	* Enhanced damage of [Barrage] to Ranger Circle 3 standards	* [배라지] 대미지가 레인저 3서클 수준으로 강화
* [貫通箭]傷害強化為遊俠2階水準	* Enhances damage of [High Anchoring] to Ranger Circle 2 standards	* [하이앵커링] 대미지가 레인저 2서클 수준으로 강화
* [貫通箭]傷害強化為遊俠3階水準	* Enhances damage of [High Anchoring] to Ranger Circle 3 standards	* [하이앵커링] 대미지가 레인저 3서클 수준으로 강화
* [穩定瞄準]的追加傷害每特性等級增加2	* Increases additional damage effect of [Steady Aim] by 2 per attribute level	* 특성 레벨당 [스테디에임]의 추가대미지가 2 증가
* [暴擊射擊]傷害強化為遊俠2階水準	* Enhances damage of [Critical Shot] to Ranger Circle 2 standards	* [크리티컬 샷] 대미지가 레인저 2서클 수준으로 강화
* [暴擊射擊]傷害強化為遊俠3階水準	* Enhances damage of [Critical Shot] to Ranger Circle 3 standards	* [크리티컬 샷] 대미지가 레인저 3서클 수준으로 강화
* [定時炸彈箭]傷害強化為遊俠3階水準	* Enhances damage of [Time Spring Arrow] to Ranger Circle 3 standards	* [타임봄 애로우] 대미지가 레인저 3서클 수준으로 강화
* [丟擲鐵蒺藜]傷害強化為弩箭手2階水準	* Enhances damage of [Scatter Caltrops] to Quarrel Shooter Circle 2 standards	* [캘트롭 뿌리기] 대미지가 쿼렐슈터 2서클 수준으로 강화
* [丟擲鐵蒺藜]傷害強化為弩箭手3階水準	* Enhances damage of [Scatter Caltrops] to Quarrel Shooter Circle 3 standards	* [캘트롭 뿌리기] 대미지가 쿼렐슈터 3서클 수준으로 강화
* [石彈射擊]傷害強化為弩箭手2階水準	* Enhances damage of [Stone Shot] to Quarrel Shooter Circle 2 standards	* [스톤샷] 대미지가 쿼렐슈터 2서클 수준으로 강화
* [石彈射擊]傷害強化為弩箭手3階水準	* Enhances damage of [Stone Shot] to Quarrel Shooter Circle 3 standards	* [스톤샷] 대미지가 쿼렐슈터 3서클 수준으로 강화
* [連續射擊]傷害強化為弩箭手3階水準	* Enhances damage of [Rapid Fire] to Quarrel Shooter Circle 3 standards	* [래피드파이어] 대미지가 쿼렐슈터 3서클 수준으로 강화
* [拆除]傷害強化為弩箭手3階水準	* Enhances damage of [Teardown] to Quarrel Shooter Circle 3 standards	* [철거] 대미지가 쿼렐슈터 3서클 수준으로 강화
* [奔跑射擊]傷害每特性等級提升。	* Increases damage of [Running Shot] per attribute level	* 특성 레벨당 [런닝샷] 대미지가 상승합니다.
* [掃蕩陷阱]傷害強化為工兵2階水準	* Enhances damage of [Broom Trap] to Sapper Circle 2 standards	* [브룸트랩] 대미지가 새퍼 2서클 수준으로 강화
* [掃蕩陷阱]傷害強化為工兵3階水準	* Enhances damage of [Broom Trap] to Sapper Circle 3 standards	* [브룸트랩] 대미지가 새퍼 3서클 수준으로 강화
* [闊劍地雷]傷害強化為工兵2階水準	* Enhanced damage of [Claymore] to Sapper Circle 2 standards	* [크레모어] 대미지가 새퍼 2서클 수준으로 강화
* [闊劍地雷]傷害強化為工兵3階水準	* Enhanced damage of [Claymore] to Sapper Circle 3 standards	* [크레모어] 대미지가 새퍼 3서클 수준으로 강화
* [竹尖釘]傷害強化為工兵2階水準	* Enhances damage of [Punji Stake] to Sapper Circle 2 standards	* [푼지스테이크] 대미지가 새퍼 2서클 수준으로 강화
* [竹尖釘]傷害強化為工兵3階水準	* Enhances damage of [Punji Stake] to Sapper Circle 3 standards	* [푼지스테이크] 대미지가 새퍼 3서클 수준으로 강화
* [引爆陷阱]傷害強化為工兵2階水準	* Enhances damage of [Detonate Traps] to Sapper Circle 2 standards	* [데토네이트 트랩] 대미지가 새퍼 2서클 수준으로 강화
* [引爆陷阱]傷害強化為工兵3階水準	* Enhances damage of [Detonate Traps] to Sapper Circle 3 standards	* [데토네이트 트랩] 대미지가 새퍼 3서클 수준으로 강화
* [人質炸彈]傷害強化為工兵3階水準	* Enhances damage of [Collar Bomb] to Sapper Circle 3 standards	* [인질 폭탄] 대미지가 새퍼 3서클 수준으로 강화
* [吹箭]傷害強化為巫蠱師2階水準	* Enhances damage of [Needle Blow] to Wugushi Circle 2 standards	* [취시] 대미지가 무고사 2서클 수준으로 강화
* [吹箭]傷害強化為巫蠱師3階水準	* Enhances damage of [Needle Blow] to Wugushi Circle 3 standards	* [취시] 대미지가 무고사 3서클 수준으로 강화
* [蜈蚣蠱]傷害強化為巫蠱師2階水準	* Enhances damage of [Wugong Gu] to Wugushi Circle 2 standards	* [오공고] 대미지가 무고사 2서클 수준으로 강화
* [蜈蚣蠱]傷害強化為巫蠱師3階水準	* Enhances damage of [Wugong Gu] to Wugushi Circle 3 standards	* [오공고] 대미지가 무고사 3서클 수준으로 강화
* [毒罐]傷害強化為巫蠱師3階水準	* Enhances damage of [Throw Gu Pot] to Wugushi Circle 3 standards	* [독항아리] 대미지가 무고사 3서클 수준으로 강화
* 敵人所受到的[吹箭]毒傷害每特性等級增加2	* Increases poison damage dealt with [Needle Blow] by 2 per attribute level	* 적에게 입히는 [취시]의 독 대미지가 특성 레벨당 2 증가
* 敵人所受到的[蜈蚣蠱]毒傷害每特性等級增加2	* Increases poison damage dealt with [Wugong Gu] by 2 per attribute level	* 적에게 입히는 [오공고]의 독 대미지가 특성 레벨당 2 증가
* [響箭]傷害強化為斥候2階水準	* Enhances damage of [Flu Flu] to Scout Circle 2 standards	* [플루플루] 대미지가 스카우트 2서클 수준으로 강화
* [響箭]傷害強化為斥候3階水準	* Enhances damage of [Flu Flu] to Scout Circle 3 standards	* [플루플루] 대미지가 스카우트 3서클 수준으로 강화
* [燃燒箭]傷害強化為斥候2階水準	* Enhances damage of [Flare Shot] to Scout Circle 2 standards	* [플레어 샷] 대미지가 스카우트 2서클 수준으로 강화
* [燃燒箭]傷害強化為斥候3階水準	* Enhances damage of [Flare Shot] to Scout Circle 3 standards	* [플레어 샷] 대미지가 스카우트 3서클 수준으로 강화
* [仇殺]傷害強化為流氓3階水準	* Enhances damage of [Vendetta] to Rogue Circle 3 standards	* [벤데타] 대미지가 로그 3서클 수준으로 강화
* [闊箭]傷害強化為造箭者2階水準	* Enhances damage of [Broadhead] to Fletcher Circle 2 standards	* [브로드헤드] 대미지가 플레쳐 2서클 수준으로 강화
* [錐箭]傷害強化為造箭者2階水準	* Enhances damage of [Bodkin Point] to Fletcher Circle 2 standards	* [보드킨 포인트] 대미지가 플레쳐 2서클 수준으로 강화
* [荊棘箭]傷害強化為造箭者2階水準	* Enhances damage of [Barbed Arrow] to Fletcher Circle 2 standards	* [바브드애로] 대미지가 플레쳐 2서클 수준으로 강화
* [交叉火力]傷害強化為造箭者2階水準	* Enhances damage of [Crossfire] to Fletcher Circle 2 standards	* [크로스파이어] 대미지가 플레쳐 2서클 수준으로 강화
* 被技能[闊箭]攻擊的敵人狀能[出血]的持續時間每特性等級增加2秒	* Increases duration of [Bleeding] by 2 seconds per attribute level when an enemy is hit by [Broadhead]	* 스킬 [브로드헤드]로 피격된 적 상태 [출혈]의 지속시간이 특성 레벨당 2초 증가
製作弓箭	Arrow Crafting	화살제작
* [主動攻擊]時不讓隼鷹使用懸停。	* The hawk will not use [Hovering] while [Pre-Emptive Strike] is being used	* [선제 공격] 시 매가 호버링을 사용하지 않게 됩니다.
* [主動攻擊]時不讓隼鷹使用音速突擊	* The hawk will not use [Sonic Strike] while [Pre-Emptive Strike] is being used	* [선제 공격] 시 매가 음속타를 사용하지 않게 됩니다.
鷹狩	Hawk Hunt	매사냥
* 馴鷹者使用技能後，隼鷹不會離去，保持滞留。	* Hawk stays after using Falconer skills	* 응사 스킬 사용 후, 매가 떠나가지 않고 머무름
掌握手槍：追加傷害	Revolver Mastery	권총 마스터리: 추가 피해
* 使用技能[逃脫射擊]時後退距離會小幅減少	* Reduces [Caracole]'s recoil	* 스킬 [카라콜] 사용시 밀려나는 거리가 소폭 감소
* 技能[裝填就緒]的基本冷卻時間每特性等級{nl} 減少1秒	* Reduces cooldown of [Prime and Load] by 1 sec per attribute level	* 스킬 [프라임 앤드 로드]의 기본 재사용 대기시간이 특성 레벨당{nl}    1초 감소
* 在寵物騎乘狀態下瞬間疾走移動速度增加	* Enables use of instant dash when riding on a companion to increase movement speed	* 컴패니언 탑승 상태에서 순간적으로 대쉬하여 이동속도가 증가
* 雙手弓和單手弓基本攻擊的射程距離每特性等級增加1	* Increases basic attack range for bows and crossbows by 1 per attribute level	* 양손활과 한손활 기본 공격의 사거리가 특성 레벨당 1 증가
* [淨化]傷害強化為牧師2階水準	* Enhances damage of [Cure] to Cleric Circle 2 standards	* [큐어] 대미지가 클레릭 2서클 수준으로 강화
* [淨化]傷害強化為牧師3階水準	* Enhances damage of [Cure] to Cleric Circle 3 standards	* [큐어] 대미지가 클레릭 3서클 수준으로 강화
* [治癒] 傷害和治癒量強化為牧師2階水準	* Enhances damage and healing amount of [Heal] to Cleric Circle 2 standards	* [힐] 대미지와 치유량이 클레릭 2서클 수준으로 강화
* [治癒] 傷害和治癒量強化為牧師3階水準	* Enhances damage and healing amount of [Heal] to Cleric Circle 3 standards	* [힐] 대미지와 치유량이 클레릭 3서클 수준으로 강화
* 因為[守護聖人]獲得傷害的對象變成自己	* [Guardian Saint] selects you as the recipient of damage	* [수호성인]으로 피해를 대신 받는 대상을 자신으로 변경
* [落雷]傷害強化為聖火祭司2階水準	* Enhances damage of [Zaibas] to Krivis Circle 2 standards	* [자이바스] 대미지가 크리비 2서클 수준으로 강화
* [落雷]傷害強化為聖火祭司3階水準	* Enhances damage of [Zaibas] to Krivis Circle 3 standards	* [자이바스] 대미지가 크리비 3서클 수준으로 강화
* 角色的火屬性扺抗每特性等級增加5{nl}    黑暗屬性扺抗每特性等級減少3	* Increases the character's Fire property resistance and decreases dark property resistance by 5 and 3 per attribute level respectively	* 캐릭터의 불 속성 저항이 특성 레벨당 5 증가하고{nl}    어둠 속성 저항이 특성 레벨당 3 감소
* [潑灑聖水]傷害強化為聖水祭司2階水準	* Enhances damage of [Aspersion] to Priest Circle 2 standards	* [아스퍼션] 대미지가 프리스트 2서클 수준으로 강화
* [潑灑聖水]傷害強化為聖水祭司3階水準	* Enhances damage of [Aspersion] to Priest Circle 3 standards	* [아스퍼션] 대미지가 프리스트 3서클 수준으로 강화
* [聖禮]的神聖屬性攻擊力增加效果每特性等級提升	* Increases Holy property attack of [Sacrament] per attribute level	* 특성 레벨당 [사크라멘트]의 신성 속성 공격력 증가 효과 상승
* [釘草人]傷害強化為邪靈祭司2階水準	* Enhanced damage of [Effigy] to Bokor Circle 2 standards	* [에피지] 대미지가 보코르 2서클 수준으로 강화
* [釘草人]傷害強化為邪靈祭司3階水準	* Enhanced damage of [Effigy] to Bokor Circle 3 standards	* [에피지] 대미지가 보코르 3서클 수준으로 강화
* [符咒]的累積傷害每特性等級減少2	* Decreases accumulated damage from [Mackangdal] by 2 per attribute level	* [마캉달]의 누적된 대미지가 특성 레벨당 2 감소
* [殭屍圍繞]傷害強化為邪靈祭司3階水準	* Enhances damage of [Bwa Kayiman] to Bokor Circle 3 standards	* [브와카이망] 대미지가 보코르 3서클 수준으로 강화
* [雕刻攻擊]傷害強化為雕刻師2階水準	* Enhanced damage of [Carve] to Dievdirbys Circle 2 standards	* [목각 공격] 대미지가 딥디르비 2서클 수준으로 강화
* [雕刻攻擊]傷害強化為雕刻師3階水準	* Enhanced damage of [Carve] to Dievdirbys Circle 3 standards	* [목각 공격] 대미지가 딥디르비 3서클 수준으로 강화
* [貓頭鷹雕像]傷害強化為雕刻師3階水準	* Enhances damage of [Carve Owl] to Dievdirbys Circle 3 standards	* [부엉이 조각상] 대미지가 딥디르비 3서클 수준으로 강화
* 技能[瓦卡麗涅女神像]的冷卻時間減少10秒	* Decreases cooldown time of [Statue of Goddess Vakarine] by 10 seconds	* 스킬 [바카리네 여신상]의 재사용 대기시간이 10초 감소
* 技能[奧施莉奈女神像]的冷卻時間減少10秒	* Decreases the cooldown of [Statue of Goddess Ausrine] by 10 seconds	* 스킬 [아우슈리네 여신상]의 재사용 대기시간이 10초 감소
* [靈魂爆炸]傷害強化為聖者2階水準	* Enhances damage of [Astral Body Explosion] to Sadhu Circle 2 standards	* [유체 폭발] 대미지가 사두 2서클 수준으로 강화
* [靈魂爆炸]傷害強化為聖者3階水準	* Enhances damage of [Astral Body Explosion] to Sadhu Circle 3 standards	* [유체 폭발] 대미지가 사두 3서클 수준으로 강화
* [支配]傷害強化為聖者3階水準	* Enhances damage of [Possession] to Sadhu Circle 3 standards	* [포제션] 대미지가 사두 3서클 수준으로 강화
* 技能[靈魂出竅]活化期間本體的迴避{nl}    每特性等級增加10	* Increases the body's evasion by 10 per attribute level when [Out of Body] is active	* 스킬 [유체이탈]이 활성화 되어 있는 동안 본체의 회피가{nl}    특성 레벨당 10 증가
* 使用[能量傳送]時同時傳送力量能力值	* Allows [Transmit Prana] to also transmit STR	* [프라나 전송] 사용 시 힘 능력치도 전송
* 使用[能量傳送]時同時傳送體力能力值	* Allows [Transmit Prana] to also transmit CON	* [프라나 전송] 사용 시 체력 능력치도 전송
* 使用[能量傳送]時同時傳送精神能力值	* Allows [Transmit Prana] to also transmit SPR	* [프라나 전송] 사용 시 정신 능력치도 전송
* 使用[能量傳送]時同時傳送敏捷能力值	* Allows [Transmit Prana] to also transmit DEX	* [프라나 전송] 사용 시 민첩 능력치도 전송
* [恢復]的HP恢復力增加效果每特性等級增加1%	* Increases HP recovery effect of [Restoration] by 1 per attribute level	* 특성 레벨당 [리스토레이션]의 HP 회복력 증가 효과가 1% 추가 상승
* [重擊]傷害強化為聖殿十字軍2階水準	* Enhances damage of [Smite] to Paladin Circle 2 standards	* [스마이트] 대미지가 팔라딘 2서클 수준으로 강화
* [重擊]傷害強化為聖殿十字軍3階水準	* Enhances damage of [Smite] to Paladin Circle 3 standards	* [스마이트] 대미지가 팔라딘 3서클 수준으로 강화
* [皈依]的怪物附近若有其他怪物接近皈依的怪物會自爆	* [Conversion] makes the target explode when coming in contact with other monsters	* [개종]된 몬스터 근처에 다른 몬스터가 근접하면 개종된 몬스터가 자폭
* [雙鎖功]傷害強化為武僧2階水準	* Enhances damage of [Double Punch] to Monk Circle 2 standards	* [쌍쇄공] 대미지가 몽크 2서클 수준으로 강화
* [鐵砂掌]傷害強化為武僧2階水準	* Enhances damage of [Palm Strike] to Monk Circle 2 standards	* [철사장] 대미지가 몽크 2서클 수준으로 강화
* [觀音掌]傷害強化為武僧2階水準	* Enhances damage of [Hand Knife] to Monk Circle 2 standards	* [관음장] 대미지가 몽크 2서클 수준으로 강화
* 以[形態變換]或[變形術]變身的怪物若是小型{nl}    迴避每特性等級增加50	* Increases evasion of small-type monster transformed by [Shape Shifting] or [Transform] by 50 per attribute level	* [쉐입시프팅] 혹은 [트랜스폼]으로 변신한 몬스터가 소형이면{nl}    회피가 특성 레벨당 50 증가
* 以[形態變換]或[變形術]變身的怪物若是動物型{nl}    暴擊率每特性等級增加40	* Increases critical rate of the animal-type monsters transformed via [Shape Shifting] or [Transform] by 40 per attribute level	* [쉐입시프팅] 혹은 [트랜스폼]으로 변신한 몬스터가 동물형이면{nl}    치명타 발생이 특성 레벨당 40 증가
* 以[形態變換]或[變形術]變身後可更快速使用怪物的技能	* Increases skill casting time while [Shapeshifting] or [Transform] is active	* [쉐입시프팅] 혹은 [트랜스폼]으로 변신후 몬스터의 스킬을 좀 더 빠르게 사용 가능
* 以[形態變換]或[變形術]變身後也能繼續維持PC移動速度	* Maintains the character's movement speed after transforming with [Shapeshifting] or [Transform]	* [쉐입시프팅] 혹은 [트랜스폼]으로 변신 후에도 PC 이동속도에 가깝게 유지
* 技能[重置]的冷卻時間減少30秒	* Decreases cooldown time of [Resetting] by 30 seconds	* 스킬 [리셋팅]의 재사용 대기시간이 30초 감소
* 配戴[鳥喙面具]時毒屬性扺抗力每特性等級增加5	* Increases Poison property resistance by 5 per attribute level whilst wearing the [Bird Beak Mask]	* [새 부리 가면]을 착용 중 독 속성 저항력이 특성 레벨당 5 증가
* [梅爾卡巴戰輪]的輪子移動速度減少	* Reduces the movement speed of [Merkabah]	* [메르카바]의 바퀴 이동속도 감소
* 很快顯示技能[數秘術]和[拼詞計算術]的數字結果值	* The numbers from [Gematria] and [Notarikon] are quickly calculated	* 스킬 [게마트리아]과 [노타리콘]의 숫자 결과값이 빠르게 표시
* 技能[數秘術]和[拼詞計算術]每特性等級對1名{nl}    額外套用	* [Gematria] and [Notarikon] affect 1 additional target per attribute level	* 스킬 [게마트리아]과 [노타리콘]이 특성 레벨당 1명에게{nl}    추가 적용
卡巴拉之杖	Staff of Kabbalah	카발라의 지팡이
卡巴拉的服裝	Kabbalah Garments	카발라의 의복
* 透過技能[取人藏物法]增加的物理攻擊力和魔法攻擊力的最小數值每特性等級增加1	* Increases minimum amount of physical and magic attack from [Hidden Potential] by 1 per attribute level	* 스킬 [취인장물법]으로 증가하는 물리 공격력과 마법 공격력의 최소 수치가 특성 레벨당 1 증가
製作御守	Craft Omamori	오마모리 제작
* 對我軍召喚物施展[拍手]而恢復的HP量每特性等級增加1	* Increases ally installments' HP recovered by [Clapping] by 1 per attribute level	* 아군 소환물에게 [박수]로 회복시켜주는 HP량이 특성 레벨당 1 증가
HP藥水推助器	HP Potion Booster	HP포션 부스터
SP藥水推助器	SP Potion Booster	SP포션 부스터
掌握刀劍	Sword Mastery	소드 마스터리
掌握權杖	Staff Mastery	스태프 마스터리
掌握弓箭	Bow Mastery	보우 마스터리
掌握鈍器	Mace Mastery	메이스 마스터리
破裂一擊	Rupture Blow	파열의 일격
沉思	Meditation	메디테이션
燃燒	Ignite	이그나이트
自活力	Self Vitality	자활력
襲擊	Strike	스트라이크
亂打	Nanta	난타
雕刻家	Sculptor	조각가
製作抵抗魔法	Craft Anti-Magic	안티매직 제작
[寬恕者] 製作抵抗魔法	[Pardoner] Craft Anti-Magic	[파드너] 안티매직 제작
需要鍊金術士1階	Alchemist 1st Circle required	알케미스트 1서클 필요
需要製作藥劑Lv1	Lv1 Tincturing required	팅크쳐링 1레벨 필요
需要鑑定師1階	Requires Appraiser Circle 1	감정사 1서클 필요
需要弓箭手1階	Archer 1st Circle required	아처 1서클 필요
需要跪射Lv3	Lv3 Kneeling Shot required	닐링샷 3레벨 필요
需要野蠻人1階	Barbarian 1st Circle required	바바리안 1서클 필요
需要戰鬥怒吼Lv3	Lv3 Warcry required	워크라이 3레벨 필요
需要邪靈祭司1階	Bokor 1st Circle required	보코르 1서클 필요
需要製造殭屍Lv2	Lv2 Zombify required	좀비 만들기 2레벨 필요
需要製造殭屍Lv3	Lv3 Zombify required	좀비 만들기 3레벨 필요
需要符咒Lv3	Lv3 Mackangdal required	마캉달 3레벨 필요
需要槍彈者1階	Bulletmarker 1st Circle Required	불릿 마커 1서클 필요
需要槍彈者2階	Bulletmarker 2nd Circle Required	불릿 마커 2서클 필요
需要重砲手1階	Cannoneer 1st Circle required	캐노니어 1서클 필요
需要重砲手3階	Canoneer 3rd Circle Required	캐노니어 3서클 필요
需要重砲手 2階	Cannoneer 2nd Circle Required	캐노니어 2서클 필요
需要鐵甲騎兵1階	Cataphract 1st Circle required	캐터프랙트 1서클 필요
需要鐵甲騎兵2階	Cataphract 2nd Circle required	캐터프랙트 2서클 필요
需要鐵甲騎兵3階	Cataphract 3rd Circle required	캐터프랙트 3서클 필요
需要百夫長1階	Centurion 1st Circle required	센츄리온 1서클 필요
需要隨軍牧師1階	Chaplain 1st Circle required	채플린 1서클 필요
需要時空法師1階	Chronomancer 1st Circle required	크로노맨서 1서클 필요
需要時空操控者2階	Chronomancer 2nd Circle required	크로노맨서 2서클 필요
需要時空法師3階	Chronomancer 3rd Circle required	크로노맨서 3서클 필요
需要牧師1階	Cleric 1st Circle required	클레릭 1서클 필요
需要破防領域Lv3	Lv3 Deprotected Zone required	디프로텍티드 존 3레벨 필요
需要海賊1階	Corsair 1st Circle required	커세어 1서클 필요
需要海賊3階	Corsair 3rd Circle required	커세어 3서클 필요
需要海賊旗Lv2	Lv2 Jolly Roger required	졸리로저 2레벨 필요
需要海賊2階	Corsair 2nd Circle required	커세어 2서클 필요
需要道士 1階	Taoist 1st Circle Required	도사 1서클 필요
需要道士2階	Taoist 2nd Circle Required	도사 2서클 필요
需要雕刻師1階	Dievdirbys 1st Circle required	딥디르비 1서클 필요
需要雙酬傭兵1階	Doppelsoeldner 1st Circle required	도펠죌트너 1서클 필요
需要雙酬傭兵 3階	Doppelsoeldner 3rd Circle Required	도펠죌트너 3서클 필요
需要雙酬傭兵2階	Doppelsoeldner 2nd Circle required	도펠죌트너 2서클 필요
需要會心一擊 6等級	Lv6 Zornhau required	존하우 6레벨 필요
需要側邊揮擊 6等級	Lv6 Zucken required	츠켄 6레벨 필요
需要迴旋斬擊 6等級	Lv6 Redel required	레델 6레벨 필요
需要龍騎士1階	Dragoon 1st Circle required	드라군 1서클 필요
需要龍騎士 2階	Dragoon 2nd Circle Required	드라군 2서클 필요
需要龍騎士3階	Dragoon 3rd Circle Required	드라군 3서클 필요
需要昇龍之勢11級	Requires Dragon Soar Lv 11	드래곤소어 11레벨 필요
需要德魯伊1階	Druid 1st Circle required	드루이드 1서클 필요
需要元素使1階	Elementalist 1st Circle required	엘리멘탈리스트 1서클 필요
需要附魔師 1階	Enchanter 1st Circle Required	인챈터 1서클 필요
需要附魔師2階	Enchanter Circle 2 Required	인챈터 2서클 필요
需要馴鷹者1階	Falconer 1st Circle required	응사 1서클 필요
需要馴鷹者 3階	Falconer 3rd Circle Required	응사 3서클 필요
需要盤旋Lv3	Lv3 Hovering required	호버링 3레벨 필요
需要馴鷹者2階	Falconer 2nd Circle required	응사 2서클 필요
需要妖術師1階	Featherfoot 1st Circle required	페더풋 1서클 필요
需要妖術師 2階	Featherfoot 2nd Circle Required	페더풋 2서클 필요
需要妖術師3階	Featherfoot 3rd Circle Required	페더풋 3서클 필요
需要擊劍手1階	Fencer 1st Circle required	펜서 1서클 필요
需要擊劍手2階	Fencer 2nd Circle required	펜서 2서클 필요
需要擊劍手 3階	Fencer 3rd Circle Required	펜서 3서클 필요
需要烈焰法師1階	Pyromancer 1st Circle required	파이로맨서 1서클 필요
需要造箭者1階	Fletcher 1st Circle required	플레쳐 1서클 필요
需要寒冰法師1階	Cryomancer 1st Circle required	크리오맨서 1서클 필요
需要刀騎兵 1階	Hackapell 1st Circle Required	하카펠 1서클 필요
需要刀騎兵2階	Hackapell 2nd Circle Required	하카펠 2서클 필요
需要高地戰士1階	Highlander 1st Circle required	하이랜더 1서클 필요
需要高地戰士2階	Highlander 2nd Circle required	하이랜더 2서클 필요
需要蓄力一擊Lv3	Lv3 Cartar Stroke required	카타스트로크 3레벨 필요
需要十字守護Lv3	Lv3 Cross Guard required	크로스 가드 3레벨 필요
需要高地戰士3階	Highlander 3rd Circle required	하이랜더 3서클 필요
需要重裝步兵1階	Hoplite 1st Circle required	하플라이트 1서클 필요
需要瞄準隙缝Lv3	Lv3 Finestra required	피네스트라 3레벨 필요
需要獵人1階	Hunter 1st Circle required	헌터 1서클 필요
需要獵人2階	Hunter 2nd Circle required	헌터 2서클 필요
需要審判者1階	Inquisitor 1st Circle Required	인퀴지터 1서클 필요
需要審判者2階	Inquisitor Circle 2 Required	인퀴지터 2서클 필요
需要卡巴拉 2階	Kabalist 2nd Circle Required	카발리스트 2서클 필요
需要卡巴拉3階	Kabalist 3rd Circle Required	카발리스트 3서클 필요
需要卡巴拉1階	Kabbalist 1st Circle required	카발리스트 1서클 필요
需要聖火祭司1階	Krivis 1st Circle required	크리비 1서클 필요
需要聖火Lv3	Lv3 Aukuras required	아우쿠라스 3레벨 필요
需要神聖烙印10級	Requires Divine Stigma Level 10	디바인 스티그마 10레벨 필요
需要槍騎兵 1階	Lancer 1st Circle Required	랜서 1서클 필요
需要槍騎兵2階	Lancer 2nd Circle Required	랜서 2서클 필요
需要鎖鏈法師1階	Linker 1st Circle required	링커 1서클 필요
需要絞首鏈Lv3	Lv3 Hangman's Knot required	행멘스낫 3레벨 필요
需要鎖鏈法師 2階	Linker 2nd Circle required	링커 2서클 필요
需要鎖鏈法師 3階	Linker 3rd Circle required	링커 3서클 필요
需要鬥牛士1階	Matador 1st Circle Required	마타도르 1서클 필요
需要鬥牛士2階	Matador 2nd Circle Required	마타도르 2서클 필요
需要神射手 1階	Mergen 1st Circle Required	메르겐 1서클 필요
需要梅勒肯2階	Mergen 2nd Circle Required	메르겐 2서클 필요
需要巫女1階	Miko 1st Circle required	무녀 1서클 필요
需要武僧1階	Monk 1st Circle required	몽크 1서클 필요
需要角鬥士 1階	Murmillo 1st Circle Required	무르밀로 1서클 필요
需要角鬥士2階	Murmillo 2nd Circle Required	무르밀로 2서클 필요
需要火槍手1階	Musketeer 1st Circle required	머스킷티어 1서클 필요
需要火槍手 2階	Musketeer 2nd Circle Required	머스킷티어 2서클 필요
需要火槍手3階	Musketeer 3rd Circle Required	머스킷티어 3서클 필요
需要泰拳1階	Nak Muay C1 required	낙무아이 1서클 필요
需要死靈法師1階	Necromancer 1st Circle required	네크로맨서 1서클 필요
需要神諭師1階	Oracle 1st Circle required	오라클 1서클 필요
需要神諭師 3階	Oracle 3rd Circle Required	오라클 3서클 필요
需要神諭師2階	Oracle 2nd Circle required	오라클 2서클 필요
需要聖殿十字軍1階	Paladin 1st Circle required	팔라딘 1서클 필요
需要恢復Lv3	Lv3 Restoration required	리스토레이션 3레벨 필요
需要元素抗性Lv3	Lv3 Resist Elements required	레지스트 엘리멘츠 3레벨 필요
需要驅趕惡靈Lv2	Lv2 Turn Undead required	턴 언데드 2레벨 필요
需要寬恕者1階	Pardoner 1st Circle required	파드너 1서클 필요
需要寬恕Lv6	Lv6 Indulgentia required	인둘겐티아 6레벨 필요
需要寬恕者2階	Pardoner 2nd Circle required	파드너 2서클 필요
需要寬恕者3階	Pardoner 3rd Circle required	파드너 3서클 필요
需要輕裝步兵1階	Peltasta 1st Circle required	펠타스타 1서클 필요
需為輕裝步兵2階	Peltasta 2nd Circle required	펠타스타 2서클 필요
需要盾心打擊Lv6	Lv6 Umbo Blow required	엄보블로 6레벨 필요
需要盾緣敲擊Lv6	Lv6 Rim Blow required	림블로 6레벨 필요
需為輕裝步兵3階	Peltasta 3rd Circle required	펠타스타 3서클 필요
需要瘟疫醫生1階	Plague Doctor 1st Circle required	플레이그닥터 1서클 필요
需要瘟疫醫生 2階	Plague Doctor 2nd Circle Required	플레이그닥터 2서클 필요
需要瘟疫醫生3階	Plague Doctor Circle 3 Required	플레이그닥터 3서클 필요
需要感染11級	Requires Pandemic Level 11	판데믹 11레벨 필요
需要聖水祭司1階	Priest 1st Circle required	프리스트 1서클 필요
需要祝福Lv3	Lv3 Blessing required	블레싱 3레벨 필요
需要聖水祭司2階、復活術Lv2	Priest 2nd Circle & Lv2 Resurrection required	프리스트 2서클, 리저렉션 2레벨 필요
需要念力法師1階	Psychokino 1st Circle required	사이코키노 1서클 필요
需要念力法師2階	Psychokino 2nd Circle required	사이코키노 2서클 필요
需要念力法師3階	Psychokino 3rd Circle required	사이코키노 3서클 필요
需要弩箭手1階	Quarrel Shooter 1st Circle required	쿼렐슈터 1서클 필요
需要遊俠1階	Ranger 1st Circle required	레인저 1서클 필요
需要穩定瞄準Lv3	Lv3 Steady Aim required	스테디에임 3레벨 필요
需要圓盾劍士1階	Rodelero 1st Circle required	로델레로 1서클 필요
需要流氓1階	Rogue 1st Circle required	로그 1서클 필요
需要催淚彈Lv3	Lv3 Lachrymator required	최루 3레벨 필요
需要符文師1階	Rune Caster 1st Circle required	룬캐스터 1서클 필요
需要聖者1階	Sadhu 1st Circle required	사두 1서클 필요
需要衰弱Lv3	Lv3 Vashita Siddhi required	바쉬타 싯디 3레벨 필요
需要賢者 1階	Sage 1st Circle Required	세이지 1서클 필요
需要賢者2階	Sage Circle 2 Required	세이지 2서클 필요
需要工兵1階	Sapper 1st Circle required	새퍼 1서클 필요
需要黑暗騎兵1階	Schwarzer Reiter 1st Circle required	슈바르츠라이터 1서클 필요
需要黑暗騎兵 3階	Schwarzer Reiter 3rd Circle Required	슈바르츠라이터 3서클 필요
需要黑暗騎兵2階	Schwarzer Reiter 2nd Circle required	슈바르츠라이터 2서클 필요
需要斥候1階	Scout 1st Circle required	스카우트 1서클 필요
需要暗影師1階	Shadowmancer 1st Circle Required	섀도우맨서 1서클 필요
需要暗影師2階	Shadowmancer 2nd Circle Required	섀도우맨서 2서클 필요
需要忍者1階	Shinobi 1st Circle required	시노비 1서클 필요
需要巫師1階	Sorcerer 1st Circle required	소서러 1서클 필요
需要召喚使役魔Lv3	Lv3 Summon Familiar required	사역마 소환 3레벨 필요
需要巫師 2階	Sorcerer 2nd Circle required	소서러 2서클 필요
需要召喚僕人Lv3	Lv3 Summon Servant required	서번트 소환 3레벨 필요
需要巫師3階	Sorcerer 3rd Circle required	소서러 3서클 필요
需要侍從1階	Squire 1st Circle required	스콰이어 1서클 필요
需要武器修理Lv3	Lv3 Weapon Maintenance required	무기 손질 3레벨 필요
需要防具修理Lv3	Lv3 Armor Maintenance required	방어구 손질 3레벨 필요
需要侍從2階	Squire 2nd Circle required	스콰이어 2서클 필요
需要侍從3階	Squire 3rd Circle required	스콰이어 3서클 필요
需要聖殿騎士2階	Templar 2nd Circle required	템플러 2서클 필요
需要聖殿騎士3階	Templar Circle 3 required	템플러 3서클 필요
需要體積縮小Lv2	Lv2 Shrink Body required	크기 축소 2레벨 필요
需要體積變大Lv2	Lv2 Swell Body required	크기 확대 2레벨 필요
需要奇術師1階	Thaumaturge 1st Circle required	쏘마터지 1서클 필요
需要右臂強化Lv3	Lv3 Swell Right Arm required	오른팔 강화 3레벨 필요
需要大腦強化Lv3	Lv3 Swell Brain required	스웰 브레인 3레벨 필요
需要咒術師1階	Warlock 1st Circle required	워록 1서클 필요
需要咒術師 2階 	Warlock 2nd Circle Required	워록 2서클 필요
需要咒術師3階	Warlock 3rd Circle required	워록 3서클 필요
需要劍士1階	Swordsman 1st Circle required	소드맨 1서클 필요
需要痛擊Lv3	Lv3 Bash required	배쉬 3레벨 필요
需要奮起Lv3	Lv3 Gung Ho required	겅호 3레벨 필요
需要專注Lv3	Lv3 Concentrate required	콘센트레이트 3레벨 필요
需要法師2階	Wizard 2nd Circle required	위저드 2서클 필요
需要法師1階	Wizard 1st Circle required	위저드 1서클 필요
需要法師3階	Wizard 3rd Circle required	위저드 3서클 필요
需要巫蠱師1階	Wugushi 1st Circle required	무고사 1서클 필요
需要狂熱者1階	Zealot 1st Circle Required	질럿 1서클 필요
需要狂熱者2階	Zealot Circle 2 required	질럿 2서클 필요
樹之審判	Medzio Diena	메드지오 디에나
詛咒呼息	Cursed Breath	저주 브레스
翻地	Ground Upheaval	지면 뒤집기
網鬥士任務技能1	Quest Skill 1	레티아리이 퀘스트 스킬1
收拉手拋網	Pull Rete	투망 끌기
丟擲手拋網	Throw Rete	투망 던지기
匕首護衛	Dagger Guard	대거가드
三叉戟完結	Trident Finish	트라이던트 피니쉬
解除武裝	Disarm	무장해제
匕首完結	Dagger Finish	대거 피니쉬
保護要害	Vital Protection	급소 보호
白虎靈	Howling White Tiger	백호령
狂水的式神靈	Water Shikigami	살수의 식신령
玄武甲	Genbu Armor	현무갑
土俑	Toyou	토용
被手拋網綁住的狀態	Trapped in the Rete	투망에 묶여있는 상태
物理防禦力減少狀態	Physical Defense Reduced	물리 방어력 감소 상태
匕首防守	Dagger Guard	대거 가드
地屬性持續傷害	Continuous Earth Damage	땅속성 지속 대미지
移動速度減少10	Movement Speed -10	이동속도 10 감소
移動速度增加10	Movement Speed +10	이동속도 10 증가
暴擊扺抗提升	Critical Resistance Increase	치명타 저항 상승
使用靈能壓力、重力磁場時發生火屬性追加效果	Fire Effects Added to Psychic Pressure and Gravity Pole	사이킥 프레셔, 그라비티 폴 사용 시 불 속성 추가 효과 발생
九死一生	Near Escape	구사일생
火球的打擊數量增加	Fireball Hits Increased	파이어볼의 타격 수가 증가
A++	A+	참 잘했어요
周末活動	Weekend Event	주말 이벤트
情人節巧克力1階段	Valentine Chocolates Stage 1	발렌타인 초콜릿 1단계
情人節巧克力2階段	Valentine Chocolates Stage 2	발렌타인 초콜릿 2단계
情人節巧克力3階段	Valentine Chocolates Stage 3	발렌타인 초콜릿 3단계
情人節巧克力4階段	Valentine Chocolates Stage 4	발렌타인 초콜릿 4단계
情人節巧克力5階段	Valentine Chocolates Stage 5	발렌타인 초콜릿 5단계
持有稱號Buff	Title Buff	칭호 보유 버프
需要陰陽師1階	Requires Onmyoji Circle 1	음양사 1서클 필요
需要陰陽師2階，需要火狐式神靈6級以上	Requires Onmyoji Circle 2 and Fire Fox Shikigami Lv 6 or higher	음양사 2서클, 불여우 식신령 6레벨 이상 필요
需要陰陽師2階	Requires Onmyoji Circle 2	음양사 2서클 필요
需要陰陽師3階，需要白虎靈6級	Requires Onmyoji Circle 2 and Howling White Tiger Lv 6 or higher	음양사 2서클, 백호령 6레벨 필요
需要網鬥士1階	Requires Retiarius Circle 1	레티아리이 1서클 필요
需要網鬥士2階	Requires Retiarius Circle 2	레티아리이 2서클 필요
痛擊	Bash	배시
劍柄打擊	Pommel	포멀 비트
二重斬	Double Slash	더블 슬래시
盾心打擊	Umbo Blow	엄보 블로
盾緣敲擊	Rim Blow	림 블로
盾牌投擲	Shield Lob	실드 로브
高級守護	High Guard	하이 가드
車輪斬	Wagon Wheel	수레 바퀴
蓄力一擊	Cartar Stroke	카타 스트로크
垂直斬	Vertical Slash	버티컬 슬래시
雙手突刺	Synchro Thrusting	양손 찌르기
長驅直入	Long Stride	롱 스트라이드
破顱斬	Helm Chopper	헬름 쵸퍼
盾牌衝鋒	Shield Charge	실드 차지
盾牌碎擊	Targe Smash	타지 스매시
盾牌推擊	Shield Push	실드 푸시
射擊之星	Shooting Star	슈팅 스타
盾牌猛擊	Shield Shoving	실드 셔빙
盾牌痛擊	Shield Bash	실드 배시
上段踢	High Kick	하이 킥
穿刺	Impaler	임페일러
騎乘衝鋒	Steed Charge	스티드 차지
海賊旗	Jolly Roger	졸리 로저
龍骨拖引	Keel Hauling	킬홀링
毀滅連擊	Hexen Dropper	헥슨 드롭퍼
雙酬	Double Pay Earn	더블 페이 언
折磨	Punish	퍼니시
狂傲斬擊	Frenzied Slash	프렌지드 슬래시
龍牙	Dragontooth	드래곤 투스
穿刺之矛	Gae Bulg	게이 불그
昇龍之勢	Dragon Soar	드래곤 소어
公會塔	Build Guild Tower	길드 타워 설치
索命斬擊	Mortal Slash	모탈 슬래시
設置鐵匠工場	Forge	포지 설치
設置盾牌集氣	Shield Charger	실드 차저 설치
盾牌集氣	Shield Charger	실드 차저
粉碎一擊	Crush	크러시
三叉戟完結	Trident Finish	트라이던트 피니시
解除武裝	Disarm	무장 해제
匕首完結	Dagger Finish	대거 피니시
地獄氣息	Hell Breath	헬 브레쓰
冰槍	Ice Pike	아이스 파이크
冰牆	Ice Wall	아이스 월
零度盾牌	Subzero Shield	서브제로 실드
冰柱	Frost Pillar	프로스트 필라
物理鏈結	Physical Link	피지컬 링크
能力調換	Transpose	트랜스포즈
石化咒詛	Stone Curse	스톤 커스
屍塊砲擊	Flesh Cannon	플레시 캐논
屍塊護環	Flesh Hoop	플레시 후프
咒屍塔	Corpse Tower	콥스 타워
死者甦醒	Raise Dead	해골 병사 만들기
屍塊襲擊	Flesh Strike	플레시 스트라이크
召喚骸骨弓箭手	Raise Skull Archer	해골 궁수 만들기
昆德拉斬擊	Kundela Slash	쿤델라 슬래시
黑暗衝擊	Dark Theurge	다크 써지
多重射擊	Multi Shot	멀티 샷
滿弦	Full Draw	풀 드로우
跪射	Kneeling Shot	닐링 샷
強力射擊	Heavy Shot	헤비 샷
雙箭	Twin Arrow	트윈 애로우
貫通箭	High Anchoring	하이 앵커링
穩定瞄準	Steady Aim	스테디 에임
彈跳射擊	Bounce Shot	바운스 샷
石頭射擊	Stone Shot	스톤 샷
連續射擊	Rapid Fire	래피드 파이어
奔跑射擊	Running Shot	런닝 샷
竹尖釘	Punji Stake	푼지 스테이크
掃蕩陷阱	Broom Trap	브룸 트랩
衝鋒	Rush Dog	러쉬 도그
迴避	Evasion	이베이젼
背刺	Backstab	백스탭
闊箭	Broadhead	브로드 헤드
懸吊射擊	Hanging Shot	행잉 샷
重砲射擊	Cannon Shot	캐논 샷
攻城轟炸	Siege Burst	시즈 버스트
掩護射擊	Covering Fire	커버링 파이어
群體發射	Volleyfire	발리 파이어
鳥狙	Birdfall	버드 폴
刀騎兵	Hakka Palle	하카 팰레
騎兵集氣	Cavalry Charge	카발리 차지
銀彈	Silver Bullet	실버 불릿
殭屍圍繞	Bwa Kayiman	브와 카이망
衰弱	Vashita Siddhi	바시타 싯디
形態變換	Shape Shifting	셰이프 시프팅
狼人化	Lycanthropy	라이칸쓰로피
秘法能量	Arcane Energy	아케인 에너지
反擊	Counter Spell	카운터 스펠
再生因子	Healing Factor	힐링 팩터
連打機會	Double Chance	연타 찬스
修瑪真	Sumazinti	슈마진
堤克拉斯	Tiksline	티크라스
眉加泰	Mergaite	메가테
卡魯札	Kraujas	카루자
加貝尼	Gyvenimas	가베니
盾牌痛擊-屬性能力混亂。	Shield Bash - Mix Stats	실드 배시-스탯 뒤섞임
騎乘衝鋒技能可以再使用一次	Steed Charge can be used 1 more time	스티드 차지 스킬 한번 더 사용 가능
魔法防禦力減少狀態	Magic defense reduced	마법 방어력 감소 상태
從堤克拉斯施展者那裡獲得的傷害增加	Increased damage received from Tiksline caster	티크라스 시전자에게 받는 대미지 증가
魔法少女	Magical Girl	마법소녀
魔法防禦力、物理防禦力提升	Increased magic and physical defense	마법 방어력, 물리 방어력 상승
卡魯札的憤怒	Ire of Kraujas	카루자의 분노
傷害增加、被攻擊傷害增加	Increased damage dealt and received	대미지 증가, 피격 대미지 증가
加貝尼的保護	Gyvenimas' Protection	가베니의 보호
盾牌效果	Shield Effects	실드효과
拓本銅像Buff	Etching Statue Buff	탁본 동상 버프
給惡魔型Boss怪物的傷害增加	Increased damage to Demon type bosses	악마형 보스 몬스터에게 주는 대미지 증가
給變異型Boss怪物的傷害增加	Increased damage to Mutant type bosses	변이형 보스 몬스터에게 주는 대미지 증가
給昆蟲型Boss怪物的傷害增加	Increased damage to Insect type bosses	곤충형 보스 몬스터에게 주는 대미지 증가
給植物型Boss怪物的傷害增加	Increased damage to Plant type bosses	식물형 보스 몬스터에게 주는 대미지 증가
給野獸型Boss怪物的傷害增加	Increased damage to Beast type bosses	야수형 보스 몬스터에게 주는 대미지 증가
從惡魔型Boss怪物那裡獲得的傷害減少	Damage from Demon type bosses reduced	악마형 보스 몬스터에게 받는 대미지 감소
從變異型Boss怪物那裡獲得的傷害減少	Damage from Mutant type bosses reduced	변이형 보스 몬스터에게 받는 대미지 감소
從昆蟲型Boss怪物那裡獲得的傷害減少	Damage from Insect type bosses reduced	곤충형 보스 몬스터에게 받는 대미지 감소
從植物型Boss怪物那裡獲得的傷害減少	Damage from Plant type bosses reduced	식물형 보스 몬스터에게 받는 대미지 감소
從野獸型Boss怪物那裡獲得的傷害減少	Damage from Beast type bosses reduced	야수형 보스 몬스터에게 받는 대미지 감소
貝爾庫波套裝組合效果	Velcoffer Costume Set Effects	벨코퍼 코스튬 세트 효과
遠征隊暴發BUFF	Raid Explosion Buff	레이드 폭발 버프
遠征隊裝備暴發計數及攻擊BUFF	Raid equipment explosion count and attack buff	레이드 장비 폭발 카운트및 공격 버프
遠征隊暴發延遲	Raid Explosion Delay	레이드 폭발 딜레이
遠征隊裝備暴發延遲BUFF	Raid equipment explosion delay buff	레이드 장비 폭발 딜레이 버프
拓本第1名Buff 100	Etching 1st Place Buff 100	탁본 1위 버프 100
拓本第1名Buff 300	Etching 1st Place Buff 300	탁본 1위 버프 300
拓本第1名Buff 500	Etching 1st Place Buff 500	탁본 1위 버프 500
Rooting機會增加 +1000	Increase Looting Chance +1000	루팅 찬스 +1000 증가
樹木的第1次	Tree's First	나무의 첫 번째
物理、魔法攻擊力 +200	Physical and magic attack +200	물리, 마법 공격력 +200
樹木的第2次	Tree's Second	나무의 두 번째
物理、魔法防禦力 +200	Physical and magic attack +200	물리, 마법 방어력 +200
樹木的第3次	Tree's Third	나무의 세 번째
樹木的第4次	Tree's Fourth	나무의 네 번째
樹木的第5次	Tree's Fifth	나무의 다섯 번째
Rooting機會 +500	Looting Chance +500	루팅 찬스 +500
樹木的第6次	Tree's Sixth	나무의 여섯 번째
每10秒恢復HP 500、SP 300	HP 500 and SP 300 restored every 10 sec	10초마다 HP 500, SP 300 회복
樹木的第7次	Tree's Seventh	나무의 일곱 번째
秘密的樹根水晶	Secret Tree Root Crystal	비밀의 나무뿌리 수정
移動速度 +2	Movement speed +2	이동 속도 +2
進場無敵	Invincibility	입장 무적
佔領點數獲得數值增加	Additional Points	점령 포인트 획득 수치 증가
傷害及移動速度增加	Damage and Movement Speed Increased	대미지 및 이동속도 증가
不能進場無敵	No Invincibility	입장 무적 불가
樹根水晶的氣息：速度	Speed Crystal	나무뿌리 수정의 기운 : 속도
樹根水晶的氣息：重生	Regeneration Crystal	나무뿌리 수정의 기운 : 재생
樹根水晶的氣息：攻擊	Attack Crystal	나무뿌리 수정의 기운 : 공격
樹根水晶的氣息：防禦	Defense Crystal	나무뿌리 수정의 기운 : 방어
水晶的氣息	Crystal Energy	수정의 기운
每疊加攻擊力 +20	Attack +20 per stack	중첩당 공격력 +20
* [痛擊]的技能攻擊力每特性等級增加28	* Increases damage dealt with [Bash] by 28 per attribute level	* [배시]의 스킬 공격력이 특성 레벨당 28 증가
* [痛擊]傷害強化為劍士3階水準	* Enhances damage of [Bash] to Swordsman Circle 3 standards	* [배시] 대미지가 소드맨 3서클 수준으로 강화
* [盾心打擊]傷害強化為輕裝步兵2階水準	* Enhances damage of [Umbo Blow] to Peltasta Circle 2 standards	* [엄보 블로] 대미지가 펠타스타 2서클 수준으로 강화
* [盾心打擊]傷害強化為輕裝步兵3階水準	* Enhances damage of [Umbo Blow] to Peltasta Circle 3 standards	* [엄보 블로] 대미지가 펠타스타 3서클 수준으로 강화
* [盾牌投擲]傷害強化為輕裝步兵3階水準	* Enhances damage of [Shield Lob] to Peltasta Circle 3 standards	* [실드 로브] 대미지가 펠타스타 3서클 수준으로 강화
* [蓄力一擊]傷害強化為高地戰士2階水準	* Enhances damage of [Cartar Stroke] to Highlander Circle 2 standards	* [카타 스트로크] 대미지가 하이랜더 2서클 수준으로 강화
* [蓄力一擊]傷害強化為高地戰士3階水準	* Enhances damage of [Cartar Stroke] to Highlander Circle 3 standards	* [카타 스트로크] 대미지가 하이랜더 3서클 수준으로 강화
* [車輪斬]傷害強化為高地戰士2階水準	* Enhances damage of [Wagon Wheel] to Highlander Circle 2 standards	* [수레 바퀴] 대미지가 하이랜더 2서클 수준으로 강화
* [車輪斬]傷害強化為高地戰士3階水準	* Enhances damage of [Wagon Wheel] to Highlander Circle 3 standards	* [수레 바퀴] 대미지가 하이랜더 3서클 수준으로 강화
* [雙手突刺]傷害強化為重裝步兵2階水準	* Enhances damage of [Synchro Thrusting] to Hoplite Circle 2 standards	* [양손 찌르기] 대미지가 하플라이트 2서클 수준으로 강화
* [雙手突刺]傷害強化為重裝步兵3階水準	* Enhances damage of [Synchro Thrusting] to Hoplite Circle 3 standards	* [양손 찌르기] 대미지가 하플라이트 3서클 수준으로 강화
* [長驅直入]傷害強化為重裝步兵3階水準	* Enhances damage of [Long Stride] to Hoplite Circle 3 standards	* [롱 스트라이드] 대미지가 하플라이트 3서클 수준으로 강화
* 技能[長驅直入]的冷卻時間減少10秒	* Decreases cooldown time of [Long Stride] by 10 seconds	* 스킬 [롱 스트라이드]의 재사용 대기시간이 10초 감소
* [盾牌衝鋒]傷害強化為圓盾劍士2階水準	* Enhances damage of [Shield Charge] to Rodelero Circle 2 standards	* [실드 차지] 대미지가 로델레로 2서클 수준으로 강화
* [盾牌衝鋒]傷害強化為圓盾劍士3階水準	* Enhances damage of [Shield Charge] to Rodelero Circle 3 standards	* [실드 차지] 대미지가 로델레로 3서클 수준으로 강화
* [盾牌碎擊]傷害強化為圓盾劍士2階水準	* Enhances damage of [Targe Smash] to Rodelero Circle 2 standards	* [타지 스매시] 대미지가 로델레로 2서클 수준으로 강화
* [盾牌碎擊]傷害強化為圓盾劍士3階水準	* Enhances damage of [Targe Smash] to Rodelero Circle 3 standards	* [타지 스매시] 대미지가 로델레로 3서클 수준으로 강화
* [盾牌推擊]傷害強化為圓盾劍士2階水準	* Enhances damage of [Shield Push] to Rodelero Circle 2 standards	* [실드 푸시] 대미지가 로델레로 2서클 수준으로 강화
* [盾牌推擊]傷害強化為圓盾劍士3階水準	* Enhances damage of [Shield Push] to Rodelero Circle 3 standards	* [실드 푸시] 대미지가 로델레로 3서클 수준으로 강화
* [穿刺]傷害強化為鐵甲騎兵2階水準	* Enhances the damage of [Impaler] to Cataphract Circle 2 standards	* [임페일러] 대미지가 캐터프락트 2서클 수준으로 강화
* [穿刺]傷害強化為鐵甲騎兵3階水準	* Enhances the damage of [Impaler] to Cataphract Circle 3 standards	* [임페일러] 대미지가 캐터프락트 3서클 수준으로 강화
* [騎乘衝鋒]傷害強化為鐵甲騎兵2階水準	* Enhances damage of [Steed Charge] to Cataphract Circle 2 standards	* [스티드 차지] 대미지가 캐터프렉트 2서클 수준으로 강화
* [騎乘衝鋒]傷害強化為鐵甲騎兵3階水準	* Enhances damage of [Steed Charge] to Cataphract Circle 3 standards	* [스티드 차지] 대미지가 캐터프렉트 3서클 수준으로 강화
* [火牆]傷害強化為烈焰術士2階水準	* Enhances damage of [Fire Wall] to Pyromancer Circle 2 standards	* [파이어 월] 대미지가 파이로맨서 2서클 수준으로 강화
* [火牆]傷害強化為烈焰術士3階水準	* Enhances damage of [Fire Wall] to Pyromancer Circle 3 standards	* [파이어 월] 대미지가 파이로맨서 3서클 수준으로 강화
* [火柱]傷害強化為烈焰術士3階水準	* Enhances damage of [Fire Pillar] to Pyromancer Circle 3 standards	* [파이어 필라] 대미지가 파이로맨서 3서클 수준으로 강화
* 被[火牆]擊中的敵人會擊退	* Knocks back enemies hit by [Fire Wall]	* [파이어 월]에 피격된 적은 넉백
* [冰槍]傷害強化為寒冰法師2階水準	* Enhances damage of [Ice Pike] to Cryomancer Circle 2 standards	* [아이스 파이크] 대미지가 크리오맨서 2서클 수준으로 강화
* [冰槍]傷害強化為寒冰法師3階水準	* Enhances damage of [Ice Pike] to Cryomancer Circle 3 standards	* [아이스 파이크] 대미지가 크리오맨서 3서클 수준으로 강화
* [冰牆]技能的持續時間增加10秒	* Increases duration of [Ice Wall] by 10 seconds	* [아이스 월] 스킬의 지속시간이 10초 증가
* 使用[能力調換]時短力和體力不會互換{nl}    而是各自套用智力和體力的平均值	* Applies average of INT and CON to both stats when using [Transpose]	* [트랜스포즈] 사용 시 지능과 체력이 서로 바뀌지 않고{nl}    지능과 체력의 평균값이 각각 적용
* 被死靈法師技能命中後陷入[腐敗]Debuff時{nl}    敵人所穿戴的裝備會暫時腐敗變得無效	* [Corruption] debuff caused by Necromancer skills will temporarily nullify enemy gear	* 네크로맨서 스킬로 인해 [부패] 디버프에 걸렸을 때{nl}    적이 장착한 장비 아이템을 일시적으로 부패시켜 무력하게 만듦
* 在[道具喚醒]地下城登場的怪物個體數減少 	* Reduces number of monsters in [Item Awakening] dungeon	* [아이템 각성] 던전에서 등장하는 몬스터의 개체수 감소
* [多重射擊]傷害強化為弓箭手2階水準	* Enhances damage of [Multi Shot] to Archer Circle 2 standards	* [멀티 샷] 대미지가 아처 2서클 수준으로 강화
* [多重射擊]傷害強化為弓箭手3階水準	* Enhances damage of [Multi Shot] to Archer Circle 3 standards	* [멀티 샷] 대미지가 아처 3서클 수준으로 강화
* [滿弦]傷害強化為弓箭手2階水準	* Enhances damage of [Full Draw] to Archer Circle 2 standards	* [풀 드로우] 대미지가 아처 2서클 수준으로 강화
* [滿弦]傷害強化為弓箭手3階水準	* Enhances damage of [Full Draw] to Archer Circle 3 standards	* [풀 드로우] 대미지가 아처 3서클 수준으로 강화
* [強力射擊]傷害強化為弓箭手3階水準	* Enhances damage of [Heavy Shot] to Archer Circle 3 standards	* [헤비 샷] 대미지가 아처 3서클 수준으로 강화
* [跪射]狀態下可使用部份技能	* Allows you to use some skills in the [Kneeling Shot] position	* [닐링 샷] 상태에서 일부 스킬 사용 가능
* [貫通箭]傷害強化為遊俠2階水準	* Enhances damage of [High Anchoring] to Ranger Circle 2 standards	* [하이 앵커링] 대미지가 레인저 2서클 수준으로 강화
* [貫通箭]傷害強化為遊俠3階水準	* Enhances damage of [High Anchoring] to Ranger Circle 3 standards	* [하이 앵커링] 대미지가 레인저 3서클 수준으로 강화
* [穩定瞄準]的追加傷害每特性等級增加2	* Increases additional damage effect of [Steady Aim] by 2 per attribute level	* 특성 레벨당 [스테디 에임]의 추가대미지가 2 증가
* [石彈射擊]傷害強化為弩箭手2階水準	* Enhances damage of [Stone Shot] to Quarrel Shooter Circle 2 standards	* [스톤 샷] 대미지가 쿼렐슈터 2서클 수준으로 강화
* [石彈射擊]傷害強化為弩箭手3階水準	* Enhances damage of [Stone Shot] to Quarrel Shooter Circle 3 standards	* [스톤 샷] 대미지가 쿼렐슈터 3서클 수준으로 강화
* [連續射擊]傷害強化為弩箭手3階水準	* Enhances damage of [Rapid Fire] to Quarrel Shooter Circle 3 standards	* [래피드 파이어] 대미지가 쿼렐슈터 3서클 수준으로 강화
* [奔跑射擊]傷害每特性等級提升。	* Increases the damage of [Running Shot] per attribute level	* 특성 레벨당 [런닝 샷] 대미지가 상승합니다.
* [掃蕩陷阱]傷害強化為工兵2階水準	* Enhances damage of [Broom Trap] to Sapper Circle 2 standards	* [브룸 트랩] 대미지가 새퍼 2서클 수준으로 강화
* [掃蕩陷阱]傷害強化為工兵3階水準	* Enhances damage of [Broom Trap] to Sapper Circle 3 standards	* [브룸 트랩] 대미지가 새퍼 3서클 수준으로 강화
* [竹尖釘]傷害強化為工兵2階水準	* Enhances damage of [Punji Stake] to Sapper Circle 2 standards	* [푼지 스테이크] 대미지가 새퍼 2서클 수준으로 강화
* [竹尖釘]傷害強化為工兵3階水準	* Enhances damage of [Punji Stake] to Sapper Circle 3 standards	* [푼지 스테이크] 대미지가 새퍼 3서클 수준으로 강화
* 工兵技能獲得輔助武器的攻擊力，而不是主武器。	* Sapper skills receive the attack values of your subweapon instead of the main weapon	* 새퍼 스킬들이 주무기가 아닌 보조무기의 공격력을 받음
* [毒罐]傷害強化為巫蠱師3階水準	* Enhances damage of [Throw Gu Pot] to Wugushi Circle 3 standards	* [독 항아리] 대미지가 무고사 3서클 수준으로 강화
* 巫蠱師技能獲得輔助武器的攻擊力，而不是主武器。	* Wugushi skills receive the attack values of your subweapon instead of the main weapon	* 무고사 스킬들이 주무기가 아닌 보조무기의 공격력을 받음
* [闊箭]傷害強化為造箭者2階水準	* Enhances damage of [Broadhead] to Fletcher Circle 2 standards	* [브로드 헤드] 대미지가 플레쳐 2서클 수준으로 강화
* [荊棘箭]傷害強化為造箭者2階水準	* Enhances damage of [Barbed Arrow] to Fletcher Circle 2 standards	* [바브드 애로우] 대미지가 플레쳐 2서클 수준으로 강화
* 被技能[闊箭]攻擊的敵人狀能[出血]的持續時間每特性等級增加2秒	* Increases duration of [Bleeding] by 2 seconds per attribute level when an enemy is hit by [Broadhead]	* 스킬 [브로드 헤드]로 피격된 적 상태 [출혈]의 지속시간이 특성 레벨당 2초 증가
* [殭屍圍繞]傷害強化為邪靈祭司3階水準	* Enhances damage of [Bwa Kayiman] to Bokor Circle 3 standards	* [브와 카이망] 대미지가 보코르 3서클 수준으로 강화
* 每特性等級[元素抗性]屬性扺抗力增加1%	* Increases property resistance of [Resist Elements] by 1 per attribute level	* 특성 레벨당 [레지스트 엘리멘츠] 속성 저항력들이 1% 증가
* 以[形態變換]或[變形術]變身的怪物若是小型{nl}    迴避每特性等級增加50	* Increases evasion of small-sized monsters transformed by [Shape Shifting] or [Transform] by 50 per attribute level	* [쉐이프시프팅] 혹은 [트랜스폼]으로 변신한 몬스터가 소형이면{nl}    회피가 특성 레벨당 50 증가
* 以[形態變換]或[變形術]變身的怪物若是動物型{nl}    暴擊率每特性等級增加40	* Increases critical rate of animal monsters transformed via [Shape Shifting] or [Transform] by 40 per attribute level	* [쉐이프시프팅] 혹은 [트랜스폼]으로 변신한 몬스터가 동물형이면{nl}    치명타 발생이 특성 레벨당 40 증가
* 以[形態變換]或[變形術]變身後可更快速使用怪物的技能	* Decreases monster's skill casting time while [Shapeshifting] or [Transform] are active	* [쉐이프시프팅] 혹은 [트랜스폼]으로 변신후 몬스터의 스킬을 좀 더 빠르게 사용 가능
* 以[形態變換]或[變形術]變身後也能繼續維持PC移動速度	* Maintains the character's movement speed after transforming with [Shapeshifting] or [Transform]	* [세이프시프팅] 혹은 [트랜스폼]으로 변신 후에도 PC 이동속도에 가깝게 유지
金球週	Golden Ball Weekends	골든볼 위크
吹笛人任務技能1	Pied Piper Quest Skill 1	파이드파이퍼 퀘스트 스킬1
吹笛人任務技能2	Pied Piper Quest Skill 2	파이드파이퍼 퀘스트 스킬2
吹笛人任務技能3	Pied Piper Quest Skill 3	파이드파이퍼 퀘스트 스킬3
吹笛人任務技能4	Pied Piper Quest Skill 4	파이드파이퍼 퀘스트 스킬4
吹笛人任務技能5	Pied Piper Quest Skill 5	파이드파이퍼 퀘스트 스킬5
弱踢腿	Light Kick	약한 발차기
普通踢腿	Normal Kick	보통 발차기
強踢腿	Hard Kick	강한 발차기
整修裝備	Equipment Maintenance	장비 손질
古泰拳	Muay Thai	무아이타이
潛毒百歲	Latent Venom	잠독백세
毒霧萬象	Wide Miasma	독무만상
血流潛川	Crescendo Bane	혈류잠천
道具屬性的屬性數量追加機率增加	Increased chances of additional item stats	아이템 옵션의 옵션 수 추가 확률 증가
不和諧音	Dissonanz	디소난츠
搖籃曲	Wiegenlied	비겐리트
催眠之笛	Hypnotische Floete	힙노티쉐 플뢰테
召喚老鼠	Hameln Nagetier	하멜른 나게티어
和平之歌	Friedenslied	프리덴슬리트
行軍曲	Marschierendeslied	마쉬렌데스리트
種子炸彈	Seed Bomb	씨앗폭탄
針刺藤蔓	Thorn	가시덩굴
快蛇	Nachash	나하시
生命之樹	Tree of Sepiroth	세피로트의 나무
紅色教條	Rubric	루브릭
實體	Entity	엔터티
天使之淚	Aqua Benedicta	아쿠아 베네틱타
自我戒律	Engkrateia	엥크라테이야
警醒	Gregorate	그레고레이트
團契交流	Koinonia	코이노니아
毒扺抗減少	Decreased Poison Resistance	독 저항 감소
暴擊傷害增加	Critical Damage Increase	치명타 대미지 증가
毒霧萬象隱身	Wide Miasma Stealth	독무만상 은신
治癒力提升	Healing Increase	치유력 상승
草毒	Rash	풀독
毒屬性傷害	Poison Property Damage	독 속성 대미지
花香	Floral Scent	꽃향기
變身成為獸人	Human Form	수인 형태로 변신
挑釁周圍敵人	Nearby Enemies Provoked	주변 적을 도발
造成傷害	Damage received	대미지를 입음
搖籃曲	Lullaby	자장가
半夢半醒	Drowsy	비몽사몽
震退、擊倒免疫	Knockback and Knockdown Immunity	넉백, 넉다운 면역
快板	Allegro	알레그로
5秒內移動速度增加15	Movement Speed +15 for 5 sec	5초동안 이동속도 15 증가
無盡 SP恢復	Ein Sof SP Recovery	아인 소프 SP회복
SP恢復狀態	SP Recovery	SP회복 상태
特務零零八持有中	Goro	고로 보유 중
閃閃發亮	Sparkling	샤방샤방
燃燒的次元香爐	Burning Dimensional Incense Burner	타오르는 차원의 향로
預熱的次元香爐	Preheating Dimensional Incense Burner	차원의 향로 예열
妖精紅雀持有中	Fairy Cardinal	페어리 카디널 보유 중
週末&Burning	Weekend Burning	주말앤버닝
團結	New Class Update	결속
設定	Setting	세팅
點球決勝負	Shoot-out	승부 차기
* 造箭者技能的射程距離增加至 [每特性等級 x 10]程度	* Increases the range of Fletcher skills by [attribute level x 10]	* 플레쳐 스킬의 사거리가 [특성 레벨 x 10]만큼 증가
* 若組隊中有劍士系列職業，[行軍曲]buff的持續時間額外增加5秒。	* Increases the duration of the [Marschierendeslied] buff by 5 sec when a Swordsman tree character is in the party	* 전사계열 클래스가 파티에 있으면 [마쉬렌데스리트] 버프의 지속시간이 5초 추가로 증가
需要驅魔師1階	Requires Exorcist Circle 1	엑소시스트 1서클 필요
需要驅魔師2階	Requires Exorcist Circle 2	엑소시스트 2서클 필요
需要吹笛人1階	Requires Pied Piper Circle 1	파이드 파이퍼 1서클 필요
需要吹笛人2階	Requires Pied Piper Circle 2	파이드 파이퍼 2서클 필요
瞬間移動沉默	Teleport Silence	순간이동 침묵
冰河時代	Ice Mage	아이스 에이지
冰波	Ice Wave	아이스 웨이브
帝王之禍	Emperor's Bane	엠퍼러즈 베인
千軍萬馬	Gigante Marcha	기간테 마르샤
鬥牛終曲	Corrida Finale	코리다 피날레
捨命衝鋒	Blandir Cadena	블란디르 카데나
暗黑之洞	Hole of Darkness	홀 오브 다크니스
過度強化	Over-Reinforce	오버 리인포스
地獄暗影	Infernal Shadow	인퍼널 섀도우
陰陽調和	Yin Yang Harmony	음양조화
無窮襲擊	Infinite Assault	인피니트 어썰트
穹頂	Zenith	제니쓰
凝凍彈	Freeze Bullet	프리즈 불릿
暴行	Outrage	아웃레이지
世界樹之歌	Lied des Weltbaum	리트 데스 벨트바움
即興演奏	Stegreifspiel	슈테그라이프슈필
神之粉碎	God Smash	갓 스매시
鐵剪	Ripper	브레스트 리퍼
退魔符	Eradication	퇴마부
堅決信仰	Emphatic Trust	엠퍼시스 트러스트
天譴	Katadikazo	카타디카조
西曼苦痛屏障	Summon Pain Barrier	서먼페인 배리어
重覆時不行的精神衝擊特性	Unstackable Spirit Shock attribute	중복되면 안되는 스피릿 쇼크 특성
吸血蝙蝠吸血	Vampirism	데스모두스 흡혈
從施展者的召喚獸那裡獲得的傷害增加	Increased summon damage	시전자의 소환수에게 받는 피해 증가
施展者的召喚獸恢復	Summon recovery	시전자의 소환수 회복
暴擊免疫狀態	Critical Immunity	치명타 면역 상태
不可裝備盾牌	Unable to equip Shield	방패 착용 불가
基本攻擊時冰凍被攻擊的敵人	Targets frozen by basic attacks	기본 공격 시 피격된 적을 얼림
受到挑釁	Provoked	도발당함
陰陽的調和者	Yin Yang Mediator	음양의 조율자
受到傷害、給予傷害增加	Increased damage dealt and received	받는 피해, 주는 피해 증가
防禦力減少狀態	Defense Reduced	방어력 감소 상태
死靈法師屍毒debuff	Necromancer Bane	네크로맨서 시독
不能寵物搭乘	Companion Unmountable	컴패니언 탑승 불가
被退魔符攻擊中	Eradication damage	퇴마부 피격 중
不可格擋狀態	Unable to block	블록 불가 상태
巫女之錘免疫	Immune to burn	마나번 면역
使用騎兵集氣	Cavalry Charge	카발리 챠지를 사용
1分內不會發動	Unusable for 1 minute	1분간 발동하지 않음
沙烏席斯的詛咒	Curse of Sausis	사우시스의 저주
沙烏席斯手套Buff	Sausis Gloves Buff	사우시스 글로브 버프
召喚獸擊退免疫	Summon Knockback Immunity	소환수 넉백 면역
召喚獸能力轉移	Summon Stat Transfer	소환수 능력 전이
飾品增幅	Accessory Amplification	악세사리 증폭
隱秘的腳步	Secretive Step	은밀한 발걸음
大海的疪護	Blessing of the Sea	바다의 가호
丹迪汪汪持有中	Dandy Doggo	댄디 멍뭉이 보유 중
[Summer Festa] 休息	Relaxing	[Summer Festa] 휴식
每10秒HP恢復+500, SP恢復+500	HP +500 and SP +500 every 10 sec	10초마다 HP+500, SP+500 회복
移動速度+2	Movement speed +2	이동속도+2
Rooting機會 +300	Looting Chance +300	루팅찬스 +300
[Summer Festa] 加倍美味烤蝦串	BBQ Prawn Skewers	[Summer Festa] 더 맛있는 꼬치
[Summer Festa] 加倍透心涼凍檸茶	Blue Lemonade	[Summer Festa] 더 짜릿한 레몬아이스티
[Summer Festa] 加倍爽口椰子汁	Fresh Coconut Water	[Summer Festa] 더 시원한 코코넛쥬스
[For 10] 經驗值Burning	[For 10] EXP Burning	[For 10] 경험치 버닝
[For 10] 移動速度	[For 10] Movement Speed	[For 10] 이동 속도
移動速度 +1	Movement Speed +1	이동 속도 +1
在Nexon 網咖連線中	Eligible for rewards	넥슨 PC방에서 접속 중
Nexon 網咖組隊經驗值	Special party EXP	넥슨 피시방 파티 경험치
副本地區進場懲罰	Instanced Dungeon Map Penalty	인스턴스 지역 입장 페널티
鐵剪暫時免疫	Ripper Immunity	브레스트리퍼일시면역
使用弩弓	Crossbow Use	쇠뇌 사용
* 可配戴[弩弓]系列武器	* Can equip [Crossbow] type weapons	* [쇠뇌] 계열 무기 착용 가능
使用火槍	Musket Use	머스킷 사용
* 可配戴[火槍]系列武器	* Can equip [Musket] type weapons	* [머스킷] 계열 무기 착용 가능
* 可配戴[雙手鈍器]系列武器	* Can equip [Two-handed Blunt] type weapons	* [양손둔기] 계열 무기 착용 가능
* 配戴[雙手鈍器]時廣域攻擊比率增加5	* Increases AoE attack ratio by 5 when equipping a [Two-handed Blunt] weapon	* [양손둔기] 착용시 광역 공격 비율 5 증가
* 配戴[雙手鈍器]時格擋貫穿增加85	* Increases block penetration by 85 when equipping a [Two-handed Blunt] weapon	* [양손둔기] 착용시 블록 관통 85 증가
* 裝備[盾牌]時，攻擊自己的敵人數量每特性等級增加1	* Increases the number of enemies that can attack you at once by 1 per attribute level when equipping a [Shield]	* [방패] 착용 시 자신을 공격하는 적의 수가 특성 레벨당 1 증가
* 利用輕裝步兵技能攻擊敵人時獲得挑釁數值套用為2倍	* Increases provocation by 2 times when attacking the enemy with Peltasta skills	* 펠타스타 스킬로 적을 공격할 때 얻는 도발 수치가 2배로 적용
* 被[十字守護]擋下的敵人進入僵直的時間{nl}    每特性等級增加1秒	* Enemies blocked by [Cross Guard] are staggered for an additional 1 sec per attribute level	* [크로스 가드]에 막힌 적이 경직 되는 시간이 특성 레벨당{nl}    1초 증가
*  [跪射]狀態下暴擊發生每特性等級增加40	* Increases critical rate by 40 per attribute level when in [Kneeling Shot] status	* [닐링 샷] 상태에서 치명타 발생이 특성 레벨당 40 증가
* 弓和弩弓基本攻擊的射程每特性等級增加1	* Increases the basic attack range of Bows and Crossbows by 1 per attribute level	* 활과 쇠뇌 기본 공격의 사거리가 특성 레벨당 1 증가
* 若組隊中有劍士系列職業{nl}    [行軍曲]buff的持續時間額外增加5秒	* Increases the duration of the [Marschierendeslied] buff by 5 sec while a Swordsman tree character is in the party	* 전사계열 클래스가 파티에 있으면 [마쉬렌데스리트] 버프의{nl}    지속시간이 5초 추가로 증가
* 以[形態變換]或[變形術]變身後也能繼續維持PC移動速度	* Maintains the character's movement speed after transforming with [Shapeshifting] or [Transform]	* [쉐이프시프팅] 혹은 [트랜스폼]으로 변신 후에도 PC 이동속도에 가깝게 유지
需要槍彈者3階	Requires Bullet Marker Circle 3	불릿 마커 3서클 필요
需要道士3階	Requires Taoist Circle 3	도사 3서클 필요
需要旋風斬11級	Requires Cyclone Level 11	사이클론 11레벨 필요
需要附魔師3階	Requires Enchanter Circle 3	인챈터 3서클 필요
需要驅魔師3階	Requires Exorcist Circle 3	엑소시스트 3서클 필요
需要刀騎兵3階	Requires Hackapell Circle 3	하카펠 3서클 필요
需要審判者3階	Requires Inquisitor Circle 3	인퀴지터 3서클 필요
需要槍騎兵3階、落馬攻擊6級	Requires Lancer Circle 3 and Unhorsing Lv 6	랜서 3서클, 낙마 공격 6레벨 필요 필요
需要槍騎兵3階、隆格米安特6級	Requires Lancer Circle 3 and Rhongomiant Lv 6	랜서 3서클, 롱고미안트 6레벨 필요
需要槍騎兵3階、預防6級	Requires Lancer Circle 3 and Prevent Lv 6	랜서 3서클, 프리벤트 6레벨 필요
需要槍騎兵3階	Requires Lancer Circle 3	랜서 3서클 필요
需要鬥牛士3階	Requires Matador Circle 3	마타도르 3서클 필요
需要神射手3階	Requires Mergen Circle 3	메르겐 3서클 필요
需要角鬥士3階	Requires Murmillo Circle 3	무르밀로 3서클 필요
需要陰陽師3階	Requires Onmyoji Circle 3	음양사 3서클 필요
需要陰陽師3階、狂水的式神靈11級以上	Requires Onmyoji Circle 3 and Water Shikigami Lv 11	음양사 3서클, 살수의 식신령 11레벨 이상 필요
需要吹笛手3階	Requires Pied Piper Circle 3	파이드 파이퍼 3서클 필요
需要網鬥士3階	Requires Retiarius Circle 3	레티아리이 3서클 필요
需要賢者3階	Requires Sage Circle 3	세이지 3서클 필요
需要暗影師3階	Requires Shadowmancer Circle 3	섀도우맨서 3서클 필요
需要狂熱者3階	Requires Zealot Circle 3	질럿 3서클 필요
* 對因為[烈焰大地]受到傷害的敵人使用[隕石]時套用5連打	* [Meteor] applies as 5 hits on enemies receiving damage from [Flame Ground]	* [플레임 그라운드]로 피해를 받고 있는 적에게 [메테오] 사용 시 5연타 적용
孵化中	Hatching	부화중
火刑	Burn	화형
火刑技能	Burn Skill	화형 스킬
修格斯死後僵直	Shoggoth Rigor Mortis	쇼고스 사후경직
設定目標	Target Set	타겟 설정
宣告	Condemn	선고
月兔	Moon Rabbit	달 토끼
火箭筒追加傷害	Bazooka Additional Damage	바주카 추가 대미지
鎖定	Lock-on	락온
亞西歐梅吉的注視	The Eye of the Asiomage	아시오 메이지의 주시
狀態異常扺抗	Resist Status Ailments	상태 이상 저항
黑白面具	Black & White Mask	흑백 가면
看不見的刀刃	Unseen Blade	보이지 않는 칼날
銳利的刀刃	Sharp Blade	예리한 칼날
微笑兔	Smile Bunny	스마일 바니
生氣兔	Angry Bunny	앵그리 바니
威伊斯特隆的憤怒	Wastrel's Wrath	웨이스트럴의 분노
組隊爆竹	Party Firecracker	파티 폭죽
需要重砲手 2階	Requires Cannoneer Circle 2	캐노니어 2 서클 필요
